Chapter 2: The Process of Exchange Commodities cannot themselves go to market and perform exchanges in their own right.	ZWEITES KAPITEL Der Austauschprozeß Die Waren können nicht selbst zu Markte gehn und sich nicht selbst austauschen.	ch02_clean.en-ch02_clean.de
We must, therefore, have recourse to their guardians, who are the possessors of commodities.	Wir müssen uns also nach ihren Hütern umsehn, den Warenbesitzern.	ch02_clean.en-ch02_clean.de
Commodities are things, and therefore lack the power to resist man.	Die Waren sind Dinge und daher widerstandslos gegen den Menschen.	ch02_clean.en-ch02_clean.de
If they are unwilling, he can use force; in other words, he can take possession of them.	Wenn sie nicht willig, kann er Gewalt brauchen, in andren Worten, sie nehmen.	ch02_clean.en-ch02_clean.de
In order that these objects may enter into relation with each other as commodities, their guardians must place themselves in relation to one another as persons whose will resides in those objects, and must behave in such a way that each does not appropriate the commodity of the other, and alienate his own, except through an act to which both parties consent.	Um diese Dinge als Waren aufeinander zu beziehn, müssen die Warenhüter sich zueinander als Personen verhalten, deren Willen in jenen Dingen haust, so daß der eine nur mit dem Willen des andren, also jeder nur vermittelst eines, beiden gemeinsamen Willensakts sich die fremde Ware aneignet, indem er die eigne veräußert.	ch02_clean.en-ch02_clean.de
The guardians must therefore recognize each other as owners of private property.	Sie müssen sich daher wechselseitig als Privateigentümer anerkennen.	ch02_clean.en-ch02_clean.de
This juridical relation, whose form is the contract, whether as part of a developed legal system or not, is a relation between two wills which mirrors the economic relation.	Dies Rechtsverhältnis, dessen Form der Vertrag ist, ob nun legal entwickelt oder nicht, ist ein Willensverhältnis, worin sich das ökonomische Verhältnis widerspiegelt.	ch02_clean.en-ch02_clean.de
The content of this juridical relation (or relation of two wills) is itself determined by the economic relation.	Der Inhalt dieses Rechts- oder Willensverhältnisses ist durch das ökonomische Verhältnis selbst gegeben.	ch02_clean.en-ch02_clean.de
Here the persons exist for one another merely as representatives and hence owners, of commodities.	Die Personen existieren hier nur füreinander als Repräsentanten von Ware und daher als Warenbesitzer.	ch02_clean.en-ch02_clean.de
As we proceed to develop our investigation, we shall find, in general, that the characters who appear on the economic stage are merely personifications of economic relations; it is as the bearers* of these economic relations that they come into contact with each other.	Wir werden überhaupt im Fortgang der Entwicklung finden, daß die ökonomischen Charaktermasken der Personen nur die Personifikationen der ökonomischen Verhältnisse sind, als deren Träger sie sich gegenübertreten.	ch02_clean.en-ch02_clean.de
What chiefly distinguishes a commodity from its owner is the fact that every other commodity counts for it only as the form of appearance of its own value.	Was den Warenbesitzer namentlich von der Ware unterscheidet, ist der Umstand, daß ihr jeder andre Warenkörper nur als Erscheinungsform ihres eignen Werts gilt.	ch02_clean.en-ch02_clean.de
A born leveller and cynic, it is always ready to exchange not only soul, but body, with each and every other commodity, be it more repulsive than Maritornes herself† The owner makes up for this lack in the commodity of a sense of the concrete, physical body of the other commodity, by his own five and more senses.	Geborner Leveller und Zyniker, steht sie daher stets auf dem Sprung, mit jeder andren Ware, sei selbe auch ausgestattet mit mehr Unannehmlichkeiten als Maritorne, nicht nur die Seele, sondern den Leib zu wechseln. Diesen der Ware mangelnden Sinn für das Konkrete des Warenkörpers ergänzt der Warenbesitzer durch seine eignen fünf und mehr Sinne.	ch02_clean.en-ch02_clean.de
For the owner, his commodity possesses no direct use-value.	Seine Ware hat für ihn keinen unmittelbaren Gebrauchswert.	ch02_clean.en-ch02_clean.de
Otherwise, he would not bring it to market.	Sonst führte er sie nicht zu Markt.	ch02_clean.en-ch02_clean.de
It has use-value for others; but for himself its only direct use-value is as a bearer of exchange-value, and consequently, a means of exchange.	Sie hat Gebrauchswert für andre. Für ihn hat sie unmittelbar nur den Gebrauchswert, Träger von Tauschwert und so Tauschmittel zu sein.	ch02_clean.en-ch02_clean.de
He therefore makes up his mind to sell it in return for commodities whose use-value is of service to him.	Darum will er sie veräußern für Ware, deren Gebrauchswert ihm Genüge tut.	ch02_clean.en-ch02_clean.de
All commodities are non-use-values for their owners, and use-values for their non-owners.	Alle Waren sind Nicht-Gebrauchswerte für ihre Besitzer, Gebrauchswerte für ihre Nicht-Besitzer.	ch02_clean.en-ch02_clean.de
Consequently, they must all change hands.	Sie müssen also allseitig die Hände wechseln.	ch02_clean.en-ch02_clean.de
But this changing of hands constitutes their exchange, and their exchange puts them in relation with each other as values and realizes them as values.	Aber dieser Händewechsel bildet ihren Austausch, und ihr Austausch bezieht sie als Werte aufeinander und realisiert sie als Werte.	ch02_clean.en-ch02_clean.de
Hence commodities must be realized as values before they can be realized as use-values.	Die Waren müssen sich daher als Werte realisieren, bevor sie sich als Gebrauchswerte realisieren können.	ch02_clean.en-ch02_clean.de
On the other hand, they must stand the test as use-values before they can be realized as values.	Andrerseits müssen sie sich als Gebrauchswerte bewähren, bevor sie sich als Werte realisieren können.	ch02_clean.en-ch02_clean.de
For the labour expended on them only counts in so far as it is expended in a form which is useful for others.	Denn die auf sie verausgabte menschliche Arbeit zählt nur, soweit sie in einer für andre nützlichen Form verausgabt ist.	ch02_clean.en-ch02_clean.de
However, only the act of exchange can prove whether that labour is useful for others, and its product consequently capable of satisfying the needs of others.	Ob sie andren nützlich, ihr Produkt daher fremde Bedürfnisse befriedigt, kann aber nur ihr Austausch beweisen.	ch02_clean.en-ch02_clean.de
The owner of a commodity is prepared to part with it only in return for other commodities whose use-value satisfies his own need.	Jeder Warenbesitzer will seine Ware nur veräußern gegen andre Ware, deren Gebrauchswert sein Bedürfnis befriedigt.	ch02_clean.en-ch02_clean.de
So far, exchange is merely an individual process for him.	Sofern ist der Austausch für ihn nur individueller Prozeß.	ch02_clean.en-ch02_clean.de
On the other hand, he desires to realize his commodity, as a value, in any other suitable commodity of the same value. It does not matter to him whether his own commodity has any use-value for the owner of the other commodity or not.	Andrerseits will er seine Ware als Wert realisieren, also in jeder ihm beliebigen andren Ware von demselben Wert, ob seine eigne Ware nun für den Besitzer der andren Ware Gebrauchswert habe oder nicht.	ch02_clean.en-ch02_clean.de
From this point of view, exchange is for him a general social process.	Sofern ist der Austausch für ihn allgemein gesellschaftlicher Prozeß.	ch02_clean.en-ch02_clean.de
But the same process cannot be simultaneously for all owners of commodities both exclusively individual and exclusively social and general.	Aber derselbe Prozeß kann nicht gleichzeitig für alle Warenbesitzer nur individuell und zugleich nur allgemein gesellschaftlich sein.	ch02_clean.en-ch02_clean.de
Let us look at the matter a little more closely. To the owner of a commodity, every other commodity counts as the particular equivalent of his own commodity.	Sehn wir näher zu, so gilt jedem Warenbesitzer jede fremde Ware als besondres Äquivalent seiner Ware, seine Ware daher als allgemeines Äquivalent aller andren Waren.	ch02_clean.en-ch02_clean.de
Hence his own commodity is the universal equivalent for all the others.		ch02_clean.en-ch02_clean.de
But since this applies to every owner, there is in fact no commodity acting as universal equivalent, and the commodities possess no general relative form of value under which they can be equated as values and have the magnitude of their values compared.	Da aber alle Warenbesitzer dasselbe tun, ist keine Ware allgemeines Äquivalent und besitzen die Waren daher auch keine allgemeine relative Wertform, worin sie sich als Werte gleichsetzen und als Wertgrößen vergleichen.	ch02_clean.en-ch02_clean.de
Therefore they definitely do not confront each other as commodities, but as products or use-values only.	Sie stehn sich daher überhaupt nicht gegenüber als Waren, sondern nur als Produkte oder Gebrauchswerte.	ch02_clean.en-ch02_clean.de
In their difficulties our commodity-owners think like Faust: ‘In the beginning was the deed.’* They have therefore already acted before thinking.	In ihrer Verlegenheit denken unsre Warenbesitzer wie Faust. Im Anfang war die Tat. Sie haben daher schon gehandelt, bevor sie gedacht haben.	ch02_clean.en-ch02_clean.de
The natural laws of the commodity have manifested themselves in the natural instinct of the owners of commodities.	Die Gesetze der Warennatur betätigten sich im Naturinstinkt der Warenbesitzer.	ch02_clean.en-ch02_clean.de
They can only bring their commodities into relation as values, and therefore as commodities, by bringing them into an opposing relation with some one other commodity, which serves as the universal equivalent.	Sie können ihre Waren nur als Werte und darum nur als Waren aufeinander beziehn, indem sie dieselben gegensätzlich auf irgendeine andre Ware als allgemeines Äquivalent beziehn.	ch02_clean.en-ch02_clean.de
We have already reached that result by our analysis of the commodity.	Das ergab die Analyse der Ware.	ch02_clean.en-ch02_clean.de
But only the action of society can turn a particular commodity into the universal equivalent.	Aber nur die gesellschaftliche Tat kann eine bestimmte Ware zum allgemeinen Äquivalent machen.	ch02_clean.en-ch02_clean.de
The social action of all other commodities, therefore, sets apart the particular commodity in which they all represent their values.	Die gesellschaftliche Aktion aller andren Waren schließt daher eine bestimmte Ware aus, worin sie allseitig ihre Werte darstellen.	ch02_clean.en-ch02_clean.de
The natural form of this commodity thereby becomes the socially recognized equivalent form.	Dadurch wird die Naturalform Ware gesellschaftlich gültige Äquivalentform.	ch02_clean.en-ch02_clean.de
Through the agency of the social process it becomes the specific social function of the commodity which has been set apart to be the universal equivalent.	Allgemeines Äquivalent zu sein wird durch den gesellschaftlichen Prozeß zur spezifisch gesellschaftlichen Funktion der ausgeschlossenen Ware.	ch02_clean.en-ch02_clean.de
It thus becomes – money.	So wird sie - Geld.	ch02_clean.en-ch02_clean.de
‘Illi unum consilium habent et virtutem et potestatem suam bestiae tradunt… Et ne quis possit emere out vendere, nisi qui habet characterem out nomen bestiae, out numerum nominis eius’ (Apocalypse). * Money necessarily crystallizes out of the process of exchange, in which different products of labour are in fact equated with each other, and thus converted into commodities.	"Illi unum consilium habent et virtutem et potestatem suam bestiae tradunt. Et ne quis possit emere aut vendere, nisi qui habet characterem aut nomen bestiae, aut numerum nomisis ejus." <"Die haben eine Meinung und werden ihre Kraft und Macht geben dem Tier, daß niemand kaufen oder verkaufen kann, er habe denn das Malzeichen, nämlich den Namen des Tiers oder die Zahl seines Namens. "> (Apokalypse) Der Geldkristall ist ein notwendiges Produkt des Austauschprozesses, worin verschiedenartige Arbeitsprodukte einander tatsächlich gleichgesetzt und daher tatsächlich in Waren verwandelt werden.	ch02_clean.en-ch02_clean.de
The historical broadening and deepening of the phenomenon of exchange develops the opposition between use-value and value which is latent in the nature of the commodity.	Die historische Ausweitung und Vertiefung des Austausches entwickelt den in der Warennatur schlummernden Gegensatz von Gebrauchswert und Wert.	ch02_clean.en-ch02_clean.de
The need to give an external expression to this opposition for the purposes of commercial intercourse produces the drive towards an independent form of value, which finds neither rest nor peace until an independent form has been achieved by the differentiation of commodities into commodities and money.	Das Bedürfnis, diesen Gegensatz für den Verkehr äußerlich darzustellen, treibt zu einer selbständigen Form des Warenwerts und ruht und rastet nicht, bis sie endgültig erzielt ist durch die Verdopplung der Ware in Ware und Geld.	ch02_clean.en-ch02_clean.de
At the same rate, then, as the transformation of the products of labour into commodities is accomplished, one particular commodity is transformed into money.	In demselben Maße daher, worin sich die Verwandlung der Arbeitsprodukte in Waren, vollzieht sich die Verwandlung von Ware in Geld.	ch02_clean.en-ch02_clean.de
The direct exchange of products has the form of the simple expression of value in one respect, but not as yet in another.	Der unmittelbare Produktenaustausch hat einerseits die Form des einfachen Wertausdrucks und hat sie andrerseits noch nicht.	ch02_clean.en-ch02_clean.de
That form was x commodity A = y commodity B. The form of the direct exchange of products is x use-value A = y use-value B. The articles A and B in this case are not as yet commodities, but become so only through the act of exchange.	Jene Form war x Ware A = y Ware B. Die Form des unmittelbaren Produktenaustausches ist: x Gebrauchsgegenstand A = y Gebrauchsgegenstand B. Die Dinge A und B sind hier nicht Waren vor dem Austausch, sondern werden es erst durch denselben.	ch02_clean.en-ch02_clean.de
The first way in which an object of utility attains the possibility of becoming an exchange-value is to exist as a non-use-value, as a quantum of use-value superfluous to the immediate needs of its owner.	Die erste Weise, worin ein Gebrauchsgegenstand der Möglichkeit nach Tauschwert ist, ist sein Dasein als Nicht-Gebrauchswert, als die unmittelbaren Bedürfnisse seines Besitzers überschießendes Quantum von Gebrauchswert.	ch02_clean.en-ch02_clean.de
Things are in themselves external to man, and therefore alienable.	Dinge sind an und für sich dem Menschen äußerlich und daher veräußerlich.	ch02_clean.en-ch02_clean.de
In order that this alienation [Veräusserung] may be reciprocal, it is only necessary for men to agree tacitly to treat each other as the private owners of those alienable things, and, precisely for that reason, as persons who are independent of each other.	Damit diese Veräußerung wechselseitig, brauchen Menschen nur stillschweigend sich als Privateigentümer jener veräußerlichen Dinge und eben dadurch als voneinander unabhängige Personen gegenüberzutreten.	ch02_clean.en-ch02_clean.de
But this relationship of reciprocal isolation and foreignness does not exist for the members of a primitive community of natural origin, whether it takes the form of a patriarchal family, an ancient Indian commune or an Inca state. The exchange of commodities begins where communities have their boundaries, at their points of contact with other communities, or with members of the latter.	Solch ein Verhältnis wechselseitiger Fremdheit existiert jedoch nicht für die Glieder eines naturwüchsigen Gemeinwesens, habe es nun die Form einer patriarchalischen Familie, einer altindischen Gemeinde, eines Inkastaates usw. Der Warenaustausch beginnt, wo die Gemeinwesen enden, an den Punkten ihres Kontakts mit fremden Gemeinwesen oder Gliedern fremder Gemeinwesen.	ch02_clean.en-ch02_clean.de
However, as soon as products have become commodities in the external relations of a community, they also, by reaction, become commodities in the internal life of the community.	Sobald Dinge aber einmal im auswärtigen, werden sie auch rückschlagend im innern Gemeinleben zu Waren.	ch02_clean.en-ch02_clean.de
Their quantitative exchange-relation is at first determined purely by chance.	Ihr quantitatives Austauschverhältnis ist zunächst ganz zufällig.	ch02_clean.en-ch02_clean.de
They become exchangeable through the mutual desire of their owners to alienate them.	Austausch- bar sind sie durch den Willensakt ihrer Besitzer, sie wechselseitig zu veräußern.	ch02_clean.en-ch02_clean.de
In the meantime, the need for others’ objects of utility gradually establishes itself.	Indes setzt sich das Bedürfnis für fremde Gebrauchsgegenstände allmählich fest.	ch02_clean.en-ch02_clean.de
The constant repetition of exchange makes it a normal social process.	Die beständige Wiederholung des Austausches macht ihn zu einem regelmäßigen gesellschaftlichen Prozeß.	ch02_clean.en-ch02_clean.de
In the course of time, therefore, at least some part of the products must be produced intentionally for the purpose of exchange.	Im Laufe der Zeit muß daher wenigstens ein Teil der Arbeitsprodukte absichtlich zum Behuf des Austausches produziert werden.	ch02_clean.en-ch02_clean.de
From that moment the distinction between the usefulness of things for direct consumption and their usefulness in exchange becomes firmly established.	Von diesem Augenblick befestigt sich einerseits die Scheidung zwischen der Nützlichkeit der Dinge für den unmittelbaren Bedarf und ihrer Nützlichkeit zum Austausch.	ch02_clean.en-ch02_clean.de
Their use-value becomes distinguished from their exchange-value.	Ihr Gebrauchswert scheidet sich von ihrem Tauschwerte.	ch02_clean.en-ch02_clean.de
On the other hand, the quantitative proportion in which the things are exchangeable becomes dependent on their production itself.	Andrerseits wird das quantitative Verhältnis, worin sie sich austauschen, von ihrer Produktion selbst abhängig.	ch02_clean.en-ch02_clean.de
Custom fixes their values at definite magnitudes.	Die Gewohnheit fixiert sie als Wertgrößen.	ch02_clean.en-ch02_clean.de
In the direct exchange of products, each commodity is a direct means of exchange to its owner, and an equivalent to those who do not possess it, although only in so far as it has use-value for them.	Im unmittelbaren Produktenaustausch ist jede Ware unmittelbar Tauschmittel für ihren Besitzer, Äquivalent für ihren Nichtbesitzer, jedoch nur soweit sie Gebrauchswert für ihn.	ch02_clean.en-ch02_clean.de
At this stage, therefore, the articles exchanged do not acquire a value-form independent of their own use-value, or of the individual needs of the exchangers.	Der Tauschartikel erhält also noch keine von seinem eignen Gebrauchswert oder dem individuellen Bedürfnis der Austauscher unabhängige Wertform.	ch02_clean.en-ch02_clean.de
The need for this form first develops with the increase in the number and variety of the commodities entering into the process of exchange.	Die Notwendigkeit dieser Form entwickelt sich mit der wachsenden Anzahl und Mannigfaltigkeit der in den Austauschprozeß eintretenden Waren.	ch02_clean.en-ch02_clean.de
The problem and the means for its solution arise simultaneously.	Die Aufgabe entspringt gleichzeitig mit den Mitteln ihrer Lösung.	ch02_clean.en-ch02_clean.de
Commercial intercourse, in which the owners of commodities exchange and compare their own articles with various other articles, never takes place unless different kinds of commodities belonging to different owners are exchanged for, and equated as values with, one single further kind of commodity.	Ein Verkehr, worin Warenbesitzer ihre eignen Artikel mit verschiednen andren Artikeln austauschen und vergleichen, findet niemals statt, ohne daß verschiedne Waren von verschiednen Warenbesitzern innerhalb ihres Verkehrs mit einer und derselben dritten Warenart ausgetauscht und als Werte verglichen werden.	ch02_clean.en-ch02_clean.de
This further commodity, by becoming the equivalent of various other commodities, directly acquires the form of a universal or social equivalent, if only within narrow limits.	Solche dritte Ware, indem sie Äquivalent für verschiedne andre Waren wird, erhält unmittelbar, wenn auch in engen Grenzen, allgemeine oder gesellschaftliche Äquivalentform.	ch02_clean.en-ch02_clean.de
The universal equivalent form comes and goes with the momentary social contacts which call it into existence.	Diese allgemeine Äquivalentform entsteht und vergeht mit dem augenblicklichen gesellschaftlichen Kontakt, der sie ins Leben rief.	ch02_clean.en-ch02_clean.de
It is transiently attached to this or that commodity in alternation.	Abwechselnd und flüchtig kommt sie dieser oder jener Ware zu.	ch02_clean.en-ch02_clean.de
But with the development of exchange it fixes itself firmly and exclusively onto particular kinds of commodity, i.e. it crystallizes out into the money-form.	Mit der Entwicklung des Warenaustausches heftet sie sich aber ausschließlich fest an besondere Warenarten oder kristallisiert zur Geldform.	ch02_clean.en-ch02_clean.de
The particular kind of commodity to which it sticks is at first a matter of accident.	An welcher Warenart sie kleben bleibt, ist zunächst zufällig.	ch02_clean.en-ch02_clean.de
Nevertheless there are two circumstances which are by and large decisive.	Jedoch entscheiden im großen und ganzen zwei Umstände.	ch02_clean.en-ch02_clean.de
The money-form comes to be attached either to the most important articles of exchange from outside, which are in fact the primitive and spontaneous forms of manifestation of the exchange-value of local products, or to the object of utility which forms the chief element of indigenous alienable wealth, for example cattle.	Geldform heftet sich entweder an die wichtigsten Eintauschartikel aus der Fremde, welche in der Tat naturwüchsige Erscheinungsformen des Tauschwerts der einheimischen Produkte sind, oder an den Gebrauchsgegenstand, welcher das Hauptelement des einheimischen veräußerlichen Besitztums bildet, wie z.B. Vieh.	ch02_clean.en-ch02_clean.de
Nomadic peoples are the first to develop the money-form, because all their worldly possessions are in a movable and therefore directly alienable form, and because their mode of life, by continually bringing them into contact with foreign communities, encourages the exchange of products.	Nomadenvölker entwickeln zuerst die Geldform, weil all ihr Hab und Gut sich in beweglicher, daher unmittelbar veräußerlicher Form befindet, und weil ihre Lebensweise sie beständig mit fremden Gemeinwesen in Kontakt bringt, daher zum Produktenaustausch sollizitiert.	ch02_clean.en-ch02_clean.de
Men have often made man himself into the primitive material of money, in the shape of the slave, but they have never done this with the land and soil.	Die Menschen haben oft den Menschen selbst in der Gestalt des Sklaven zum ursprünglichen Geldmaterial gemacht, aber niemals den Grund und Boden.	ch02_clean.en-ch02_clean.de
Such an idea could only arise in a bourgeois society, and one which was already well developed.	Solche Idee konnte nur in bereits ausgebildeter bürgerlicher Gesellschaft aufkommen.	ch02_clean.en-ch02_clean.de
It dates from the last third of the seventeenth century, and the first attempt to implement the idea on a national scale was made a century later, during the French bourgeois revolution. * In the same proportion as exchange bursts its local bonds, and the value of commodities accordingly expands more and more into the material embodiment of human labour as such, in that proportion does the money-form become transferred to commodities which are by nature fitted to perform the social function of a universal equivalent. Those commodities are the precious metals.	Sie datiert vom letzten Dritteil des 17. Jahrhunderts, und ihre Ausführung, auf nationalem Maßstab, wurde erst ein Jahrhundert später in der bürgerlichen Revolution der Franzosen versucht. In demselben Verhältnis, worin der Warenaustausch seine nur lokalen Bande sprengt, der Warenwert sich daher zur Materiatur menschlicher Arbeit überhaupt ausweitet, geht die Geldform auf Waren über, die von Natur zur gesellschaftlichen Funktion eines allgemeinen Äquivalents taugen, auf die edlen Metalle.	ch02_clean.en-ch02_clean.de
The truth of the statement that ‘although gold and silver are not by nature money, money is by nature gold and silver’, is shown by the appropriateness of their natural properties for the functions of money.	Daß nun, "obgleich Gold und Silber nicht von Natur Geld, Geld von Natur Gold und Silber ist" , zeigt die Kongruenz ihrer Natureigenschaften mit seinen Funktionen.	ch02_clean.en-ch02_clean.de
So far, however, we are acquainted with only one function of money, namely to serve as the form of appearance of the value of commodities, that is as the material in which the magnitudes of their values are socially expressed.	Bisher kennen wir aber nur die eine Funktion des Geldes, als Erscheinungsform des Warenwerts zu dienen oder als das Material, worin die Wertgrößen der Waren sich gesellschaftlich ausdrücken.	ch02_clean.en-ch02_clean.de
Only a material whose every sample possesses the same uniform quality can be an adequate form of appearance of value, that is a material embodiment of abstract and therefore equal human labour.	Adäquate Erscheinungsform von Wert oder Materiatur abstrakter und daher gleicher menschlicher Arbeit kann nur eine Materie sein, deren sämtliche Exemplare dieselbe gleichförmige Qualität besitzen.	ch02_clean.en-ch02_clean.de
On the other hand, since the difference between the magnitudes of value is purely quantitative, the money commodity must be capable of purely quantitative differentiation, it must therefore be divisible at will, and it must also be possible to assemble it again from its component parts.	Andrerseits, da der Unterschied der Wertgrößen rein quantitativ ist, muß die Geldware rein quantitativer Unterschiede fähig, also nach Willkür teilbar und aus ihren Teilen wieder zusammensetzbar sein.	ch02_clean.en-ch02_clean.de
Gold and silver possess these properties by nature.	Gold und Silber besitzen aber diese Eigenschaften von Natur.	ch02_clean.en-ch02_clean.de
The money commodity acquires a dual use-value.	Der Gebrauchswert der Geldware verdoppelt sich.	ch02_clean.en-ch02_clean.de
Alongside its special use-value as a commodity (gold, for instance, serves to fill hollow teeth, it forms the raw material for luxury articles, etc.) it acquires a formal use-value, arising out of its specific social function.	Neben ihrem besondren Gebrauchswert als Ware, wie Gold z.B. zum Ausstopfen hohler Zähne, Rohmaterial von Luxusartikeln usw. dient, erhält sie einen formalen Gebrauchswert, der aus ihren spezifischen gesellschaftlichen Funktionen entspringt.	ch02_clean.en-ch02_clean.de
Since all other commodities are merely particular equivalents for money, the latter being their universal equivalent, they relate to money as particular commodities relate to the universal commodity.	Da alle andren Waren nur besondre Äquivalente des Geldes, das Geld ihr allgemeines Äquivalent, verhalten sie sich als besondre Waren zum Geld als der allgemeinen Ware.	ch02_clean.en-ch02_clean.de
We have seen that the money-form is merely the reflection thrown upon a single commodity by the relations between all other commodities.	Man hat gesehn, daß die Geldform nur der an einer Ware festhaftende Reflex der Beziehungen aller andren Waren.	ch02_clean.en-ch02_clean.de
That money is a commodity is therefore only a discovery for those who proceed from its finished shape in order to analyse it afterwards.	Daß Geld Ware ist , ist also nur eine Entdeckung für den, der von seiner fertigen Gestalt ausgeht, um sie hinterher zu analysieren.	ch02_clean.en-ch02_clean.de
The process of exchange gives to the commodity which it has converted into money not its value but its specific value-form.	Der Austauschprozeß gibt der Ware, die er in Geld verwandelt, nicht ihren Wert, sondern ihre spezifische Wertform.	ch02_clean.en-ch02_clean.de
Confusion between these two attributes has misled some writers into maintaining that the value of gold and silver is imaginary.	Die Verwechslung beider Bestimmungen verleitete dazu, den Wert von Gold und Silber für imaginär zu halten.	ch02_clean.en-ch02_clean.de
The fact that money can, in certain functions, be replaced by mere symbols of itself, gave rise to another mistaken notion, that it is itself a mere symbol.	Weil Geld in bestimmten Funktionen durch bloße Zeichen seiner selbst ersetzt werden kann, entsprang der andre Irrtum, es sei ein bloßes Zeichen.	ch02_clean.en-ch02_clean.de
Nevertheless, this error did contain the suspicion that the money-form of the thing is external to the thing itself, being simply the form of appearance of human relations hidden behind it.	Andrerseits lag darin die Ahnung, daß die Geldform des Dings ihm selbst äußerlich und bloß Erscheinungsform dahinter versteckter menschlicher Verhältnisse.	ch02_clean.en-ch02_clean.de
In this sense every commodity is a symbol, since, as value, it is only the material shell of the human labour expended on it.	In diesem Sinn wäre jede Ware ein Zeichen, weil als Wert nur sachliche Hülle der auf sie verausgabten menschlichen Arbeit.	ch02_clean.en-ch02_clean.de
But if it is declared that the social characteristics assumed by material objects, or the material characteristics assumed by the social determinations of labour on the basis of a definite mode of production, are mere symbols, then it is also declared, at the same time, that these characteristics are the arbitrary product of human reflection.	Indem man aber die gesellschaftlichen Charak- tere, welche Sachen, oder die sachlichen Charaktere, welche gesellschaftliche Bestimmungen der Arbeit auf Grundlage einer bestimmten Produktionsweise erhalten, für bloße Zeichen, erklärt man sie zugleich für willkürliches Reflexionsprodukt der Menschen.	ch02_clean.en-ch02_clean.de
This was the kind of explanation favoured by the eighteenth century: in this way the Enlightenment endeavoured, at least temporarily, to remove the appearance of strangeness from the mysterious shapes assumed by human relations whose origins they were unable to decipher.	Es war dies beliebte Aufklärungsmanier des 18. Jahrhunderts, um den rätselhaften Gestalten menschlicher Verhältnisse, deren Entstehungsprozeß man noch nicht entziffern konnte, wenigstens vorläufig den Schein der Fremdheit abzustreifen.	ch02_clean.en-ch02_clean.de
It has already been remarked above that the equivalent form of a commodity does not imply that the magnitude of its value can be determined.	Es ward vorhin bemerkt, daß die Äquivalentform einer Ware die quantitative Bestimmung ihrer Wertgröße nicht einschließt.	ch02_clean.en-ch02_clean.de
Therefore, even if we know that gold is money, and consequently directly exchangeable with all other commodities, this still does not tell us how much 101b. of gold is worth, for instance.	Weiß man, daß Gold Geld, daher mit allen andren Waren unmittelbar austauschbar ist, so weiß man deswegen nicht, wieviel z.B. 10 Pfund Gold wert sind.	ch02_clean.en-ch02_clean.de
Money, like every other commodity, cannot express the magnitude of its value except relatively in other commodities.	Wie jede Ware kann das Geld seine eigne Wertgröße nur relativ in andren Waren ausdrücken.	ch02_clean.en-ch02_clean.de
This value is determined by the labour-time required for its production, and is expressed in the quantity of any other commodity in which the same amount of labour-time is congealed.	Sein eigner Wert ist bestimmt durch die zu seiner Produktion erheischte Arbeitszeit und drückt sich in dem Quantum jeder andren Ware aus, worin gleichviel Arbeitszeit geronnen ist.	ch02_clean.en-ch02_clean.de
This establishing of its relative value occurs at the source of its production by means of barter.	Diese Festsetzung seiner relativen Wertgröße findet statt an seiner Produktionsquelle in unmittelbarem Tauschhandel.	ch02_clean.en-ch02_clean.de
As soon as it enters into circulation as money, its value is already given.	Sobald es als Geld in die Zirkulation eintritt, ist sein Wert bereits gegeben.	ch02_clean.en-ch02_clean.de
In the last decades of the seventeenth century the first step in the analysis of money, the discovery that money is a commodity, had already been taken; but this was merely the first step, and nothing more.	Wenn es schon in den letzten Dezennien des 17. Jahrhunderts weit überschrittner Anfang der Geldanalyse, zu wissen, daß Geld Ware ist, so aber auch nur der Anfang.	ch02_clean.en-ch02_clean.de
The difficulty lies not in comprehending that money is a commodity, but in discovering how, why and by what means a commodity becomes money.	Die Schwierigkeit liegt nicht darin zu begreifen, daß Geld Ware, sondern wie, warum, wodurch Ware Geld ist.	ch02_clean.en-ch02_clean.de
We have already seen, from the simplest expression of value, x commodity A = y commodity B, that the thing in which the magnitude of the value of another thing is represented appears to have the equivalent form independently of this relation, as a social property inherent in its nature.	Wir sahen, wie schon in dem einfachsten Wertausdruck, x Ware A = y Ware B, das Ding, worin die Wertgröße eines andren Dings dargestellt wird, seine Äquivalentform unabhängig von dieser Beziehung als gesellschaftliche Natureigenschaft zu besitzen scheint.	ch02_clean.en-ch02_clean.de
We followed the process by which this false semblance became firmly established, a process which was completed when the universal equivalent form became identified with the natural form of a particular commodity, and thus crystallized into the money-form.	Wir verfolgten die Befestigung dieses falschen Scheins. Er ist vollendet, sobald die allgemeine Äquivalentform mit der Naturalform einer besondren Warenart verwachsen oder zur Geldform kristallisiert ist.	ch02_clean.en-ch02_clean.de
What appears to happen is not that a particular commodity becomes money because all other commodities express their values in it, but, on the contrary, that all other commodities universally express their values in a particular commodity because it is money.	Eine Ware scheint nicht erst Geld zu werden, weil die andren Waren allseitig ihre Werte in ihr darstellen, sondern sie scheinen umgekehrt allgemein ihre Werte in ihr darzustellen, weil sie Geld ist.	ch02_clean.en-ch02_clean.de
The movement through which this process has been mediated vanishes in its own result, leaving no trace behind.	Die vermittelnde Bewegung verschwindet in ihrem eignen Resultat und läßt keine Spur zurück.	ch02_clean.en-ch02_clean.de
Without any initiative on their part, the commodities find their own value-configuration ready to hand, in the form of a physical commodity existing outside but also alongside them.	Ohne ihr Zutun finden die Waren ihre eigne Wertgestalt fertig vor als einen außer und neben ihnen existierenden Warenkörper.	ch02_clean.en-ch02_clean.de
This physical object, gold or silver in its crude state, becomes, immediately on its emergence from the bowels of the earth, the direct incarnation of all human labour.	Diese Dinge, Gold und Silber, wie sie aus den Eingeweiden der Erde herauskommen, sind zugleich die unmittelbare Inkarnation aller menschlichen Arbeit.	ch02_clean.en-ch02_clean.de
Hence the magic of money.	Daher die Magie des Geldes.	ch02_clean.en-ch02_clean.de
Men are henceforth related to each other in their social process of production in a purely atomistic way. Their own relations of production therefore assume a material shape which is independent of their control and their conscious individual action. This situation is manifested first by the fact that the products of men’s labour universally take on the form of commodities.	Das bloß atomistische Verhalten der Menschen in ihrem gesellschaftlichen Produktionsprozeß und daher die von ihrer Kontrolle und ihrem bewußten individuellen Tun unabhängige, sachliche Gestalt ihrer eignen Produktionsverhältnisse erscheinen zunächst darin, daß ihre Arbeitsprodukte allgemein die Warenform annehmen.	ch02_clean.en-ch02_clean.de
The riddle of the money fetish is therefore the riddle of the commodity fetish, now become visible and dazzling to our eyes.	Das Rätsel des Geldfetischs ist daher nur das sichtbar gewordne, die Augen blendende Rätsel des Warenfetischs.	ch02_clean.en-ch02_clean.de

