Chapter 6: The Sale and Purchase of Labour-Power The change in value of the money which has to be transformed into capital cannot take place in the money itself, since in its function as means of purchase and payment it does no more than realize [realisieren] the price of the commodity it buys or pays for, while, when it sticks to its own peculiar form, it petrifies into a mass of value of constant magnitude.	3. Kauf und Verkauf der Arbeitskraft Die Wertverändrung des Geldes, das sich in Kapital verwandeln soll, kann nicht an diesem Geld selbst vorgehn, denn als Kaufmittel und als Zahlungsmittel realisiert es nur den Preis der Ware, die es kauft oder zahlt, während es, in seiner eignen Form verharrend, zum Petrefakt von gleichbleibender Wertgröße erstarrt.	ch06_clean.en-ch06_clean.de
Just as little can this change originate in the second act of circulation, the resale of the commodity, for this act merely converts the commodity from its natural form back into its money-form.	Ebensowenig kann die Veränderung aus dem zweiten Zirkulationsakt, dem Wiederverkauf der Ware, entspringen, denn dieser Akt verwandelt die Ware bloß aus der Naturalform zurück in die Geldform.	ch06_clean.en-ch06_clean.de
The change must therefore take place in the commodity which is bought in the first act of circulation, M-C, but not in its value, for it is equivalents which are being exchanged, and the commodity is paid for at its full value.	Die Veränderung muß sich also zutragen mit der Ware, die im ersten Akt G - W gekauft wird, aber nicht mit ihrem Wert, denn es werden Äquivalente ausgetauscht, die Ware wird zu ihrem Werte bezahlt.	ch06_clean.en-ch06_clean.de
The change can therefore originate only in the actual use-value of the commodity, i.e. in its consumption.	Die Veränderung kann also nur entspringen aus ihrem Gebrauchswert als solchem, d.h. aus ihrem Verbrauch.	ch06_clean.en-ch06_clean.de
In order to extract value out of the consumption of a commodity, our friend the money-owner must be lucky enough to find within the sphere of circulation, on the market, a commodity whose use-value possesses the peculiar property of being a source of value, whose actual consumption is therefore itself an objectification [Vergegenständlichung] of labour, hence a creation of value.	Um aus dem Verbrauch einer Ware Wert herauszuziehn, müßte unser Geldbesitzer so glücklich sein, innerhalb der Zirkulationssphäre, auf dem Markt, eine Ware zu entdecken, deren Gebrauchswert selbst die eigentümliche Beschaffenheit besäße, Quelle von Wert zu sein, deren wirklicher Verbrauch also selbst Vergegenständlichung von Arbeit wäre, daher Wertschöpfung.	ch06_clean.en-ch06_clean.de
The possessor of money does find such a special commodity on the market: the capacity for labour [Arbeitsvermögen], in other words labour-power [Arbeitskraft].	Und der Geldbesitzer findet auf dem Markt eine solche spezifische Ware vor - das Arbeitsvermögen oder die Arbeitskraft.	ch06_clean.en-ch06_clean.de
We mean by labour-power, or labour-capacity, the aggregate of those mental and physical capabilities existing in the physical form, the living personality, of a human being, capabilities which he sets in motion whenever he produces a use-value of any kind.	Unter Arbeitskraft oder Arbeitsvermögen verstehen wir den Inbegriff der physischen und geistigen Fähigkeiten, die in der Leiblichkeit, der lebendigen Persönlichkeit eines Menschen existieren und die er in Bewegung setzt, sooft er Gebrauchswerte irgendeiner Art produziert.	ch06_clean.en-ch06_clean.de
But in order that the owner of money may find labour-power on the market as a commodity, various conditions must first be fulfilled.	Damit jedoch der Geldbesitzer die Arbeitskraft als Ware auf dem Markt vorfinde, müssen verschiedne Bedingungen erfüllt sein.	ch06_clean.en-ch06_clean.de
In and for itself, the exchange of commodities implies no other relations of dependence than those which result from its own nature.	Der Warenaustausch schließt an und für sich keine andren Abhängigkeitsverhältnisse ein als die aus seiner eignen Natur entspringenden.	ch06_clean.en-ch06_clean.de
On this assumption, labour-power can appear on the market as a commodity only if, and in so far as, its possessor, the individual whose labour-power it is, offers it for sale or sells it as a commodity.	Unter dieser Voraussetzung kann die Arbeitskraft als Ware nur auf dem Markt erscheinen, sofern und weil sie von ihrem eignen Besitzer, der Person, deren Arbeitskraft sie ist, als Ware feilgeboten oder verkauft wird.	ch06_clean.en-ch06_clean.de
In order that its possessor may sell it as a commodity, he must have it at his disposal, he must be the free proprietor of his own labour-capacity, hence of his person.	Damit ihr Besitzer sie als Ware verkaufe, muß er über sie verfügen können, also freier Eigentümer seines Arbeitsvermögens, seiner Person sein.	ch06_clean.en-ch06_clean.de
He and the owner of money meet in the market, and enter into relations with each other on a footing of equality as owners of commodities, with the sole difference that one is a buyer, the other a seller; both are therefore equal in the eyes of the law.	Er und der Geldbesitzer begegnen sich auf dem Markt und treten in Verhältnis zueinander als ebenbürtige Warenbesitzer, nur dadurch unterschieden, daß der eine Käufer, der andre Verkäufer, beide also juristisch gleiche Personen sind.	ch06_clean.en-ch06_clean.de
For this relation to continue, the proprietor of labour-power must always sell it for a limited period only, for if he were to sell it in a lump, once and for all, he would be selling himself, converting himself from a free man into a slave, from an owner of a commodity into a commodity.	Die Fortdauer dieses Verhältnisses erheischt, daß der Eigentümer der Arbeitskraft sie stets nur für bestimmte Zeit verkaufe, denn verkauft er sie in Bausch und Bogen, ein für allemal, so verkauft er sich selbst, verwandelt sich aus einem Freien in einen Sklaven, aus einem Warenbesitzer in eine Ware.	ch06_clean.en-ch06_clean.de
He must constantly treat his labour-power as his own property, his own commodity, and he can do this only by placing it at the disposal of the buyer, i.e. handing it over to the buyer for him to consume, for a definite period of time, temporarily. In this way he manages both to alienate [veräussern] his labour-power and to avoid renouncing his rights of ownership over it.	Er als Person muß sich beständig zu seiner Arbeitskraft als seinem Eigentum und daher seiner eignen Ware verhalten, und das kann er nur, soweit er sie dem Käufer stets nur vorübergehend, für einen bestimmten Zeittermin, zur Verfügung stellt, zum Verbrauch überläßt, also durch ihre Veräußerung nicht auf sein Eigentum an ihr verzichtet.	ch06_clean.en-ch06_clean.de
The second essential condition which allows the owner of money to find labour-power in the market as a commodity is this, that the possessor of labour-power, instead of being able to sell commodities in which his labour has been objectified, must rather be compelled to offer for sale as a commodity that very labour-power which exists only in his living body.	Die zweite wesentliche Bedingung, damit der Geldbesitzer die Arbeitskraft auf dem Markt als Ware vorfinde, ist die, daß ihr Besitzer, statt Waren verkaufen zu können, worin sich seine Arbeit vergegenständlicht hat, vielmehr seine Arbeitskraft selbst, die nur in seiner lebendigen Leiblichkeit existiert, als Ware feilbieten muß.	ch06_clean.en-ch06_clean.de
In order that a man may be able to sell commodities other than his labour-power, he must of course possess means of production, such as raw materials, instruments of labour, etc.	Damit jemand von seiner Arbeitskraft unterschiedne Waren verkaufe, muß er natürlich Produktionsmittel besitzen, z.B. Rohstoffe, Arbeitsinstrumente usw. Er kann keine Stiefel machen ohne Leder.	ch06_clean.en-ch06_clean.de
No boots can be made without leather.	Er bedarf außerdem Lebensmittel.	ch06_clean.en-ch06_clean.de
He requires also the means of subsistence. Nobody – not even a practitioner of Zukunftsmusik* — can live on the products of the future, or on use-values whose production has not yet been completed; just as on the first day of his appearance on the world’s stage, man must still consume every day, before and while he produces.	Niemand, selbst kein Zukunftsmusikant, kann von Produkten der Zukunft zehren, also auch nicht von Gebrauchswerten, deren Produktion noch unfertig, und wie am ersten Tage seiner Erscheinung auf der Erdbühne, muß der Mensch noch jeden Tag konsumieren, bevor und während er produziert.	ch06_clean.en-ch06_clean.de
If products are produced as commodities, they must be sold after they have been produced, and they can only satisfy the producer’s needs after they have been sold.	Werden die Produkte als Waren produziert, so müssen sie verkauft werden, nachdem sie produziert sind, und können die Bedürfnisse des Produzenten erst nach dem Verkauf befriedigen.	ch06_clean.en-ch06_clean.de
The time necessary for sale must be counted as well as the time of production.	Zur Produktionszeit kommt die für den Verkauf nötige Zeit hinzu.	ch06_clean.en-ch06_clean.de
For the transformation of money into capital, therefore, the owner of money must find the free worker available on the commodity-market; and this worker must be free in the double sense that as a free individual he can dispose of his labour-power as his own commodity, and that, on the other hand, he has no other commodity for sale, i.e. he is rid of them, he is free of all the objects needed for the realization [Verwirklichung] of his labour-power.	Zur Verwandlung von Geld in Kapital muß der Geldbesitzer also den freien Arbeiter auf dem Warenmarkt vorfinden, frei in dem Doppelsinn, daß er als freie Person über seine Arbeitskraft als seine Ware verfügt, daß er andrerseits andre Waren nicht zu verkaufen hat, los und ledig, frei ist von allen zur Verwirklichung seiner Arbeitskraft nötigen Sachen.	ch06_clean.en-ch06_clean.de
Why this free worker confronts him in the sphere of circulation is a question which does not interest the owner of money, for he finds the labour-market in existence as a particular branch of the commodity-market.	Die Frage, warum dieser freie Arbeiter ihm in der Zirkulationssphäre gegenübertritt, interessiert den Geldbesitzer nicht, der den Arbeitsmarkt als eine besondre Abteilung des Warenmarkts vorfindet.	ch06_clean.en-ch06_clean.de
And for the present it interests us just as little.	Und einstweilen interessiert sie uns ebensowenig.	ch06_clean.en-ch06_clean.de
We confine ourselves to the fact theoretically, as he does practically.	Wir halten theoretisch an der Tatsache fest, wie der Geldbesitzer praktisch.	ch06_clean.en-ch06_clean.de
One thing, however, is clear: nature does not produce on the one hand owners of money or commodities, and on the other hand men possessing nothing but their own labour-power.	Eins jedoch ist klar. Die Natur produziert nicht auf der einen Seite Geld- oder Warenbesitzer und auf der andren bloße Besitzer der eignen Arbeitskräfte.	ch06_clean.en-ch06_clean.de
This relation has no basis in natural history, nor does it have a social basis common to all periods of human history.	Dies Verhältnis ist kein naturgeschichtliches und ebensowenig ein gesellschaftliches, das allen Geschichtsperioden gemein wäre.	ch06_clean.en-ch06_clean.de
It is clearly the result of a past historical development, the product of many economic revolutions, of the extinction of a whole series of older formations of social production.	Es ist offenbar selbst das Resultat einer vorhergegangenen historischen Entwicklung, das Produkt vieler ökonomischen Umwälzungen, des Untergangs einer ganzen Reihe älterer Formationen der gesellschaftlichen Produktion.	ch06_clean.en-ch06_clean.de
The economic categories already discussed similarly bear a historical imprint.	Auch die ökonomischen Kategorien, die wir früher betrachtet, tragen ihre geschichtliche Spur.	ch06_clean.en-ch06_clean.de
Definite historical conditions are involved in the existence of the product as a commodity.	Im Dasein des Produkts als Ware sind bestimmte historische Bedingungen eingehüllt.	ch06_clean.en-ch06_clean.de
In order to become a commodity, the product must cease to be produced as the immediate means of subsistence of the producer himself.	Um Ware zu werden, darf das Produkt nicht als unmittelbares Subsistenzmittel für den Produzenten selbst produziert werden.	ch06_clean.en-ch06_clean.de
Had we gone further, and inquired under what circumstances all, or even the majority of products take the form of commodities, we should have found that this only happens on the basis of one particular mode of production, the capitalist one.	Hätten wir weiter geforscht: Unter welchen Umständen nehmen alle oder nimmt auch nur die Mehrzahl der Produkte die Form der Ware an, so hätte sich gefunden, daß dies nur auf Grundlage einer ganz spezifischen, der kapitalistischen Produktionsweise, geschieht.	ch06_clean.en-ch06_clean.de
Such an investigation, however, would have been foreign to the analysis of commodities.	Eine solche Untersuchung lag jedoch der Analyse der Ware fern.	ch06_clean.en-ch06_clean.de
The production and circulation of commodities can still take place even though the great mass of the objects produced are intended for the immediate requirements of their producers, and are not turned into commodities, so that the process of social production is as yet by no means dominated in its length and breadth by exchange-value.	Warenproduktion und Warenzirkulation können stattfinden, obgleich die weit überwiegende Produktenmasse, unmittelbar auf den Selbstbedarf gerichtet, sich nicht in Ware verwandelt, der gesellschaftliche Produktionsprozeß also noch lange nicht in seiner ganzen Breite und Tiefe vom Tauschwert beherrscht ist.	ch06_clean.en-ch06_clean.de
The appearance of products as commodities requires a level of development of the division of labour within society such that the separation of use-value from exchange-value, a separation which first begins with barter, has already been completed.	Die Darstellung des Produkts als Ware bedingt eine so weit entwickelte Teilung der Arbeit innerhalb der Gesellschaft, daß die Scheidung zwischen Gebrauchswert und Tauschwert, die im unmittelbaren Tauschhandel erst beginnt, bereits vollzogen ist.	ch06_clean.en-ch06_clean.de
But such a degree of development is common to many economic formations of society [ökonomische Gesell-schaftsformationen], with the most diverse historical characteristics.	Eine solche Entwicklungsstufe ist aber den geschichtlich verschiedensten ökonomischen Gesellschaftsformationen gemein.	ch06_clean.en-ch06_clean.de
If we go on to consider money, its existence implies that a definite stage in the development of commodity exchange has been reached.	Oder betrachten wir das Geld, so setzt es eine gewisse Höhe des Warenaustausches voraus.	ch06_clean.en-ch06_clean.de
The various forms of money (money as the mere equivalent of commodities, money as means of circulation, money as means of payment, money as hoard, or money as world currency) indicate very different levels of the process of social production, according to the extent and relative preponderance of one function or the other.	Die besondren Geldformen, bloßes Warenäquivalent oder Zirkulationsmittel oder Zahlungsmittel, Schatz und Weltgeld, deuten, je nach dem verschiednen Umfang und dem relativen Vorwiegen einer oder der andren Funktion, auf sehr verschiedne Stufen des gesellschaftlichen Produktionsprozesses.	ch06_clean.en-ch06_clean.de
Yet we know by experience that a relatively feeble development of commodity circulation suffices for the creation of all these forms.	Dennoch genügt erfahrungsmäßig eine relativ schwach entwickelte Warenzirkulation zur Bildung aller dieser Formen.	ch06_clean.en-ch06_clean.de
It is otherwise with capital.	Anders mit dem Kapital.	ch06_clean.en-ch06_clean.de
The historical conditions of its existence are by no means given with the mere circulation of money and commodities.	Seine historischen Existenzbedingungen sind durchaus nicht da mit der Waren- und Geldzirkulation.	ch06_clean.en-ch06_clean.de
It arises only when the owner of the means of production and subsistence finds the free worker available, on the market, as the seller of his own labour-power. And this one historical pre-condition comprises a world’s history.	Es entsteht nur, wo der Besitzer von Produktions- und Lebensmitteln den freien Arbeiter als Verkäufer seiner Arbeitskraft auf dem Markt vorfindet, und diese eine historische Bedingung umschließt eine Weltgeschichte.	ch06_clean.en-ch06_clean.de
Capital, therefore, announces from the outset a new epoch in the process of social production.	Das Kapital kündigt daher von vornherein eine Epoche des gesellschaftlichen Produktionsprozesses an.	ch06_clean.en-ch06_clean.de
This peculiar commodity, labour-power, must now be examined more closely.	Diese eigentümliche Ware, die Arbeitskraft, ist nun näher zu betrachten.	ch06_clean.en-ch06_clean.de
Like all other commodities it has a value.	Gleich allen andren Waren besitzt sie einen Wert.	ch06_clean.en-ch06_clean.de
How is that value determined?	Wie wird er bestimmt?	ch06_clean.en-ch06_clean.de
The value of labour-power is determined, as in the case of every other commodity, by the labour-time necessary for the production, and consequently also the reproduction, of this specific article.	Der Wert der Arbeitskraft, gleich dem jeder andren Ware, ist bestimmt durch die zur Produktion, also auch Reproduktion, dieses spezifischen Artikels notwendige Arbeitszeit.	ch06_clean.en-ch06_clean.de
In so far as it has value, it represents no more than a definite quantity of the average social labour objectified in it.	So sie Wert, repräsentiert die Arbeits- kraft selbst nur ein bestimmtes Quantum in ihr vergegenständlichter gesellschaftlicher Durchschnittsarbeit.	ch06_clean.en-ch06_clean.de
Labour-power exists only as a capacity of the living individual.	Die Arbeitskraft existiert nur als Anlage des lebendigen Individuums.	ch06_clean.en-ch06_clean.de
Its production consequently presupposes his existence.	Ihre Produktion setzt also seine Existenz voraus.	ch06_clean.en-ch06_clean.de
Given the existence of the individual, the production of labour-power consists in his reproduction of himself or his maintenance.	Die Existenz des Individuums gegeben, besteht die Produktion der Arbeitskraft in seiner eignen Reproduktion oder Erhaltung.	ch06_clean.en-ch06_clean.de
For his maintenance he requires a certain quantity of the means of subsistence.	Zu seiner Erhaltung bedarf das lebendige Individuum einer gewissen Summe von Lebensmitteln.	ch06_clean.en-ch06_clean.de
Therefore the labour-time necessary for the production of labour-power is the same as that necessary for the production of those means of subsistence; in other words, the value of labour-power is the value of the means of subsistence necessary for the maintenance of its owner.	Die zur Produktion der Arbeitskraft notwendige Arbeitszeit löst sich also auf in die zur Produktion dieser Lebensmittel notwendige Arbeitszeit, oder der Wert der Arbeitskraft ist der Wert der zur Erhaltung ihres Besitzers notwendigen Lebensmittel.	ch06_clean.en-ch06_clean.de
However, labour-power becomes a reality only by being expressed; it is activated only through labour.	Die Arbeitskraft verwirklicht sich jedoch nur durch ihre Äußerung, betätigt sich nur in der Arbeit.	ch06_clean.en-ch06_clean.de
But in the course of this activity, i.e. labour, a definite quantity of human muscle, nerve, brain, etc. is expended, and these things have to be replaced.	Durch ihre Betätigung, die Arbeit, wird aber ein bestimmtes Quantum von menschlichem Muskel, Nerv, Hirn usw. verausgabt, das wieder ersetzt werden muß.	ch06_clean.en-ch06_clean.de
Since more is expended, more must be received.	Diese vermehrte Ausgabe bedingt eine vermehrte Einnahme.	ch06_clean.en-ch06_clean.de
If the owner of labour-power works today, tomorrow he must again be able to repeat the same process in the same conditions as regards health and strength.	Wenn der Eigentümer der Arbeitskraft heute gearbeitet hat, muß er denselben Prozeß morgen unter denselben Bedingungen von Kraft und Gesundheit wiederholen können.	ch06_clean.en-ch06_clean.de
His means of subsistence must therefore be sufficient to maintain him in his normal state as a working individual.	Die Summe der Lebensmittel muß also hinreichen, das arbeitende Individuum als arbeitendes Individuum in seinem normalen Lebenszustand zu erhalten.	ch06_clean.en-ch06_clean.de
His natural needs, such as food, clothing, fuel and housing vary according to the climatic and other physical peculiarities of his country.	Die natürlichen Bedürfnisse selbst, wie Nahrung, Kleidung, Heizung, Wohnung usw., sind verschieden je nach den klimatischen und andren natürlichen Eigentümlichkeiten eines Landes.	ch06_clean.en-ch06_clean.de
On the other hand, the number and extent of his so-called necessary requirements, as also the manner in which they are satisfied, are themselves products of history, and depend therefore to a great extent on the level of civilization attained by a country; in particular they depend on the conditions in which, and consequently on the habits and expectations with which, the class of free workers has been formed.	Andrerseits ist der Umfang sog. notwendiger Bedürfnisse, wie die Art ihrer Befriedigung, selbst ein historisches Produkt und hängt daher großenteils von der Kulturstufe eines Landes, unter andrem auch wesentlich davon ab, unter welchen Bedingungen, und daher mit welchen Gewohnheiten und Lebensansprüchen die Klasse der freien Arbeiter sich gebildet hat.	ch06_clean.en-ch06_clean.de
In contrast, therefore, with the case of other commodities, the determination of the value of labour-power contains a historical and moral element.	Im Gegensatz zu den andren Waren enthält also die Wertbestimmung der Arbeitskraft ein historisches und moralisches Element.	ch06_clean.en-ch06_clean.de
Nevertheless, in a given country at a given period, the average amount of the means of subsistence necessary for the worker is a known datum.	Für ein bestimmtes Land, zu einer bestimmten Periode jedoch, ist der Durchschnitts-Umkreis der notwendigen Lebensmittel gegeben.	ch06_clean.en-ch06_clean.de
The owner of labour-power is mortal.	Der Eigentümer der Arbeitskraft ist sterblich.	ch06_clean.en-ch06_clean.de
If then his appearance in the market is to be continuous, and the continuous transformation of money into capital assumes this, the seller of labour-power must perpetuate himself ‘in the way that every living individual perpetuates himself, by procreation’.	Soll also seine Erscheinung auf dem Markt eine kontinuierliche sein, wie die kontinuierliche Verwandlung von Geld in Kapital voraussetzt, so muß der Verkäufer der Arbeitskraft sich verewigen, "wie jedes lebendige Individuum sich verewigt, durch Fortpflanzung".	ch06_clean.en-ch06_clean.de
The labour-power withdrawn from the market by wear and tear, and by death, must be continually replaced by, at the very least, an equal amount of fresh labour-power.	Die durch Abnutzung und Tod dem Markt entzogenen Arbeitskräfte müssen zum allermindesten durch eine gleiche Zahl neuer Arbeitskräfte beständigt ersetzt werden.	ch06_clean.en-ch06_clean.de
Hence the sum of means of subsistence necessary for the production of labour-power must include the means necessary for the worker’s replacements, i.e. his children, in order that this race of peculiar commodity-owners may perpetuate its presence on the market.	Die Summe der zur Produktion der Arbeitskraft notwendigen Lebensmittel schließt also die Lebensmittel der Ersatzmänner ein, d.h. der Kinder der Arbeiter, so daß sich diese Race eigentümlicher Warenbesitzer auf dem Warenmarkte verewigt.	ch06_clean.en-ch06_clean.de
In order to modify the general nature of the human organism in such a way that it acquires skill and dexterity in a given branch of industry, and becomes labour-power of a developed and specific kind, a special education or training is needed, and this in turn costs an equivalent in commodities of a greater or lesser amount.	Um die allgemein menschliche Natur so zu modifizieren, daß sie Geschick und Fertigkeit in einem bestimmten Arbeitszweig erlangt, entwickelte und spezifische Arbeitskraft wird, bedarf es einer bestimmten Bildung oder Erziehung, welche ihrerseits eine größere oder geringere Summe von Warenäquivalenten kostet.	ch06_clean.en-ch06_clean.de
The costs of education vary according to the degree of complexity of the labour-power required.	Je nach dem mehr oder minder vermittelten Charakter der Arbeitskraft sind ihre Bildungskosten verschieden.	ch06_clean.en-ch06_clean.de
These expenses (exceedingly small in the case of ordinary labour-power) form a part of the total value spent in producing it.	Diese Erlernungskosten, verschwindend klein für die gewöhnliche Arbeitskraft, gehn also ein in den Umkreis der zu ihrer Produktion verausgabten Werte.	ch06_clean.en-ch06_clean.de
The value of labour-power can be resolved into the value of a definite quantity of the means of subsistence.	Der Wert der Arbeitskraft löst sich auf in den Wert einer bestimmten Summe von Lebensmitteln.	ch06_clean.en-ch06_clean.de
It therefore varies with the value of the means of subsistence, i.e. with the quantity of labour-time required to produce them.	Er wechselt daher auch mit dem Wert dieser Lebensmittel, d.h. der Größe der zu ihrer Produktion erheischten Arbeitszeit.	ch06_clean.en-ch06_clean.de
Some of the means of subsistence, such as food and fuel, are consumed every day, and must therefore be replaced every day.	Ein Teil der Lebensmittel, z.B. Nahrungsmittel, Heizungsmittel usw., werden täglich neu verzehrt und müssen täglich neu ersetzt werden.	ch06_clean.en-ch06_clean.de
Others, such as clothes and furniture, last for longer periods and need to be replaced only at longer intervals.	Andre Lebensmittel, wie Kleider, Möbel usw., verbrauchen sich in längeren Zeiträumen und sind daher nur in längeren Zeiträumen zu ersetzen.	ch06_clean.en-ch06_clean.de
Articles of one kind must be bought or paid for every day, others every week, others every quarter and so on.	Waren einer Art müssen täglich, andre wöchentlich, vierteljährlich usf. gekauft oder gezahlt werden.	ch06_clean.en-ch06_clean.de
But in whatever way the sum total of these outlays may be spread over the year, they must be covered by the average income, taking one day with another.	Wie sich die Summe dieser Ausgaben aber immer während eines Jahres z.B. verteilen möge, sie muß gedeckt sein durch die Durchschnittseinnahme tagein, tagaus.	ch06_clean.en-ch06_clean.de
If the total of the commodities required every day for the production of labour-power = A, and of those required every week = B, and of those required every quarter = C, and so on, the daily average of these commodities = 365A + 52B + 4C +…/365.	Wäre die Masse der täglich zur Produktion der Arbeitskraft erheischten Waren = A, die der wöchentlich erheischten = B, die der vierteljährlich erheischten = C usw., so wäre der täglich Durchschnitt dieser Waren = 365A + 52B + 4C + usw./365.	ch06_clean.en-ch06_clean.de
Suppose that this mass of commodities required for the average day contains 6 hours of social labour, then every day half a day of average social labour is objectified in labour-power, or in other words half a day of labour is required for the daily production of labour-power.	Gesetzt, in dieser für den Durchschnittstag nötigen Warenmasse steckten 6 Stunden gesellschaftlicher Arbeit, so vergegenständlicht sich in der Arbeitskraft täglich ein halber Tag gesellschaftlicher Durchschnittsarbeit, oder ein halber Arbeitstag ist zur täglichen Produktion der Arbeitskraft erheischt.	ch06_clean.en-ch06_clean.de
This quantity of labour forms the value of a day’s labour-power, or the value of the labour-power reproduced every day.	Dies zu ihrer täglichen Produktion erheischte Arbeitsquantum bildet den Tageswert der Arbeitskraft oder den Wert der täglich reproduzierten Arbeitskraft.	ch06_clean.en-ch06_clean.de
If half a day of average social labour is present in 3 shillings, then 3 shillings is the price corresponding to the value of a day’s labour-power.	Wenn sich ein halber Tag gesellschaftlicher Durchschnittsarbeit ebenfalls in einer Goldmasse von 3 sh. oder einem Taler darstellt, so ist ein Taler der dem Tauschwert der Arbeitskraft entsprechende Preis.	ch06_clean.en-ch06_clean.de
If its owner therefore offers it for sale at 3 shillings a day, its selling price is equal to its value, and according to our original assumption the owner of money, who is intent on transforming his 3 shillings into capital, pays this value.	Bietet der Besitzer der Arbeitskraft sie feil für einen Taler täglich, so ist ihr Verkaufspreis gleich ihrem Wert und, nach unsrer Voraussetzung, zahlt der auf Verwandlung seiner Taler in Kapital erpichte Geldbesitzer diesen Wert.	ch06_clean.en-ch06_clean.de
The ultimate or minimum limit of the value of labour-power is formed by the value of the commodities which have to be supplied every day to the bearer of labour-power, the man, so that he can renew his life-process.	Die letzte Grenze oder Minimalgrenze des Werts der Arbeitskraft wird gebildet durch den Wert einer Warenmasse, ohne deren tägliche Zufuhr der Träger der Arbeitskraft, der Mensch, seinen Lebensprozeß nicht erneuern kann, also durch den Wert der physisch unentbehrlichen Lebensmittel.	ch06_clean.en-ch06_clean.de
That is to say, the limit is formed by the value of the physically indispensable means of subsistence.	Sinkt der Preis der Arbeitskraft auf diese Minimum, so sinkt er unter ihren Wert, denn sie kann sich so nur in verkümmerter Form erhalten und entwickeln.	ch06_clean.en-ch06_clean.de
If the price of labour-power falls to this minimum, it falls below its value, since under such circumstances it can be maintained and developed only in a crippled state, and the value of every commodity is determined by the labour-time required to provide it in its normal quality.	Der Wert jeder Ware ist aber bestimmt durch die Arbeitszeit, erfordert, um sie in normaler Güte zu liefern.	ch06_clean.en-ch06_clean.de
It is an extraordinarily cheap kind of sentimentality which declares that this method of determining the value of labour-power, a method prescribed by the very nature of the case, is brutal, and which laments with Rossi in this matter: ‘To conceive capacity for labour (puissance de travail) in abstraction from the workers’ means of subsistence during the production process is to conceive a phantom (être de raison).	Es ist eine außerordentlich wohlfeile Sentimentalität, diese aus der Natur der Sache fließende Wertbestimmung der Arbeitskraft grob zu finden und etwa mit Rossi zu jammern: "Das Arbeitsvermögen (puissance de travail) begreifen, während man von den Subsistenzmitteln der Arbeit während des Produktionsprozesses abstrahiert, heißt ein Hirngespinst (être de raison) begreifen.	ch06_clean.en-ch06_clean.de
When we speak of labour, or capacity for labour, we speak at the same time of the worker and his means of subsistence, of the worker and his wages.’	Wer Arbeit sagt, wer Arbeitsvermögen sagt, sagt zugleich Arbeiter und Subsistenzmittel, Arbeiter und Arbeitslohn."	ch06_clean.en-ch06_clean.de
When we speak of capacity for labour, we do not speak of labour, any more than we speak of digestion when we speak of capacity for digestion.	Wer Arbeitsvermögen sagt, sagt nicht Arbeit, so wenig als wer Verdauungsvermögen sagt, Verdauen sagt.	ch06_clean.en-ch06_clean.de
As is well known, the latter process requires something more than a good stomach.	Zum letztren Prozeß ist bekanntlich mehr als ein guter Magen erfordert.	ch06_clean.en-ch06_clean.de
When we speak of capacity for labour, we do not abstract from the necessary means of subsistence.	Wer Arbeitsvermögen sagt, abstrahiert nicht von den zu seiner Subsistenz notwendigen Lebensmitteln.	ch06_clean.en-ch06_clean.de
On the contrary, their value is expressed in its value.	Ihr Wert ist vielmehr ausgedrückt in seinem Wert.	ch06_clean.en-ch06_clean.de
If his capacity for labour remains unsold, this is of no advantage to the worker. He will rather feel it to be a cruel nature-imposed necessity that his capacity for labour has required for its production a definite quantity of the means of subsistence, and will continue to require this for its reproduction.	Wird es nicht verkauft, so nützt es dem Arbeiter nichts, so empfindet er es vielmehr als eine grausame Naturnotwendigkeit, daß sein Arbeitsvermögen ein bestimmtes Quantum Subsistenzmittel zu seiner Produktion erheischt hat und stets wieder von neuem zu seiner Reproduktion erheischt.	ch06_clean.en-ch06_clean.de
Then, like Sismondi, he will discover that ‘the capacity for labour… is nothing unless it is sold’.	Er entdeckt dann mit Sismondi: "Das Arbeitsvermögen ... ist nichts, wenn es nicht verkauft wird" .	ch06_clean.en-ch06_clean.de
One consequence of the peculiar nature of labour-power as a commodity is this, that it does not in reality pass straight away into the hands of the buyer on the conclusion of the contract between buyer and seller.	Die eigentümliche Natur dieser spezifischen Ware, der Arbeitskraft, bringt es mit sich, daß mit der Abschließung des Kontrakts zwischen Käufer und Verkäufer ihr Gebrauchswert noch nicht wirklich in die Hand des Käufers übergegangen ist.	ch06_clean.en-ch06_clean.de
Its value, like that of every other commodity, is already determined before it enters into circulation, for a definite quantity of social labour has been spent on the production of the labour-power. But its use-value consists in the subsequent exercise of that power.	Ihr Wert, gleich dem jeder andren Ware, war bestimmt, bevor sie in die Zirkulation trat, denn ein bestimmtes Quantum gesellschaftlicher Arbeit ward zur Produktion der Arbeitskraft verausgabt, aber ihr Gebrauchswert besteht erst in der nachträglichen Kraftäußerung.	ch06_clean.en-ch06_clean.de
The alienation [Veräusserung] of labour-power and its real manifestation [Äusserung], i.e. the period of its existence as a use-value, do not coincide in time.	Die Veräußerung der Kraft und ihre wirkliche Äußerung, d.h. ihr Dasein als Gebrauchswert, fallen daher der Zeit nach auseinander.	ch06_clean.en-ch06_clean.de
But in those cases in which the formal alienation by sale of the use-value of a commodity is not simultaneous with its actual transfer to the buyer, the money of the buyer serves as means of payment.	Bei solchen Waren aber , wo die formelle Veräußerung des Gebrauchswerts durch den Verkauf und seine wirkliche Überlassung an den Käufer der Zeit nach auseinanderfallen, funktioniert das Geld des Käufers meist als Zahlungsmittel.	ch06_clean.en-ch06_clean.de
In every country where the capitalist mode of production prevails, it is the custom not to pay for labour-power until it has been exercised for the period fixed by the contract, for example, at the end of each week.	In allen Ländern kapitalistischer Produktionsweise wird die Arbeitskraft erst gezahlt, nachdem sie bereits während des im Kaufkontrakt festgesetzten Termins funktioniert hat, z.B. am Ende jeder Woche.	ch06_clean.en-ch06_clean.de
In all cases, therefore, the worker advances the use-value of his labour-power to the capitalist. He lets the buyer consume it before he receives payment of the price. Everywhere the worker allows credit to the capitalist.	Überall schießt daher der Arbeiter dem Kapitalisten den Gebrauchswert der Arbeitskraft vor; er läßt sie vom Käufer konsumieren, bevor er ihrem Preis bezahlt erhält, überall kreditiert daher der Arbeiter dem Kapitalisten.	ch06_clean.en-ch06_clean.de
That this credit is no mere fiction is shown not only by the occasional loss of the wages the worker has already advanced, when a capitalist goes bankrupt, but also by a series of more long-lasting consequences.	Daß dies Kreditieren kein leerer Wahn ist, zeigt nicht nur der gelegentliche Verlust des kreditierten Lohns beim Bankrott des Kapitalisten , sondern auch eine Reihe mehr nachhaltiger Wirkungen.	ch06_clean.en-ch06_clean.de
Whether money serves as a means of purchase or a means of payment, this does not alter the nature of the exchange of commodities.	Indes ändert es an der Natur des Warenaustausches selbst nichts, ob das Geld als Kaufmittel oder als Zahlungsmittel funktioniert.	ch06_clean.en-ch06_clean.de
The price of the labour-power is fixed by the contract, although it is not realized till later, like the rent of a house.	Der Preis der Arbeitskraft ist kontraktlich festgesetzt, obgleich er erst hinterher realisiert wird, wie der Mietpreis eines Hauses.	ch06_clean.en-ch06_clean.de
The labour-power is sold, although it is paid for only at a later period.	Die Arbeitskraft ist verkauft, obgleich sie erst hinterher bezahlt wird.	ch06_clean.en-ch06_clean.de
It will therefore be useful, if we want to conceive the relation in its pure form, to presuppose for the moment that the possessor of labour-power, on the occasion of each sale, immediately receives the price stipulated in the contract.	Für die reine Auffassung des Verhältnisses ist es jedoch nützlich, einstweilen vorauszusetzen, daß der Besitzer der Arbeitskraft mit ihrem Verkauf jedesmal auch sogleich den kontraktlich stipulierten Preis erhält.	ch06_clean.en-ch06_clean.de
We now know the manner of determining the value paid by the owner of money to the owner of this peculiar commodity, labour-power.	Wir kennen nun die Art und Weise der Bestimmung des Werts, welcher dem Besitzer dieser eigentümlichen Ware, der Arbeitskraft, vom Geldbesitzer gezahlt wird.	ch06_clean.en-ch06_clean.de
The use-value which the former gets in exchange manifests itself only in the actual utilization, in the process of the consumption of the labour-power.	Der Gebrauchswert, den letztrer seinerseits im Austausch erhält, zeigt sich erst im wirklichen Verbrauch, im Konsumtionsprozeß der Arbeitskraft.	ch06_clean.en-ch06_clean.de
The money-owner buys everything necessary for this process, such as raw material, in the market, and pays the full price for it.	Alle zu diesem Prozeß nötigen Dinge, wie Rohmaterial usw., kauft der Geldbesitzer auf dem Warenmarkt und zahlt sie zum vollen Preis.	ch06_clean.en-ch06_clean.de
The process of the consumption of labour-power is at the same time the production process of commodities and of surplus-value.	Der Konsumtionsprozeß der Arbeitskraft ist zugleich der Produktionsprozeß von Ware und von Mehrwert.	ch06_clean.en-ch06_clean.de
The consumption of labour-power is completed, as in the case of every other commodity, outside the market or the sphere of circulation.	Die Konsumtion der Arbeitskraft, gleich der Konsumtion jeder andren Ware, vollzieht sich außerhalb des Markts oder der Zirkulationssphäre.	ch06_clean.en-ch06_clean.de
Let us therefore, in company with the owner of money and the owner of labour-power, leave this noisy sphere, where everything takes place on the surface and in full view of everyone, and follow them into the hidden abode of production, on whose threshold there hangs the notice ‘No admittance except on business’. Here we shall see, not only how capital produces, but how capital is itself produced.	Diese geräuschvolle, auf der Oberfläche hausende und aller Augen zugängliche Sphäre verlassen wir daher, zusammen mit Geldbesitzer und Arbeitskraftbesitzer, um beiden nachzufolgen in die verborgne Stätte der Produktion, an deren Schwelle zu lesen steht: No admittance except on business. <Eintritt nur in Geschäftsangelegenheiten.> Hier wird sich zeigen, nicht nur wie das Kapital produziert, sondern auch wie man es selbst produziert, das Kapital.	ch06_clean.en-ch06_clean.de
The secret of profit-making must at last be laid bare.	Das Geheimnis der Plusmacherei muß sich endlich enthüllen.	ch06_clean.en-ch06_clean.de
The sphere of circulation or commodity exchange, within whose boundaries the sale and purchase of labour-power goes on, is in fact a very Eden of the innate rights of man.	Die Sphäre der Zirkulation oder des Warenaustausches, innerhalb deren Schranken Kauf und Verkauf der Arbeitskraft sich bewegt, war in der Tat ein wahres Eden der angebornen Menschenrechte.	ch06_clean.en-ch06_clean.de
It is the exclusive realm of Freedom, Equality, Property and Bentham.	Was allein hier herrscht, ist Freiheit, Gleichheit, Eigentum und Bentham.	ch06_clean.en-ch06_clean.de
Freedom, because both buyer and seller of a commodity, let us say of labour-power, are determined only by their own free will.	Freiheit! Denn Käufer und Verkäufer einer Ware, z.B. der Arbeitskraft, sind nur durch ihren freien Willen bestimmt.	ch06_clean.en-ch06_clean.de
They contract as free persons, who are equal before the law.	Sie kontrahieren als freie, rechtlich ebenbürtige Personen.	ch06_clean.en-ch06_clean.de
Their contract is the final result in which their joint will finds a common legal expression.	Der Kontrakt ist das Endresultat, worin sich ihre Willen einen gemeinsamen Rechtsausdruck geben.	ch06_clean.en-ch06_clean.de
Equality, because each enters into relation with the other, as with a simple owner of commodities, and they exchange equivalent for equivalent.	Gleichheit! Denn sie beziehen sich nur als Warenbesitzer aufeinander und tauschen Äquivalent für Äquivalent.	ch06_clean.en-ch06_clean.de
Property, because each disposes only of what is his own.	Eigentum! Denn jeder verfügt nur über das Seine.	ch06_clean.en-ch06_clean.de
And Bentham, because each looks only to his own advantage.	Bentham! Denn jedem von den beiden ist es nur um sich zu tun.	ch06_clean.en-ch06_clean.de
The only force bringing them together, and putting them into relation with each other, is the selfishness, the gain and the private interest of each.	Die einzige Macht, die sie zusammen und in ein Verhältnis bringt, ist die ihres Eigennutzes, ihres Sondervorteils, ihrer Privatinteressen.	ch06_clean.en-ch06_clean.de
Each pays heed to himself only, and no one worries about the others. And precisely for that reason, either in accordance with the pre-established harmony of things, or under the auspices of an omniscient providence, they all work together to their mutual advantage, for the common weal, and in the common interest.	Und eben weil so jeder nur für sich und keiner für den andren kehrt, vollbringen alle, infolge einer prästabilierten Harmonie der Dinge oder unter den Auspizien einer allpfiffigen Vorsehung, nur das Werk ihres wechselseitigen Vorteils, des Gemeinnutzens, des Gesamtinteresses.	ch06_clean.en-ch06_clean.de
When we leave this sphere of simple circulation or the exchange of commodities, which provides the ‘free-trader vulgaris’ with his views, his concepts and the standard by which he judges the society of capital and wage-labour, a certain change takes place, or so it appears, in the physiognomy of our dramatis personae.	Beim Scheiden von dieser Sphäre der einfachen Zirkulation oder des Warenaustausches, woraus der Freihändler vulgaris Anschauungen, Be- griffe und Maßstab für sein Urteil über die Gesellschaft des Kapitals und der Lohnarbeit entlehnt, verwandelt sich, so scheint es, schon in etwas die Physiognomie unsrer dramatis personae.	ch06_clean.en-ch06_clean.de
He who was previously the money-owner now strides out in front as a capitalist; the possessor of labour-power follows as his worker. The one smirks self-importantly and is intent on business; the other is timid and holds back, like someone who has brought his own hide to market and now has nothing else to expect but – a tanning.	Der ehemalige Geldbesitzer schreitet voran als Kapitalist, der Arbeitskraftbesitzer folgt ihm nach als sein Arbeiter; der eine bedeutungsvoll schmunzelnd und geschäftseifrig, der andre scheu, widerstrebsam, wie jemand, der seine eigne Haut zu Markt getragen und nun nichts andres zu erwarten hat als die - Gerberei.	ch06_clean.en-ch06_clean.de

