Chapter 7: The Labour Process and the Valorization Process 1. THE LABOUR PROCESS The use of labour-power is labour itself.	FÜNFTES KAPITEL Arbeitsprozeß und Verwertungsprozeß 1. Arbeitsprozeß Der Gebrauch der Arbeitskraft ist die Arbeit selbst.	ch07_clean.en-ch07_clean.de
The purchaser of labour-power consumes it by setting the seller of it to work.	Der Käufer der Arbeitskraft konsumiert sie, indem er ihren Verkäufer arbeiten läßt.	ch07_clean.en-ch07_clean.de
By working, the latter becomes in actuality what previously he only was potentially, namely labour-power in action, a worker.	Letztrer wird hierdurch actu <tatsächlich> sich betätigende Arbeitskraft, Arbeiter, was er früher nur potentia <dem Vermögen nach> war.	ch07_clean.en-ch07_clean.de
In order to embody his labour in commodities, he must above all embody it in use-values, things which serve to satisfy needs of one kind or another.	Um seine Arbeit in Waren darzustellen, muß er sie vor allem in Gebrauchswerten darstellen, Sachen, die zur Befriedigung von Bedürfnissen irgendeiner Art dienen.	ch07_clean.en-ch07_clean.de
Hence what the capitalist sets the worker to produce is a particular use-value, a specific article.	Es ist also ein besondrer Gebrauchtwert, ein bestimmter Artikel, den der Kapitalist vom Arbeiter anfertigen läßt.	ch07_clean.en-ch07_clean.de
The fact that the production of use-values, or goods, is carried on under the control of a capitalist and on his behalf does not alter the general character of that production.	Die Produktion von Gebrauchswerten oder Gütern ändert ihre allgemeine Natur nicht dadurch, daß sie für den Kapitalisten und unter seiner Kontrolle vorgeht.	ch07_clean.en-ch07_clean.de
We shall therefore, in the first place, have to consider the labour process independently of any specific social formation.	Der Arbeitsprozeß ist daher zunächst unabhängig von jeder bestimmten gesellschaftlichen Form zu betrachten.	ch07_clean.en-ch07_clean.de
Labour is, first of all, a process between man and nature, a process by which man, through his own actions, mediates, regulates and controls the metabolism between himself and nature.	Die Arbeit ist zunächst ein Prozeß zwischen Mensch und Natur, ein Prozeß, worin der Mensch seinen Stoffwechsel mit der Natur durch seine eigne Tat vermittelt, regelt und kontrolliert.	ch07_clean.en-ch07_clean.de
He confronts the materials of nature as a force of nature.	Er tritt dem Naturstoff selbst als eine Naturmacht gegenüber.	ch07_clean.en-ch07_clean.de
He sets in motion the natural forces which belong to his own body, his arms, legs, head and hands, in order to appropriate the materials of nature in a form adapted to his own needs.	Die seiner Leiblichkeit angehörigen Naturkräfte, Arme und Beine, Kopf und Hand, setzt er in Bewegung, um sich den Naturstoff in einer für sein eignes Leben brauchbaren Form anzueignen.	ch07_clean.en-ch07_clean.de
Through this movement he acts upon external nature and changes it, and in this way he simultaneously changes his own nature.	Indem er durch diese Bewegung auf die Natur außer ihm wirkt und sie verändert, verändert er zugleich seine eigne Natur.	ch07_clean.en-ch07_clean.de
He develops the potentialities slumbering within nature, and subjects the play of its forces to his own sovereign power.	Er entwickelt die in ihr schlummernden Potenzen und unterwirft das Spiel ihrer Kräfte seiner eignen Botmäßigkeit.	ch07_clean.en-ch07_clean.de
We are not dealing here with those first instinctive forms of labour which remain on the animal level.	Wir haben es hier nicht mit den ersten tierartig instinktmäßigen Formen der Arbeit zu tun.	ch07_clean.en-ch07_clean.de
An immense interval of time separates the state of things in which a man brings his labour-power to market for sale as a commodity from the situation when human labour had not yet cast off its first instinctive form.	Dem Zustand, worin der Arbeiter als Verkäufer seiner eignen Arbeitskraft auf dem Warenmarkt auftritt, ist in urzeitlichen Hintergrund der Zustand entrückt, worin die menschliche Arbeit ihre erste instinktartige Form noch nicht abgestreift hatte.	ch07_clean.en-ch07_clean.de
We presuppose labour in a form in which it is an exclusively human characteristic.	Wir unterstellen die Arbeit in einer Form, worin sie dem Menschen ausschließlich angehört.	ch07_clean.en-ch07_clean.de
A spider conducts operations which resemble those of the weaver, and a bee would put many a human architect to shame by the construction of its honeycomb cells.	Eine Spinne verrichtet Operationen, die denen des Webers ähneln, und eine Biene beschämt durch den Bau ihrer Wachszellen manchen menschlichen Baumeister.	ch07_clean.en-ch07_clean.de
But what distinguishes the worst architect from the best of bees is that the architect builds the cell in his mind before he constructs it in wax.	Was aber von vornherein den schlechtesten Baumeister vor der besten Biene auszeichnet, ist, daß er die Zelle in seinem Kopf gebaut hat, bevor er sie in Wachs baut.	ch07_clean.en-ch07_clean.de
At the end of every labour process, a result emerges which had already been conceived by the worker at the beginning, hence already existed ideally.	Am Ende des Arbeitsprozesses kommt ein Resultat heraus, das beim Beginn desselben schon in der Vorstellung des Arbeiters, also schon ideell vorhanden war.	ch07_clean.en-ch07_clean.de
Man not only effects a change of form in the materials of nature; he also realizes [ver-wirklicht] his own purpose in those materials. And this is a purpose he is conscious of, it determines the mode of his activity with the rigidity of a law, and he must subordinate his will to it.	Nicht daß er nur eine Formveränderung des Natürlichen bewirkt; er verwirklicht im Natürlichen zugleich seinen Zweck, den er weiß, der die Art und Weise seines Tuns als Gesetz bestimmt und dem er seine Willen unterordnen muß.	ch07_clean.en-ch07_clean.de
This subordination is no mere momentary act.	Und diese Unterordnung ist kein vereinzelter Akt.	ch07_clean.en-ch07_clean.de
Apart from the exertion of the working organs, a purposeful will is required for the entire duration of the work.		ch07_clean.en-ch07_clean.de
This means close attention. The less he is attracted by the nature of the work and the way in which it has to be accomplished, and the less, therefore, he enjoys it as the free play of his own physical and mental powers, the closer his attention is forced to be.	Außer der Anstrengung der Organe, die arbeiten, ist der zweckmäßige Wille, der sich als Aufmerksamkeit äußert, für die ganze Dauer der Arbeit erheischt, und um so mehr, je weniger sie durch den eignen Inhalt und die Art und Weise ihrer Ausführung den Arbeiter mit sich fortreißt, je weniger er sie daher als Spiel seiner eignen körperlichen und geistigen Kräfte genießt.	ch07_clean.en-ch07_clean.de
The simple elements of the labour process are (1) purposeful activity, that is work itself, (2) the object on which that work is performed, and (3) the instruments of that work.	Die einfachen Momente des Arbeitsprozesses sind die zweckmäßige Tätigkeit oder die Arbeit selbst, ihr Gegenstand und ihr Mittel.	ch07_clean.en-ch07_clean.de
The land (and this, economically speaking, includes water) in its original state in which it supplies man with necessaries or means of subsistence ready to hand is available without any effort on his part as the universal material for human labour.	Die Erde (worunter ökonomisch auch das Wasser einbegriffen), wie sie den Menschen ursprünglich mit Proviant, fertigen Lebensmitteln ausrüstet , findet sich ohne sein Zutun als der allgemeine Gegenstand der menschlichen Arbeit vor.	ch07_clean.en-ch07_clean.de
All those things which labour merely separates from immediate connection with their environment are objects of labour spontaneously provided by nature, such as fish caught and separated from their natural element, namely water, timber felled in virgin forests, and ores extracted from their veins.	Alle Dinge, welche die Arbeit nur von ihrem unmittelbaren Zusammenhang mit dem Erdganzen loslöst, sind von Natur vorgefundne Arbeitsgegenstände. So der Fisch, der von seinem Lebenselement, dem Wasser, getrennt, gefangen wird, das Holz, das im Urwald gefällt, das Erz, das aus seiner Ader losgebrochen wird.	ch07_clean.en-ch07_clean.de
If, on the other hand, the object of labour has, so to speak, been filtered through previous labour, we call it raw material.	Ist der Arbeitsgegenstand dagegen selbst schon sozusagen durch frühere Arbeit filtriert, so nennen wir ihn Rohmaterial.	ch07_clean.en-ch07_clean.de
For example, ore already extracted and ready for washing.	Z.B. das bereits losgebrochene Erz, das nun ausgewaschen wird.	ch07_clean.en-ch07_clean.de
All raw material is an object of labour [Arbeitsgegen-stand], but not every object of labour is raw material; the object of labour counts as raw material only when it has already undergone some alteration by means of labour. * An instrument of labour is a thing, or a complex of things, which the worker interposes between himself and the object of his labour and which serves as a conductor, directing his activity onto that object.	Alles Rohmaterial ist Arbeitsgegenstand, aber nicht jeder Arbeitsgegenstand ist Rohmaterial. Rohmaterial ist der Arbeitsgegenstand nur, sobald er bereits eine durch Arbeit vermittelte Veränderung erfahren hat. Das Arbeitsmittel ist ein Ding oder ein Komplex von Dingen, die der Arbeiter zwischen sich und den Arbeitsgegenstand schiebt und die ihm als Leiter seiner Tätigkeit auf diesen Gegenstand dienen.	ch07_clean.en-ch07_clean.de
He makes use of the mechanical, physical and chemical properties of some substances in order to set them to work on other substances as instruments of his power, and in accordance with his purposes.	Er benutzt die mechanischen, physikalischen, chemischen Eigenschaften der Dinge, um sie als Machtmittel auf andre Dinge, seinem Zweck gemäß, wirken zu lassen.	ch07_clean.en-ch07_clean.de
Leaving out of consideration such ready-made means of subsistence as fruits, in gathering which a man’s bodily organs alone serve as the instruments of his labour, the object the worker directly takes possession of is not the object of labour but its instrument.	Der Gegenstand, dessen sich der Arbeiter unmittelbar bemächtigt - abgesehn von der Ergreifung fertiger Lebensmittel, der Früchte z.B., wobei seine eignen Leibesorgane allein als Arbeitsmittel dienen - ist nicht der Arbeitsgegenstand, sondern das Arbeitsmittel.	ch07_clean.en-ch07_clean.de
Thus nature becomes one of the organs of his activity, which he annexes to his own bodily organs, adding stature to himself in spite of the Bible.	So wird das Natürliche selbst zum Organ seiner Tätigkeit, ein Organ, das er seinen eignen Leibesorganen hinzufügt, seine natürliche Gestalt verlängernd, trotz der Bibel.	ch07_clean.en-ch07_clean.de
As the earth is his original larder, so too it is his original tool house.	Wie die Erde seine ursprüngliche Proviantkammer, ist sie sein ursprüngliches Arsenal von Arbeitsmitteln.	ch07_clean.en-ch07_clean.de
It supplies him, for instance, with stones for throwing, grinding, pressing, cutting, etc. The earth itself is an instrument of labour, but its use in this way, in agriculture, presupposes a whole series of other instruments and a comparatively high stage of development of labour-power.	Sie liefert ihm z.B. den Stein, womit er wirft, reibt, drückt, schneidet usw. Die Erde selbst ist ein Arbeitsmittel, setzt jedoch zu ihrem Dienst als Arbeitsmittel in der Agrikultur wieder eine ganze Reihe andrer Arbeitsmittel und eine schon relativ hohe Entwicklung der Arbeitskraft voraus.	ch07_clean.en-ch07_clean.de
As soon as the labour process has undergone the slightest development, it requires specially prepared instruments.	Sobald überhaupt der Arbeitsprozeß nur einigermaßen entwickelt ist, bedarf er bereits bearbeiteter Arbeitsmittel.	ch07_clean.en-ch07_clean.de
Thus we find stone implements and weapons in the oldest caves.	In den ältesten Menschenhöhlen finden wir Steinwerkzeuge und Steinwaffen.	ch07_clean.en-ch07_clean.de
In the earliest period of human history, domesticated animals, i.e. animals that have undergone modification by means of labour, that have been bred specially, play the chief part as instruments of labour along with stones, wood, bones and shells, which have also had work done on them.	Neben bearbeitetem Stein, Holz, Knochen und Muscheln spielt im Anfang der Menschengeschichte das gezähmte, also selbst schon durch Arbeit veränderte, gezüchtete Tier die Hauptrolle als Arbeitsmittel.	ch07_clean.en-ch07_clean.de
The use and construction of instruments of labour, although present in germ among certain species of animals, is characteristic of the specifically human labour process, and Franklin therefore defines man as ‘a tool-making animal’.	Der Gebrauch und die Schöpfung von Arbeitsmitteln, obgleich im Keim schon gewissen Tierarten eigen, charakterisieren den spezifisch menschlichen Arbeitsprozeß, und Franklin definiert daher den Menschen als "a toolmaking animal", ein Werkzeuge fabrizierendes Tier.	ch07_clean.en-ch07_clean.de
Relics of bygone instruments of labour possess the same importance for the investigation of extinct economic formations of society as do fossil bones for the determination of extinct species of animals.	Dieselbe Wichtigkeit, welche der Bau von Knochenreliquien für die Erkenntnis der Organisation untergegangner Tiergeschlechter, haben Reliquien von Arbeitsmitteln für die Beurteilung untergegangner ökonomischer Gesellschaftsformationen.	ch07_clean.en-ch07_clean.de
It is not what is made but how, and by what instruments of labour, that distinguishes different economic epochs.	Nicht was gemacht wird, sondern wie, mit welchen Arbeitsmitteln gemacht wird, unterscheidet die ökonomischen Epochen.	ch07_clean.en-ch07_clean.de
Instruments of labour, not only supply a standard of the degree of development which human labour has attained, but they also indicate the social relations within which men work.	Die Arbeitsmittel sind nicht nur Gradmesser der Entwicklung der menschlichen Arbeitskraft, sondern auch Anzeiger der gesellschaftlichen Verhältnisse, worin gearbeitet wird.	ch07_clean.en-ch07_clean.de
Among the instruments of labour, those of a mechanical kind, which, taken as a whole, we may call the bones and muscles of production, offer much more decisive evidence of the character of a given social epoch of production than those which, like pipes, tubs, baskets, jars etc., serve only to hold the materials for labour, and may be given the general denotation of the vascular system of production. The latter first begins to play an important part in the chemical industries.	Unter den Arbeitsmitteln selbst bieten die mechanischen Arbeitsmittel, deren Gesamtheit man das Knochen- und Muskelsystem der Produktion nennen kann, viel entscheidendere Charaktermerkmale einer gesellschaftlichen Produktionsepoche als solche Arbeitsmittel, die nur zu Behältern des Arbeitsgegenstandes dienen und deren Gesamtheit ganz allgemein als das Gefäßsystem der Produktion bezeichnet werden kann, wie z.B. Röhren, Fässer, Körbe, Krüge usw. Erst in der chemischen Fabrikation spielen sie eine bedeutungsvolle Rolle.	ch07_clean.en-ch07_clean.de
In a wider sense we may include among the instruments of labour, in addition to things through which the impact of labour on its object is mediated, and which therefore, in one way or another, serve as conductors of activity, all the objective conditions necessary for carrying on the labour process.	(5a) Im weitren Sinn zählt der Arbeitsprozeß unter seine Mittel außer den Dingen, welche die Wirkung der Arbeit auf ihren Gegenstand vermitteln und daher in einer oder der andren Weise als Leiter der Tätigkeit dienen, alle gegenständlichen Bedingungen, die überhaupt erheischt sind, damit der Prozeß stattfinde.	ch07_clean.en-ch07_clean.de
These do not enter directly into the process, but without them it is either impossible for it to take place, or possible only to a partial extent.	Sie gehn nicht direkt in ihn ein, aber er kann ohne sie gar nicht oder nur unvollkommen vorgehn.	ch07_clean.en-ch07_clean.de
Once again, the earth itself is a universal instrument of this kind, for it provides the worker with the ground beneath his feet and a ‘field of employment’ for his own particular process.	Das allgemeine Arbeitsmittel dieser Art ist wieder die Erde selbst, denn sie gibt dem Arbeiter den locus standi <Standort> und seinem Prozeß den Wirkungsraum (field of employment).	ch07_clean.en-ch07_clean.de
Instruments of this kind, which have already been mediated through past labour, include workshops, canals, roads, etc. In the labour process, therefore, man’s activity, via the instruments of labour, effects an alteration in the object of labour which was intended from the outset.	Durch die Arbeit schon vermittelte Arbeitsmittel dieser Art sind z.B. Arbeitsgebäude, Kanäle, Straßen usw. Im Arbeitsprozeß bewirkt also die Tätigkeit des Menschen durch das Arbeitsmittel eine von vornherein bezweckte Veränderung des Arbeitsgegenstandes.	ch07_clean.en-ch07_clean.de
The process is extinguished in the product.	Der Prozeß erlischt im Produkt.	ch07_clean.en-ch07_clean.de
The product of the process is a use-value, a piece of natural material adapted to human needs by means of a change in its form.	Sein Produkt ist ein Gebrauchswert, ein durch Formveränderung menschlichen Bedürfnissen angeeigneter Naturstoff.	ch07_clean.en-ch07_clean.de
Labour has become bound up in its object: labour has been objectified, the object has been worked on.	Die Arbeit hat sich mit ihrem Gegenstand verbunden. Sie ist vergegenständlicht, und der Gegenstand ist verarbeitet.	ch07_clean.en-ch07_clean.de
What on the side of the worker appeared in the form of unrest [Unruhe] now appears, on the side of the product, in the form of being [Sein], as a fixed, immobile characteristic.	Was auf seiten des Arbeiters in der Form der Unruhe erschien, erscheint nun als ruhende Eigenschaft, in der Form des Seins, auf seiten des Produkts.	ch07_clean.en-ch07_clean.de
The worker has spun, and the product is a spinning. * If we look at the whole process from the point of view of its result, the product, it is plain that both the instruments and the object of labour are means of production and that the labour itself is productive labour.	Er hat gesponnen, und das Produkt ist ein Gespinst. Betrachtet man den ganzen Prozeß vom Standpunkt seines Resultats, des Produkts, so erscheinen beide, Arbeitsmittel und Arbeitsgegenstand, als Produktionsmittel und die Arbeit selbst als produktive Arbeit .	ch07_clean.en-ch07_clean.de
Although a use-value emerges from the labour process, in the form of a product, other use-values, products of previous labour, enter into it as means of production.	Wenn ein Gebrauchswert als Produkt aus dem Arbeitsprozeß herauskommt, gehn andre Gebrauchswerte, Produkte frührer Arbeitsprozesse, als Produktionsmittel in ihn ein.	ch07_clean.en-ch07_clean.de
The same use-value is both the product of a previous process, and a means of production in a later process.	Derselbe Gebrauchswert, der das Produkt dieser, bildet das Produktionsmittel jener Arbeit.	ch07_clean.en-ch07_clean.de
Products are therefore not only results of labour, but also its essential conditions.	Produkte sind daher nicht nur Resultat, sondern zugleich Bedingung des Arbeitsprozesses.	ch07_clean.en-ch07_clean.de
With the exception of the extractive industries, such as mining, hunting, fishing (and agriculture, but only in so far as it starts by breaking up virgin soil), where the material for labour is provided directly by nature, all branches of industry deal with raw material, i.e. an object of labour which has already been filtered through labour, which is itself already a product of labour.	Mit Ausnahme der extraktiven Industrie, die ihren Arbeitsgegenstand von Natur vorfindet, wie Bergbau, Jagd, Fischfang usw. (der Ackerbau nur, soweit er in erster Instanz die jungfräuliche Erde selbst aufbricht), behandeln alle Industriezweige einen Gegenstand, der Rohmaterial, d.h. bereits durch die Arbeit filtrierter Arbeitsgegenstand, selbst schon Arbeitsprodukt ist.	ch07_clean.en-ch07_clean.de
An example is seed in agriculture.	So z.B. der Samen in der Agrikultur.	ch07_clean.en-ch07_clean.de
Animals and plants which we are accustomed to consider as products of nature, may be, in their present form, not only products of, say, last year’s labour, but the result of a gradual transformation continued through many generations under human control, and through the agency of human labour.	Tiere und Pflanzen, die man als Naturprodukte zu betrachten pflegt, sind nicht nur Produkte vielleicht der Arbeit vom vorigen Jahr, sondern, in ihren jetzigen Formen, Produkte einer durch viele Generationen unter menschlicher Kontrolle, vermittelst menschlicher Arbeit, fortgesetzten Umwandlung.	ch07_clean.en-ch07_clean.de
As regards the instruments of labour in particular, they show traces of the labour of past ages, even to the most superficial observer, in the great majority of cases.	Was aber die Arbeitsmittel insbesondre betrifft, so zeigt ihre ungeheure Mehrzahl dem oberflächlichsten Blick die Spur vergangner Arbeit.	ch07_clean.en-ch07_clean.de
Raw material may either form the principal substance of a product, or it may enter into its formation only as an accessory.	Das Rohmaterial kann die Hauptsubstanz eines Produkts bilden oder nur als Hilfsstoff in seine Bildung eingehn.	ch07_clean.en-ch07_clean.de
An accessory may be consumed by the instruments of labour, such as coal by a steam-engine, oil by a wheel, hay by draft-horses, or it may be added to the raw material in order to produce some physical modification of it, as chlorine is added to unbleached linen, coal to iron, dye to wool, or again it may help to accomplish the work itself, as in the case of the materials used for heating and lighting workshops.	Der Hilfsstoff wird vom Arbeitsmittel konsumiert, wie Kohle von der Dampfmaschine, Öl vom Rade, Heu vom Zugpferd, oder dem Rohmaterial zugesetzt, um darin eine stoffliche Veränderung zu bewirken, wie Chlor zur ungebleichten Leinwand, Kohle zum Eisen, Farbe zur Wolle, oder er unterstützt die Verrichtung der Arbeit selbst, wie z.B. zur Beleuchtung und Heizung des Arbeitslokals verwandte Stoffe.	ch07_clean.en-ch07_clean.de
The distinction between principal substance and accessory vanishes in the chemical industries proper, because there none of the raw material re-appears, in its original composition, in the substance of the product.	Der Unterschied zwischen Hauptstoff und Hilfsstoff verschwimmt in der eigentlich chemischen Fabrikation, weil keines der angewandten Rohmaterialien als die Substanz des Produkts wieder erscheint.	ch07_clean.en-ch07_clean.de
Every object possesses various properties, and is thus capable of being applied to different uses. The same product may therefore form the raw material for very different labour processes.	Da jedes Ding vielerlei Eigenschaften besitzt und daher verschiedner Nutzanwendung fähig ist, kann dasselbe Produkt das Rohmaterial sehr verschiedner Arbeitsprozesse bilden.	ch07_clean.en-ch07_clean.de
Corn, for example, is a raw material for millers, starch-manufacturers, distillers and cattle-breeders.	Korn z.B. ist Rohmaterial für Müller, Stärkefabrikant, Destillateur, Viehzüchter usw. Es wird Rohmaterial seiner eignen Produktion als Samen.	ch07_clean.en-ch07_clean.de
It also enters as raw material into its own production in the shape of seed; coal both emerges from the mining industry as a product and enters into it as a means of production.	So geht die Kohle als Produkt aus der Minenindustrie hervor und als Produktionsmittel in sie ein.	ch07_clean.en-ch07_clean.de
Again, a particular product may be used as both instrument of labour and raw material in the same process.	Dasselbe Produkt mag in demselben Arbeitsprozeß als Arbeitsmittel und Rohmaterial dienen.	ch07_clean.en-ch07_clean.de
Take, for instance, the fattening of cattle, where the animal is the raw material, and at the same time an instrument for the production of manure.	Bei der Viehmast z.B., wo das Vieh, das bearbeitete Rohmaterial, zugleich Mittel der Düngerbereitung ist.	ch07_clean.en-ch07_clean.de
A product, though ready for immediate consumption, may nevertheless serve as raw material for a further product, as grapes do when they become the raw material for wine.	Ein Produkt, das in einer für die Konsumtion fertigen Form existiert, kann von neuem zum Rohmaterial eines andren Produkts werden, wie die Traube zum Rohmaterial des Weins.	ch07_clean.en-ch07_clean.de
On the other hand, labour may release its product in such a form that it can only be used as raw material.	Oder die Arbeit entläßt ihr Produkt in Formen, worin es nur wieder als Rohmaterial brauchbar ist.	ch07_clean.en-ch07_clean.de
Raw material in this condition, such as cotton, thread and yarn, is called semi-manufactured, but should rather be described as having been manufactured up to a certain level. Although itself already a product, this raw material may have to go through a whole series of different processes, and in each of these it serves as raw material, changing its shape constantly, until it is precipitated from the last process of the series in finished form, either as means of subsistence or as instrument of labour.	Rohmaterial in diesem Zustand heißt Halbfabrikat und hieße besser Stufenfabrikat, wie z.B. Baumwolle, Faden, Garn usw. Obgleich selbst schon Produkt, mag das ursprüngliche Rohmaterial eine ganze Staffel verschiedner Prozesse zu durchlaufen haben, worin es in stets veränderter Gestalt stets von neuem als Rohmaterial funktioniert bis zum letzten Arbeitsprozeß, der es als fertiges Lebensmittel oder fertiges Arbeitsmittel von sich abstößt.	ch07_clean.en-ch07_clean.de
Hence we see that whether a use-value is to be regarded as raw material, as instrument of labour or as product is determined entirely by its specific function in the labour process, by the position it occupies there: as its position changes, so do its determining characteristics.	Man sieht: Ob ein Gebrauchswert als Rohmaterial, Arbeitsmittel oder Produkt erscheint, hängt ganz und gar ab von seiner bestimmten Funktion im Arbeitsprozesse, von der Stelle, die er in ihm einnimmt, und mit dem Wechsel dieser Stelle wechseln jene Bestimmungen.	ch07_clean.en-ch07_clean.de
Therefore, whenever products enter as means of production into new labour processes, they lose their character of being products and function only as objective factors contributing to living labour.	Durch ihren Eintritt als Produktionsmittel in neue Arbeitsprozesse verlieren Produkte daher den Charakter des Produkts. Sie funktionieren nur noch als gegenständliche Faktoren der lebendigen Arbeit.	ch07_clean.en-ch07_clean.de
A spinner treats spindles only as a means for spinning, and flax as the material he spins.	Der Spinner behandelt die Spindel nur als Mittel, womit, den Flachs nur als Gegenstand, den er spinnt.	ch07_clean.en-ch07_clean.de
Of course it is impossible to spin without material and spindles; and therefore the availability of these products is presupposed at the beginning of the spinning operation.	Allerdings kann man nicht spinnen ohne Spinnmaterial und Spindel. Das Vorhandensein dieser Produkte <4. Auflage: dieses Produkts> ist daher vorausgesetzt beim Beginn des Spinnens.	ch07_clean.en-ch07_clean.de
But in the process itself, the fact that they are the products of past labour is as irrelevant as, in the case of the digestive process, the fact that bread is the product of the previous labour of the farmer, the miller and the baker.	In diesem Prozeß selbst aber ist es ebenso gleichgültig, daß Flachs und Spindel Produkte vergangner Arbeit sind, wie es im Akt der Ernährung gleichgültig ist, daß Brot das Produkt der vergangnen Arbeiten von Bauer, Müller, Bäcker usw. Umgekehrt.	ch07_clean.en-ch07_clean.de
On the contrary, it is by their imperfections that the means of production in any process bring to our attention their character of being the products of past labour.	Machen Produktionsmittel im Arbeitsprozeß ihren Charakter als Produkte vergangner Arbeit geltend, so durch ihre Mängel.	ch07_clean.en-ch07_clean.de
A knife which fails to cut, a piece of thread which keeps on snapping, forcibly remind us of Mr A, the cutler, or Mr B, the spinner. In a successful product, the role played by past labour in mediating its useful properties has been extinguished.	Ein Messer, das nicht schneidet, Garn, das beständig zerreißt usw., erinnern lebhaft an Messerschmied A und Garnwichser E. Im gelungnen Produkt ist die Vermittlung seiner Gebrauchseigenschaften durch vergangne Arbeit ausgelöscht.	ch07_clean.en-ch07_clean.de
A machine which is not active in the labour process is useless.	Eine Maschine, die nicht im Arbeitsprozeß dient, ist nutzlos.	ch07_clean.en-ch07_clean.de
In addition, it falls prey to the destructive power of natural processes.	Außerdem verfällt sie der zerstörenden Gewalt des natürlichen Stoffwechsels.	ch07_clean.en-ch07_clean.de
Iron rusts; wood rots.	Das Eisen verrostet, das Holz verfault.	ch07_clean.en-ch07_clean.de
Yarn with which we neither weave nor knit is cotton wasted.	Garn, das nicht verwebt oder verstrickt wird, ist verdorbne Baumwolle.	ch07_clean.en-ch07_clean.de
Living labour must seize on these things, awaken them from the dead, change them from merely possible into real and effective use-values.	Die lebendige Arbeit muß diese Dinge ergreifen, sie von den Toten erwecken, sie aus nur möglichen in wirkliche und wirkende Gebrauchswerte verwandeln.	ch07_clean.en-ch07_clean.de
Bathed in the fire of labour, appropriated as part of its organism, and infused with vital energy for the performance of the functions appropriate to their concept and to their vocation in the process, they are indeed consumed, but to some purpose, as elements in the formation of new use-values, new products, which are capable of entering into individual consumption as means of subsistence or into a new labour process as means of production.	Vom Feuer der Arbeit beleckt, als Leiber derselben angeeignet, zu ihren begriffs- und berufsmäßigen Funktionen im Prozeß begeistet, werden sie zwar auch verzehrt, aber zweckvoll, als Bildungselemente neuer Gebrauchswerte, neuer Produkte, die fähig sind, als Lebensmittel in die individuelle Konsumtion oder als Produktionsmittel in neuen Arbeitsprozeß einzugehn.	ch07_clean.en-ch07_clean.de
If then, on the one hand, finished products are not only results of the labour process, but also conditions of its existence, their induction into the process, their contact with living labour, is the sole means by which they can be made to retain their character of use-values, and be realized.	Wenn also vorhandne Produkte nicht nur Resultate, sondern auch Existenzbedingungen des Arbeitsprozesses sind, ist andrerseits ihr Hineinwerfen in ihn, also ihr Kontakt mit lebendiger Arbeit, das einzige Mittel, um diese Produkte vergangner Arbeit als Gebrauchswerte zu erhalten und zu verwirklichen.	ch07_clean.en-ch07_clean.de
Labour uses up its material elements, its objects and its instruments. It consumes them, and is therefore a process of consumption.	Die Arbeit verbraucht ihre stofflichen Elemente, ihren Gegenstand und ihr Mittel, verspeist dieselben und ist also Konsumtionsprozeß.	ch07_clean.en-ch07_clean.de
Such productive consumption is distinguished from individual consumption by this, that the latter uses up products as means of subsistence for the living individual; the former, as means of subsistence for labour, i.e. for the activity through which the living individual’s labour-power manifests itself.	Diese produktive Konsumtion unterscheidet sich dadurch von der individuellen Konsumtion, daß letztere die Produkte als Lebensmittel des lebendigen Individuums, erstere sie als Lebensmittel der Arbeit, seiner sich betätigenden Arbeitskraft, verzehrt.	ch07_clean.en-ch07_clean.de
Thus the product of individual consumption is the consumer himself; the result of productive consumption is a product distinct from the consumer.	Das Produkt der individuellen Konsumtion ist daher der Konsument selbst, das Resultat der produktiven Konsumtion ein vom Konsumenten unterschiednes Produkt.	ch07_clean.en-ch07_clean.de
In so far then as its instruments and its objects are themselves products, labour consumes products in order to create products, or in other words consumes one set of products by turning them into means of production for another set.	Sofern ihr Mittel und ihr Gegenstand selbst schon Produkte sind, verzehrt die Arbeit Produkte, um Produkte zu schaffen, oder vernutzt Produkte als Produktionsmittel von Produkten.	ch07_clean.en-ch07_clean.de
But just as the labour process originally took place only between man and the earth (which was available independently of any human action), so even now we still employ in the process many means of production which are provided directly by nature and do not represent any combination of natural substances with human labour.	Wie der Arbeitsprozeß aber ursprünglich nur zwischen dem Menschen und der ohne sein Zutun vorhandnen Erde vorgeht, dienen in ihm immer noch auch solche Produktionsmittel, die von Natur vorhanden, keine Verbindung von Naturstoff und menschlicher Arbeit darstellen.	ch07_clean.en-ch07_clean.de
The labour process, as we have just presented it in its simple and abstract elements, is purposeful activity aimed at the production of use-values.	Der Arbeitsprozeß, wie wir ihn in seinen einfachen und abstrakten Momenten dargestellt haben, ist zweckmäßige Tätigkeit zur Herstellung von Gebrauchswerten, Aneignung des Natürlichen für menschliche Bedürfnisse, allgemeine Bedingung des Stoffwechsels zwischen Mensch und Natur, ewige Naturbedingung des menschlichen Lebens und daher unabhängig von jeder Form dieses Lebens, vielmehr allen seinen Gesellschaftsformen gleich gemeinsam.	ch07_clean.en-ch07_clean.de
It is an appropriation of what exists in nature for the requirements of man.	Wir hatten daher nicht nötig, den Arbeiter im Verhältnis zu andren Arbeitern darzustellen.	ch07_clean.en-ch07_clean.de
It is the universal condition for the metabolic interaction [Stoffwechsel] between man and nature, the everlasting nature-imposed condition of human existence, and it is therefore independent of every form of that existence, or rather it is common to all forms of society in which human beings live.		ch07_clean.en-ch07_clean.de
We did not, therefore, have to present the worker in his relationship with other workers; it was enough to present man and his labour on one side, nature and its materials on the other.	Der Mensch und seine Arbeit auf der einen, die Natur und ihre Stoffe auf der andren Seite genügten.	ch07_clean.en-ch07_clean.de
The taste of porridge does not tell us who grew the oats, and the process we have presented does not reveal the conditions under which it takes place, whether it is happening under the slave-owner’s brutal lash or the anxious eye of the capitalist, whether Cincinnatus undertakes it in tilling his couple of acres,* or a savage, when he lays low a wild beast with a stone.	So wenig man dem Weizen anschmeckt, wer ihn gebaut hat, so wenig sieht man diesem Prozeß an, unter welchen Bedingungen er vorgeht, ob unter der brutalen Peitsche des Sklavenaufsehers oder unter dem ängstlichen Auge des Kapitalisten, ob Cincinnatus ihn verrichtet in der Bestellung seiner paar jugera <Morgen> oder der Wilde, der mit einem Stein eine Bestie erlegt.	ch07_clean.en-ch07_clean.de
Let us now return to our would-be capitalist.	Kehren wir zu unsrem Kapitalisten in spe zurück.	ch07_clean.en-ch07_clean.de
We left him just after he had purchased, in the open market, all the necessary factors of the labour process; its objective factors, the means of production, as well as its personal factor, labour-power.	Wir verließen ihn, nachdem er auf dem Warenmarkt alle zu einem Arbeitsprozeß notwendigen Faktoren gekauft hatte, die gegenständlichen Faktoren oder die Produktionsmittel, den persönlichen Faktor oder die Arbeitskraft.	ch07_clean.en-ch07_clean.de
With the keen eye of an expert, he has selected the means of production and the kind of labour-power best adapted to his particular trade, be it spinning, bootmaking or any other kind.	Er hat mit schlauem Kennerblick die für sein besondres Geschäft, Spinnerei, Stiefelfabrikation usw., passenden Produktionsmittel und Arbeitskräfte ausgewählt.	ch07_clean.en-ch07_clean.de
He then proceeds to consume the commodity, the labour-power he has just bought, i.e. he causes the worker, the bearer of that labour-power, to consume the means of production by his labour.	Unser Kapitalist setzt sich also daran, die von ihm gekaufte Ware, die Arbeitskraft, zu konsumieren, d.h., er läßt den Träger der Arbeitskraft, den Arbeiter, die Produktionsmittel durch seine Arbeit konsumieren.	ch07_clean.en-ch07_clean.de
The general character of the labour process is evidently not changed by the fact that the worker works for the capitalist instead of for himself; moreover, the particular methods and operations employed in bootmaking or spinning are not immediately altered by the intervention of the capitalist.	Die allgemeine Natur des Arbeitsprozesses ändert sich natürlich nicht dadurch, daß der Arbeiter ihn für den Kapitalisten, statt für sich selbst verrichtet. Aber auch die bestimmte Art und Weise, wie man Stiefel macht oder Garn spinnt, kann sich zunächst nicht ändern durch die Dazwischenkunft des Kapitalisten.	ch07_clean.en-ch07_clean.de
He must begin by taking the labour-power as he finds it in the market, and consequently he must be satisfied with the kind of labour which arose in a period when there were as yet no capitalists.	Er muß die Arbeitskraft zunächst nehmen, wie er sie auf dem Markt vorfindet, also auch ihre Arbeit, wie sie in einer Periode entsprang, wo es noch keine Kapitalisten gab.	ch07_clean.en-ch07_clean.de
The transformation of the mode of production itself which results from the subordination of labour to capital can only occur later on, and we shall therefore deal with it in a later chapter.	Die Verwandlung der Produktionsweise selbst durch die Unterordnung der Arbeit unter das Kapital kann sich erst später ereignen und ist daher erst später zu betrachten.	ch07_clean.en-ch07_clean.de
The labour process, when it is the process by which the capitalist consumes labour-power, exhibits two characteristic phenomena.	Der Arbeitsprozeß, wie er als Konsumtionsprozeß der Arbeitskraft durch den Kapitalisten vorgeht, zeigt nun zwei eigentümliche Phänomene.	ch07_clean.en-ch07_clean.de
First, the worker works under the control of the capitalist to whom his labour belongs; the capitalist takes good care that the work is done in a proper manner, and the means of production are applied directly to the purpose, so that the raw material is not wasted, and the instruments of labour are spared, i.e. only worn to the extent necessitated by their use in the work.	Der Arbeiter arbeitet unter der Kontrolle des Kapitalisten, dem seine Arbeit gehört. Der Kapitalist paßt auf, daß die Arbeit ordentlich vonstatten geht und die Produktionsmittel zweckmäßig verwandt werden, also kein Rohmaterial vergeudet und das Arbeitsinstrument geschont, d.h. nur so weit zerstört wird, als sein Gebrauch in der Arbeit ernötigt.	ch07_clean.en-ch07_clean.de
Secondly, the product is the property of the capitalist and not that of the worker, its immediate producer.	Zweitens aber: Das Produkt ist Eigentum des Kapitalisten, nicht des unmittelbaren Produzenten, des Arbeiters.	ch07_clean.en-ch07_clean.de
Suppose that a capitalist pays for a day’s worth of labour-power; then the right to use that power for a day belongs to him, just as much as the right to use any other commodity, such as a horse he had hired for the day.	Der Kapitalist zahlt z.B. den Tageswert der Arbeitskraft. Ihr Gebrauch, wie der jeder andren Ware, z.B. eines Pferdes, das er für einen Tag gemietet, gehört ihm also für den Tag.	ch07_clean.en-ch07_clean.de
The use of a commodity belongs to its purchaser, and the seller of labour-power, by giving his labour, does no more, in reality, than part with the use-value he has sold.	Dem Käufer der Ware gehört der Gebrauch der Ware, und der Besitzer der Arbeitskraft gibt in der Tat nur den von ihm verkauften Gebrauchswert, indem er seine Arbeit gibt.	ch07_clean.en-ch07_clean.de
From the instant he steps into the workshop, the use-value of his labour-power and therefore also its use, which is labour, belongs to the capitalist.	Von dem Augenblicke, wo er in die Werkstätte des Kapitalisten trat, gehörte der Gebrauchswert seiner Arbeitskraft, also ihr Gebrauch, die Arbeit, dem Kapitalisten.	ch07_clean.en-ch07_clean.de
By the purchase of labour-power, the capitalist incorporates labour, as a living agent of fermentation, into the lifeless constituents of the product, which also belong to him.	Der Kapitalist hat durch den Kauf der Arbeitskraft die Arbeit selbst als lebendigen Gärungsstoff den toten ihm gleichfalls gehörigen Bildungselementen des Produkts einverleibt.	ch07_clean.en-ch07_clean.de
From his point of view, the labour process is nothing more than the consumption of the commodity purchased, i.e. of labour-power; but he can consume this labour-power only by adding the means of production to it.	Von seinem Standpunkt ist der Arbeitsprozeß nur die Konsumtion der von ihm gekauften Ware Arbeitskraft, die er jedoch nur konsumieren kann, indem er ihr Produktionsmittel zusetzt.	ch07_clean.en-ch07_clean.de
The labour process is a process between things the capitalist has purchased, things which belong to him.	Der Arbeitsprozeß ist ein Prozeß zwischen Dingen, die der Kapitalist gekauft hat, zwischen ihm gehörigen Dingen.	ch07_clean.en-ch07_clean.de
Thus the product of this process belongs to him just as much as the wine which is the product of the process of fermentation going on in his cellar.	Das Produkt dieses Prozesses gehört ihm daher ganz ebensosehr als das Produkt des Gärungsprozesses in seinem Weinkeller.	ch07_clean.en-ch07_clean.de
2. THE VALORIZATION PROCESS The product – the property of the capitalist – is a use-value, as yarn, for example, or boots. But although boots are, to some extent, the basis of social progress, and our capitalist is decidedly in favour of progress, he does not manufacture boots for their own sake.	2. Verwertungsprozeß Das Produkt - das Eigentum des Kapitalisten - ist ein Gebrauchswert, Garn, Stiefel usw. Aber obgleich Stiefel z.B. gewissermaßen die Basis des gesellschaftlichen Fortschritts bilden und unser Kapitalist ein entschiedner Fortschrittsmann ist, fabriziert er die Stiefel nicht ihrer selbst wegen.	ch07_clean.en-ch07_clean.de
Use-value is certainly not la chose qu’on aime pour lui-même* in the production of commodities.	Der Gebrauchswert ist überhaupt nicht das Ding qu'on aime pour lui-même <das man um seiner selbst willen liebt> in der Warenproduktion.	ch07_clean.en-ch07_clean.de
Use-values are produced by capitalists only because and in so far as they form the material substratum of exchange-value, are the bearers of exchange-value.	Gebrauchswerte werden hier überhaupt nur produziert, weil und sofern sie materielles Substrat, Träger des Tauschwerts sind. Und unsrem Kapitalisten handelt es sich um zweierlei.	ch07_clean.en-ch07_clean.de
Our capitalist has two objectives: in the first place, he wants to produce a use-value which has exchange-value, i.e. an article destined to be sold, a commodity; and secondly he wants to produce a commodity greater in value than the sum of the values of the commodities used to produce it, namely the means of production and the labour-power he purchased with his good money on the open market.	Erstens will er einen Gebrauchswert produzieren, der einen Tauschwert hat, einen zum Verkauf bestimmten Artikel, eine Ware. Und zweitens will er eine Ware produzieren, deren Wert höher als die Wertsumme der zu ihrer Produktion erheischten Waren, der Produktionsmittel und der Arbeitskraft, für die er sein gutes Geld auf dem Warenmarkt vorschoß.	ch07_clean.en-ch07_clean.de
His aim is to produce not only a use-value, but a commodity; not only use-value, but value; and not just value, but also surplus-value.	Er will nicht nur einen Gebrauchswert produzieren, sondern eine Ware, nicht nur Gebrauchswert, sondern Wert, und nicht nur Wert, sondern auch Mehrwert.	ch07_clean.en-ch07_clean.de
It must be borne in mind that we are now dealing with the production of commodities, and that up to this point we have considered only one aspect of the process.	In der Tat, da es sich hier um Warenproduktion handelt, haben wir bisher offenbar nur eine Seite des Prozesses betrachtet.	ch07_clean.en-ch07_clean.de
Just as the commodity itself is a unity formed of use-value and value, so the process of production must be a unity, composed of the labour process and the process of creating value [Wertbildungsprozess].	Wie die Ware selbst Einheit von Gebrauchswert und Wert, muß ihr Produktionsprozeß Einheit von Arbeitsprozeß und Wertbildungsprozeß sein.	ch07_clean.en-ch07_clean.de
Let us now examine production as a process of creating value.	Betrachten wir den Produktionsprozeß nun auch als Wertbildungsprozeß.	ch07_clean.en-ch07_clean.de
We know that the value of each commodity is determined by the quantity of labour materialized in its use-value, by the labour-time socially necessary to produce it.	Wir wissen, daß der Wert jeder Ware bestimmt ist durch das Quantum der in ihrem Gebrauchswert materialisierten Arbeit, durch die zu ihrer Produktion gesellschaftlich notwendige Arbeitszeit.	ch07_clean.en-ch07_clean.de
This rule also holds good in the case of the product handed over to the capitalist as a result of the labour-process.	Dies gilt auch für das Produkt, das sich unsrem Kapitalisten als Resultat des Arbeitsprozesses ergab.	ch07_clean.en-ch07_clean.de
Assuming this product to be yarn, our first step is to calculate the quantity of labour objectified in it.	Es ist also zunächst die in diesem Produkt vergegenständlichte Arbeit zu berechnen. Es sei z.B. Garn.	ch07_clean.en-ch07_clean.de
For spinning the yarn, raw material is required; suppose in this case 10 lb. of cotton.	Zur Herstellung des Garns war zuerst sein Rohmaterial nötig, z.B. 10 Pfund Baumwolle.	ch07_clean.en-ch07_clean.de
We have no need at present to investigate the value of this cotton, for our capitalist has, we will assume, bought it at its full value, say 10 shillings.	Was der Wert der Baumwolle, ist nicht erst zu untersuchen, denn der Kapitalist hat sie auf dem Markt zu ihrem Wert, z.B. zu 10 sh. gekauft.	ch07_clean.en-ch07_clean.de
In this price the labour required for the production of the cotton is already expressed in terms of average social labour.	In dem Preise der Baumwolle ist die zu ihrer Produktion erheischte Arbeit schon als allgemein gesellschaftliche Arbeit dargestellt.	ch07_clean.en-ch07_clean.de
We will further assume that the wear and tear of the spindle, which for our present purpose may represent all other instruments of labour employed, amounts to the value of 2 shillings.	Wir wollen ferner annehmen, daß die in der Verarbeitung der Baumwolle verzehrte Spindelmasse, die uns alle andren aufgewandten Arbeitsmittel repräsentiert, einen Wert von 2 sh. besitzt.	ch07_clean.en-ch07_clean.de
If then, twenty-four hours of labour, or two working days, are required to produce the quantity of gold represented by 12 shillings, it follows first of all that two days of labour are objectified in the yarn.	Ist eine Goldmasse von 12 sh. das Produkt von 24 Arbeitsstunden oder zwei Arbeitstagen, so folgt zunächst, daß im Garn zwei Arbeitstage vergegenständlicht sind.	ch07_clean.en-ch07_clean.de
We should not let ourselves be misled by the circumstance that the cotton has changed its form and the worn-down portion of the spindle has entirely disappeared.	Der Umstand, daß die Baumwolle ihre Form verändert hat und die aufgezehrte Spindelmasse ganz verschwunden ist, darf nicht beirren.	ch07_clean.en-ch07_clean.de
According to the general law of value, if the value of 40 lb. of yarn = the value of 40 lb. of cotton + the value of a whole spindle, i.e. if the same amount of labour-time is required to produce the commodities on either side of this equation, then 10 lb. of yarn are an equivalent for 10 lb. of cotton, together with a quarter of a spindle.	Nach dem allgemeinen Wertgesetz sind z.B. 10 Pfund Garn ein Äquivalent für 10 Pfund Baumwolle und 1/4 Spindel, wenn der Wert von 40 Pfund Garn = dem Wert von 40 Pfund Baumwolle + dem Wert einer ganzen Spindel, d.h., wenn dieselbe Arbeitszeit erfordert ist, um beide Seiten dieser Gleichung zu produzieren.	ch07_clean.en-ch07_clean.de
In the case we are considering, the same amount of labour-time is represented in the 10 lb. of yarn on the one hand, and in the 10 lb. of cotton and the fraction of a spindle on the other.	In diesem Fall stellt sich dieselbe Arbeitszeit das eine Mal in dem Gebrauchswert Garn, das andre Mal in den Gebrauchswerten Baumwolle und Spindel dar.	ch07_clean.en-ch07_clean.de
It is therefore a matter of indifference whether value appears in cotton, in a spindle or in yarn: its amount remains the same.	Der Wert ist also gleichgültig dagegen, ob er in Garn, Spindel oder Baumwolle erscheint.	ch07_clean.en-ch07_clean.de
The spindle and cotton, instead of resting quietly side by side, join together in the process, their forms are altered, and they are turned into yarn; but their value is no more affected by this fact than it would be if they had been simply exchanged for their equivalent in yarn.	Daß Spindel und Baumwolle, statt ruhig nebeneinander zu liegen, im Spinnprozesse eine Verbindung eingehn, welche ihre Gebrauchsformen verändert, sie in Garn Verwandelt, berührt ihren Wert ebensowenig, als wenn sie durch einfachen Austausch gegen ein Äquivalent von Garn umgesetzt worden wären.	ch07_clean.en-ch07_clean.de
The labour-time required for the production of the cotton, the raw material of the yarn, is part of the labour necessary to produce the yarn, and is therefore contained in the yarn.	Die zur Produktion der Baumwolle erheischte Arbeitszeit ist Teil der zur Produktion des Garns, dessen Rohmaterial sie bildet, erheischten Arbeitszeit und deshalb im Garn enthalten.	ch07_clean.en-ch07_clean.de
The same applies to the labour embodied in the spindle, without whose wear and tear the cotton could not be spun.	Ebenso verhält es sich mit der Arbeitszeit, die zur Produktion der Spindelmasse erheischt ist, ohne deren Verschleiß oder Konsum die Baumwolle nicht versponnen werden kann.	ch07_clean.en-ch07_clean.de
Hence in determining the value of the yarn, or the labour-time required for its production, all the special processes carried on at various times and in different places which were necessary, first to produce the cotton and the wasted portion of the spindle, and then with the cotton and the spindle to spin the yarn, may together be looked on as different and successive phases of the same labour process.	Soweit also der Wert des Garns, die zu seiner Herstellung erheischte Arbeitszeit, in Betrachtung kommt, können die verschiednen besondren, der Zeit und dem Raum nach getrennten Arbeitsprozesse, die durchlaufen werden müssen, um die Baumwolle selbst und die vernutzte Spindelmasse zu produzieren, endlich aus Baumwolle und Spindel Garn zu machen, als verschiedne aufeinander folgende Phasen eines und desselben Arbeitsprozesses betrachtet werden.	ch07_clean.en-ch07_clean.de
All the labour contained in the yarn is past labour; and it is a matter of no importance that the labour expended to produce its constituent elements lies further back in the past than the labour expended on the final process, the spinning.	Alle im Garn enthaltne Arbeit ist vergangne Arbeit.	ch07_clean.en-ch07_clean.de
The former stands, as it were, in the pluperfect, the latter in the perfect tense, but this does not matter.	Daß die zur Produktion seiner Bildungselemente erheischte Arbeitszeit früher vergangen ist, im Plusquamperfektum steht, dagegen die zum Schlußprozeß, dem Spinnen, unmittelbar verwandte Arbeit dem Präsens näher, im Perfektum steht, ist ein durchaus gleichgültiger Umstand.	ch07_clean.en-ch07_clean.de
If a definite quantity of labour, say thirty days, is needed to build a house, the total amount of labour incorporated in the house is not altered by the fact that the work of the last day was done twenty-nine days later than that of the first.	Ist eine bestimmte Masse Arbeit, z.B. von 30 Arbeitstagen, zum Bau eines Hauses nötig, so ändert es nichts am Gesamtquantum der dem Hause einverleibten Arbeitszeit, daß der 30. Arbeitstag 29 Tage später in die Produktion einging als der erste Arbeitstag.	ch07_clean.en-ch07_clean.de
Therefore the labour contained in the raw material and instruments of labour can be treated just as if it were labour expended in an earlier stage of the spinning process, before the labour finally added in the form of actual spinning.	Und so kann die im Arbeitsmaterial und Arbeitsmittel enthaltne Arbeitszeit ganz so betrachtet werden, als wäre sie nur in einem früheren Stadium des Spinnprozesses verausgabt worden, vor der zuletzt unter der Form des Spinnens zugesetzten Arbeit.	ch07_clean.en-ch07_clean.de
The values of the means of production which are expressed in the price of 12 shillings (the cotton and the spindle) are therefore constituent parts of the value of the yarn, i.e. of the value of the product.	Die Werte der Produktionsmittel, der Baumwolle und der Spindel, ausgedrückt in dem Preise von 12 sh., bilden also Bestandteile des Garnwerts oder des Werts des Produkts.	ch07_clean.en-ch07_clean.de
Two conditions must nevertheless be fulfilled.	Nur sind zwei Bedingungen zu erfüllen.	ch07_clean.en-ch07_clean.de
First, the cotton and the spindle must genuinely have served to produce a use-value; they must in the present case become yarn.	Einmal müssen Baumwolle und Spindel wirklich zur Produktion eines Gebrauchswerts gedient haben. Es muß in unsrem Fall Garn aus ihnen geworden sein.	ch07_clean.en-ch07_clean.de
Value is independent of the particular use-value by which it is borne, but a use-value of some kind has to act as its bearer.	Welcher Gebrauchswert ihn trägt, ist dem Wert gleichgültig, aber ein Gebrauchswert muß ihn tragen.	ch07_clean.en-ch07_clean.de
Second, the labour-time expended must not exceed what is necessary under the given social conditions of production.	Zweitens ist vorausgesetzt, daß nur die unter den gegebnen gesellschaftlichen Produktionsbedingungen notwendige Arbeitszeit verwandt wurde.	ch07_clean.en-ch07_clean.de
Therefore, if no more than 1 lb. of cotton is needed to spin 1 lb. of yarn, no more than this weight of cotton may be consumed in the production of 1 lb. of yarn.	Wäre also nur 1 Pfund Baumwolle nötig, um 1 Pfund Garn zu spinnen, so darf nur 1 Pfund Baumwolle verzehrt sein in der Bildung von 1 Pfund Garn.	ch07_clean.en-ch07_clean.de
The same is true of the spindle.	Ebenso verhält es sich mit der Spindel.	ch07_clean.en-ch07_clean.de
If the capitalist has a foible for using golden spindles instead of steel ones, the only labour that counts for anything in the value of the yarn remains that which would be required to produce a steel spindle, because no more is necessary under the given social conditions.	Hat der Kapitalist die Phantasie, goldne statt eiserner Spindeln anzuwenden, so zählt im Garnwert dennoch nur die gesellschaftlich notwendige Arbeit, d.h. die zur Produktion eiserner Spindeln notwendige Arbeitszeit.	ch07_clean.en-ch07_clean.de
We now know what part of the value of the yarn is formed by the means of production, namely the cotton and the spindle.	Wir wissen jetzt, welchen Teil des Garnwerts die Produktionsmittel, Baumwolle und Spindel, bilden.	ch07_clean.en-ch07_clean.de
It is 12 shillings, i.e. the materialization of two days of labour.	Er ist gleiche 12 sh. oder die Materiatur von zwei Arbeitstagen.	ch07_clean.en-ch07_clean.de
The next point to be considered is what part of the value of the yarn is added to the cotton by the labour of the spinner.	Es handelt sich also nun um den Wertteil, welchen die Arbeit des Spinners selbst der Baumwolle zusetzt.	ch07_clean.en-ch07_clean.de
We have now to consider this labour from a standpoint quite different from that adopted for the labour process.	Wir haben diese Arbeit jetzt von einem ganz andren Gesichtspunkte zu betrachten, als während des Arbeitsprozesses.	ch07_clean.en-ch07_clean.de
There we viewed it solely as the activity which has the purpose of changing cotton into yarn; there, the more appropriate the work was to its purpose, the better the yarn, other circumstances remaining the same.	Dort handelte es sich um die zweckmäßige Tätigkeit, Baumwolle in Garn zu verwandeln. Je zweckmäßiger die Arbeit, desto besser das Garn, alle andren Umstände als gleichbleibend vorausgesetzt.	ch07_clean.en-ch07_clean.de
In that case the labour of the spinner was specifically different from other kinds of productive labour, and this difference revealed itself both subjectively in the particular purpose of spinning, and objectively in the special character of its operations, the special nature of its means of production, and the special use-value of its product For the operation of spinning, cotton and spindles are a necessity, but for making rifled cannon they would be of no use whatever.	Die Arbeit des Spinners war spezifisch verschieden von andren produktiven Arbeiten, und die Verschiedenheit offenbarte sich subjektiv und objektiv, im besondren Zweck des Spinnens, seiner besondren Operationsweise, der besondren Natur seiner Produktionsmittel, dem besondren Gebrauchswert seines Produkts. Baumwolle und Spindel dienen als Lebensmittel der Spinnarbeit, aber man kann mit ihnen keine gezogenen Kanonen machen.	ch07_clean.en-ch07_clean.de
Here, on the contrary, where we consider the labour of the spinner only in so far as it creates value, i.e. is a source of value, that labour differs in no respect from the labour of the man who bores cannon, or (what concerns us more closely here) from the labour of the cotton-planter and the spindle-maker which is realized in the means of production of the yarn.	Sofern die Arbeit des Spinners dagegen wertbildend ist, d.h. Wertquelle, ist sie durchaus nicht verschieden von der Arbeit des Kanonenbohrers, oder, was uns hier näher liegt, von den in den Produktionsmitteln des Garns verwirklichten Arbeiten des Baumwollpflanzers und des Spindelmachers.	ch07_clean.en-ch07_clean.de
It is solely by reason of this identity that cotton planting, spindle-making and spinning are capable of forming the component parts of one whole, namely the value of the yarn, differing only quantitatively from each other.	Nur wegen diese Identität können Baumwollpflanzen, Spindelmachen und Spinnen bloß quantitativ verschiedne Teile desselben Gesamtwerts, des Garnwerts, bilden.	ch07_clean.en-ch07_clean.de
Here we are no longer concerned with the quality, the character and the content of the labour, but merely with its quantity.	Es handelt sich hier nicht mehr um die Qualität, die Beschaffenheit und den Inhalt der Arbeit, sondern nur noch um ihre Quantität.	ch07_clean.en-ch07_clean.de
And this simply requires to be calculated.	Diese ist einfach zu zählen.	ch07_clean.en-ch07_clean.de
We assume that spinning is simple labour, the average labour of a given society.	Wir nehmen an, daß die Spinnarbeit einfache Arbeit, gesellschaftliche Durchschnittsarbeit ist.	ch07_clean.en-ch07_clean.de
Later it will be seen that the contrary assumption would make no difference.	Man wird später sehn, daß die gegenteilige Annahme nichts an der Sache ändert.	ch07_clean.en-ch07_clean.de
During the labour process, the worker’s labour constantly under-goes a transformation, from the form of unrest [Urtruhe] into that of being [Sein], from the form of motion [Bewegung] into that of objectivity [Gegenstständlichkeit].	Während des Arbeitsprozesses setzt sich die Arbeit beständig aus der Form der Unruhe in die des Seins, aus der Form der Bewegung in die der Gegenständlichkeit um.	ch07_clean.en-ch07_clean.de
At the end of one hour, the spinning motion is represented in a certain quantity of yarn; in other words, a definite quantity of labour, namely that of one hour, has been objectified in the cotton.	Am Ende einer Stunde ist die Spinnbewegung in einem gewissen Quantum Garn dargestellt, also ein bestimmtes Quantum Arbeit, eine Arbeitsstunde, in der Baumwolle vergegenständlicht.	ch07_clean.en-ch07_clean.de
We say labour, i.e. the expenditure of his vital force by the spinner, and not spinning labour, because the special work of spinning counts here only in so far as it is the expenditure of labour-power in general, and not the specific labour of the spinner.	Wir sagen Arbeitsstunde, d.h. die Verausgabung der Lebenskraft des Spinners während einer Stunde, denn die Spinnarbeit gilt hier nur, soweit sie Verausgabung von Arbeitskraft, nicht soweit sie die spezifische Arbeit des Spinnens ist.	ch07_clean.en-ch07_clean.de
In the process we are now considering it is of extreme importance that no more time be consumed in the work of transforming the cotton into yarn than is necessary under the given social conditions.	Es ist nun entscheidend wichtig, daß während der Dauer des Prozesses, d.h. der Verwandlung von Baumwolle in Garn, nur die gesellschaftlich notwendige Arbeitszeit verzehrt wird.	ch07_clean.en-ch07_clean.de
If under normal, i.e. average social conditions of production, x pounds of cotton are made into y pounds of yarn by one hour’s labour, then a day’s labour does not count as 12 hours’ labour unless 12x lb. of cotton have been made into 12y lb. of yarn; for only socially necessary labour-time counts towards the creation of value.	Müssen unter normalen, d.h. durchschnittlichen gesellschaftlichen Produktionsbedingungen, a Pfund Baumwolle während einer Arbeitsstunde in b Pfund Garn verwandelt sein, so gilt nur der Arbeitstag als Arbeitstag von 12 Stunden, der 12 x a Pfund Baumwolle in 12 x b Pfund Garn verwandelt. Denn nur die gesellschaftlich notwendige Arbeitszeit zählt als wertbildend.	ch07_clean.en-ch07_clean.de
Not only the labour, but also the raw material and the product now appear in quite a new light, very different from that in which we viewed them in the labour process pure and simple.	Wie die Arbeit selbst, so erscheint hier auch Rohmaterial und Produkt in einem ganz andren Licht als vom Standpunkt des eigentlichen Arbeitsprozesses.	ch07_clean.en-ch07_clean.de
Now the raw material merely serves to absorb a definite quantity of labour.	Das Rohmaterial gilt hier nur als Aufsauger eines bestimmten Quantums Arbeit.	ch07_clean.en-ch07_clean.de
By being soaked in labour, the raw material is in fact changed into yarn, because labour-power is expended in the form of spinning and added to it; but the product, the yarn, is now nothing more than a measure of the labour absorbed by the cotton.	Durch diese Aufsaugung verwandelt es sich in der Tat in Garn, weil die Arbeitskraft in der Form der Spinnerei verausgabt und ihm zugesetzt wurde. Aber das Produkt, das Garn, ist jetzt nur noch Gradmesser der von der Baumwolle eingesaugten Arbeit.	ch07_clean.en-ch07_clean.de
If in one hour 1 2/ lb. of cotton can be spun into 1 2/ lb. of yarn, then 10 lb. of yarn indicate the absorption of 6 hours of labour.	Wird in einer Stunde 12/3 Pfund Baumwolle versponnen oder in 12/3 Pfund Garn verwandelt, so zeigen 10 Pfund Garn 6 eingesaugte Arbeitsstunden an.	ch07_clean.en-ch07_clean.de
Definite quantities of product, quantities which are determined by experience, now represent nothing but definite quantities of labour, definite masses of crystallized labour-time.	Bestimmte und erfahrungsmäßig festgestellte Quanta Produkt stellen jetzt nichts dar als bestimmte Quanta Arbeit, bestimmte Masse festgeronnener Arbeitszeit.	ch07_clean.en-ch07_clean.de
They are now simply the material shape taken by a given number of hours or days of social labour.	Sie sind nur noch Materiatur von einer Stunde, zwei Stunden, einem Tag gesellschaftlicher Arbeit.	ch07_clean.en-ch07_clean.de
The fact that the labour is precisely the labour of spinning, that its material is cotton, its product yarn, is as irrelevant here as it is that the object of labour is itself already a product, hence already raw material.	Daß die Arbeit grade Spinnarbeit, ihr Material Baumwolle und ihr Produkt Garn, wird hier ebenso gleichgültig, als daß der Arbeitsgegenstand selbst schon Produkt, also Rohmaterial ist.	ch07_clean.en-ch07_clean.de
If the worker, instead of spinning, were to be employed in a coal-mine, the object on which he worked would be coal, which is present in nature; nevertheless, a definite quantity of coal, when extracted from its seam, would represent a definite quantity of absorbed labour.	Wäre der Arbeiter, statt in der Spinnerei, in der Kohlengrube beschäftigt, so wäre der Arbeitsgegenstand, die Kohle, von Natur vorhanden. Dennoch stellte ein bestimmtes Quantum aus dem Bett losgebrochener Kohle, z.B. ein Zentner, ein bestimmtes Quantum aufgesaugter Arbeit dar.	ch07_clean.en-ch07_clean.de
We assumed, on the occasion of its sale, that the value of a day’s labour-power was 3 shillings, and that 6 hours of labour was incorporated in that sum; and consequently that this amount of labour was needed to produce the worker’s average daily means of subsistence.	Beim Verkauf der Arbeitskraft ward unterstellt, daß ihr Tageswert = 3 sh., und in den letztren 6 Arbeitsstunden verkörpert sind, dies Arbeitsquantum also erheischt ist, um die Durchschnittssumme der täglichen Lebensmittel des Arbeiters zu produzieren.	ch07_clean.en-ch07_clean.de
If now our spinner, by working for one hour, can convert 12/ lb. of cotton into 12/3; lb. of yarn, it follows that in 6 hours he will convert 10 lb. of cotton into 10 lb. of yarn.	Verwandelt unser Spinner nun während einer Arbeitsstunde 12/3 Pfund Baumwolle im 12/3 Pfund Garn , so in 6 Stunden 10 Pfund Baumwolle in 10 Pfund Garn.	ch07_clean.en-ch07_clean.de
Hence, during the spinning process, the cotton absorbs 6 hours of labour.	Während der Dauer des Spinnprozesses saugt die Baumwolle also 6 Arbeitsstunden ein.	ch07_clean.en-ch07_clean.de
The same quantity of labour is also embodied in a piece of gold of the value of 3 shillings.	Dieselbe Arbeitszeit stellt sich in einem Goldquantum von 3 sh. dar.	ch07_clean.en-ch07_clean.de
A value of 3 shillings, therefore, is added to the cotton by the labour of spinning.	Der Baumwolle wird also durch das Spinnen selbst ein Wert von 3 sh. zugesetzt.	ch07_clean.en-ch07_clean.de
Let us now consider the total value of the product, the 10 lb. of yarn.	Sehn wir uns nun den Gesamtwert des Produkts, der 10 Pfund Garn, an.	ch07_clean.en-ch07_clean.de
Two and a half days of labour have been objectified in it. Out of this, two days were contained in the cotton and the worn-down portion of the spindle, and half a day was absorbed during the process of spinning.	In ihnen sind 21/2 Arbeitstage vergegenständlicht, 2 Tage enthalten in Baumwolle und Spindelmasse, 1/2 Tag Arbeit eingesaugt während des Spinnprozesses.	ch07_clean.en-ch07_clean.de
This two and a half days of labour is represented by a piece of gold of the value of 15 shillings.	Dieselbe Arbeitszeit stellt sich in einer Goldmasse von 15 sh. dar.	ch07_clean.en-ch07_clean.de
Hence 15 shillings is an adequate price for the 10 lb. of yarn, and the price of 1 lb. is 1s.	Der dem Wert der 10 Pfund Garn adäquate Preis beträgt also 15 sh., der Preis eines Pfundes Garn 1 sh.	ch07_clean.en-ch07_clean.de
6d. Our capitalist stares in astonishment.	6 d. Unser Kapitalist stutzt.	ch07_clean.en-ch07_clean.de
The value of the product is equal to the value of the capital advanced.	Der Wert des Produkts ist gleich dem Wert des vorgeschossenen Kapitals.	ch07_clean.en-ch07_clean.de
The value advanced has not been valorized, no surplus-value has been created, and consequently money has not been transformed into capital.	Der vorgeschossene Wert hat sich nicht verwertet, keinen Mehrwert erzeugt, Geld sich also nicht in Kapital verwandelt.	ch07_clean.en-ch07_clean.de
The price of the yarn is 15 shillings, and 15 shillings were spent in the open market on the constituent elements of the product or, what amounts to the same thing, on the factors of the labour process; 10 shillings were paid for the cotton, 2 shillings for the wear of the spindle and 3 shillings for the labour-power.	Der Preis der 10 Pfund Garn ist 15 sh., und 15 sh. wurden verausgabt auf dem Warenmarkt für die Bildungselemente des Produkts oder, was dasselbe, die Faktoren des Arbeitsprozesses: 10 sh. für Baumwolle, 2 sh. für die verzehrte Spindelmasse und 3 sh. für Arbeitskraft.	ch07_clean.en-ch07_clean.de
The swollen value of the yarn is of no avail, for it is merely the sum of the values formerly existing in the cotton, the spindle and the labour-power: out of such a simple addition of existing values, no surplus-value can possibly arise.	Der aufgeschwollne Wert des Garns hilft nichts, denn sein Wert ist nur die Summe der früher auf Baumwolle, Spindel und Arbeitskraft verteilten Werte, und aus einer solchen bloßen Addition vorhandner Werte kann nun und nimmermehr ein Mehrwert entspringen.	ch07_clean.en-ch07_clean.de
These values are now all concentrated in one thing; but so they were in the sum of 15 shillings, before it was split up into three part’s by the purchase of the commodities.	Diese Werte sind jetzt alle auf ein Ding konzentriert, aber so waren sie in der Geldsumme von 15 sh., bevor diese sich durch drei Warenkäufe zersplitterte.	ch07_clean.en-ch07_clean.de
In itself this result is not particularly strange.	An und für sich ist dies Resultat nicht befremdlich.	ch07_clean.en-ch07_clean.de
The value of one pound of yarn is Is.	Der Wert eines Pfund Garn ist 1 sh.	ch07_clean.en-ch07_clean.de
6d., and our capitalist would therefore have to pay 15 shillings for 10 lb. of yarn on the open market.	6 d., und für 10 Pfund Garn müßte unser Kapitalist daher auf dem Warenmarkt 15 sh. zahlen.	ch07_clean.en-ch07_clean.de
It is clear that whether a man buys his house ready built, or has it built for him, neither of these operations will increase the amount of money laid out on the house.	Ob er sein Privathaus fertig auf dem Markt kauft oder es selbst bauen läßt, keine dieser Operationen wird das im Erwerb des Hauses ausgelegte Geld vermehren.	ch07_clean.en-ch07_clean.de
Our capitalist, who is at home in vulgar economics, may perhaps say that he advanced his money with the intention of making more money out of it.	Der Kapitalist, der in der Vulgärökonomie Bescheid weiß, sagt vielleicht, er haben sein Geld mit der Absicht vorgeschossen, mehr Geld daraus zu machen.	ch07_clean.en-ch07_clean.de
The road to hell is paved with good intentions, and he might just as well have intended to make money without producing at all.	Der Weg zur Hölle ist jedoch mit guten Absichten gepflastert, und er konnte ebensogut der Absicht sein, Geld zu machen, ohne zu produzieren.	ch07_clean.en-ch07_clean.de
He makes threats.	Er droht.	ch07_clean.en-ch07_clean.de
He will not be caught napping again.	Man werde ihn nicht wieder ertappen.	ch07_clean.en-ch07_clean.de
In future he will buy the commodities in the market, instead of manufacturing them himself.	Künftig werde er die Ware fertig auf dem Markt kaufen, statt sie selbst zu fabrizieren.	ch07_clean.en-ch07_clean.de
But if all his brother capitalists were to do the same, where would he find his commodities on the market?	Wenn aber alle seine Brüder Kapitalisten desgleichen tun, wo soll er Ware auf dem Markt finden?	ch07_clean.en-ch07_clean.de
And he cannot eat his money.	Und Geld kann er nicht essen.	ch07_clean.en-ch07_clean.de
He recites the catechism: ‘Consider my abstinence.	Er katechisiert. Man soll seine Abstinenz bedenken.	ch07_clean.en-ch07_clean.de
I might have squandered the 15 shillings, but instead I consumed it productively and made yarn with it.’	Er konnte seine 15 sh. verprassen.	ch07_clean.en-ch07_clean.de
Very true; and as a reward he is now in possession of good yarn instead of a bad conscience.	Statt dessen hat er sie produktiv konsumiert und Garn daraus gemacht.	ch07_clean.en-ch07_clean.de
As for playing the part of a miser, it would never do for him to relapse into such bad ways; we have already seen what such asceticism leads to.	Aber dafür ist er ja im Besitz von Garn statt von Gewissensbissen. Er muß beileibe nicht in die Rolle des Schatzbildners zurückfallen, der uns zeigte, was bei der Asketik herauskommt.	ch07_clean.en-ch07_clean.de
Besides, where there is nothing, the king has lost his rights; whatever the merits of his abstinence there is no money there to recompense him, because the value of the product is merely the sum of the values thrown into the process of production.	Außerdem, wo nichts ist, hat der Kaiser sein Recht verloren. Welches immer das Verdienst seiner Entsagung, es ist nichts da, um sie extra zu zahlen, da der Wert des Produkts, der aus dem Prozeß herauskommt, nur gleich der Summe der hineingeworfenen Warenwerte.	ch07_clean.en-ch07_clean.de
Let him therefore console himself with the reflection that virtue is its own reward.	Er beruhige sich also dabei, daß Tugend Lohn.	ch07_clean.en-ch07_clean.de
But no, on the contrary, he becomes insistent.	Statt dessen wird er zudringlich.	ch07_clean.en-ch07_clean.de
The yarn is of no use to him, he says.	Das Garn ist ihm unnütz.	ch07_clean.en-ch07_clean.de
He produced it in order to sell it.	Er hat es für den Verkauf produziert.	ch07_clean.en-ch07_clean.de
In that case let him sell it, or, easier still, let him in future produce only things he needs himself, a remedy already prescribed by his personal physician MacCulloch as being of proven efficacy against an epidemic of over-production.	So verkaufe er es, oder, noch einfacher, produziere in Zukunft nur Dinge für seinen eignen Bedarf, ein Rezept, das ihm bereits sein Hausarzt MacCulloch als probates Mittel gegen die Epidemie der Überproduktion verschrieben hat.	ch07_clean.en-ch07_clean.de
Now our capitalist grows defiant.	Er stellt sich trutzig auf die Hinterbeine.	ch07_clean.en-ch07_clean.de
‘Can the worker produce commodities out of nothing, merely by using his arms and legs?	Sollte der Arbeiter mit seinen eignen Gliedmaßen in der blauen Luft Arbeitsgebilde schaffen, Waren produzieren?	ch07_clean.en-ch07_clean.de
Did I not provide him with the materials through which, and in which alone, his labour could be embodied?	Gab er ihm nicht den Stoff, womit und worin er allein seine Arbeit verleiblichen kann?	ch07_clean.en-ch07_clean.de
And as the greater part of society consists of such impecunious creatures, have I not rendered society an incalculable service by providing my instruments of production, my cotton and my spindle, and the worker too, for have I not provided him with the means of subsistence?	Da nun der größte Teil der Gesellschaft aus solchen Habenichtsen besteht, hat er nicht der Gesellschaft durch seine Produktionsmittel, seine Baumwolle und seine Spindel, einen unermeßlichen Dienst erwiesen, nicht dem Arbeiter selbst, den er obendrein noch mit Lebensmitteln versah?	ch07_clean.en-ch07_clean.de
Am I to be allowed nothing in return for all this service?’	Und soll er den Dienst nicht berechnen?	ch07_clean.en-ch07_clean.de
But has the worker not performed an equivalent service in return, by changing his cotton and his spindle into yarn?	Hat der Arbeiter ihm aber nicht den Gegendienst erwiesen, Baumwolle und Spindel in Garn zu verwandeln?	ch07_clean.en-ch07_clean.de
In any case, here the question of service does not arise.	Außerdem handelt es sich hier nicht um Dienste.	ch07_clean.en-ch07_clean.de
A service is nothing other than the useful effect of a use-value, be it that of a commodity, or that of the labour.	Ein Dienst ist nichts als die nützliche Wirkung eines Gebrauchswerts, sei es der Ware, sei es der Arbeit. Hier aber gilt's den Tauschwert.	ch07_clean.en-ch07_clean.de
But here we are dealing with exchange-value.	Er zahlte dem Arbeiter den Wert von 3 sh.	ch07_clean.en-ch07_clean.de
The capitalist paid to the worker a value of 3 shillings, and the worker gave him back an exact equivalent in the value of 3 shillings he added to the cotton: he gave him value for value.	Der Arbeiter gab ihm ein exaktes Äquivalent zurück in dem der Baumwolle zugesetzten Wert von 3 sh. Wert für Wert.	ch07_clean.en-ch07_clean.de
Our friend, who has up till now displayed all the arrogance of capital, suddenly takes on the unassuming demeanour of one of his own workers, and exclaims: ‘Have I myself not worked?	Unser Freund, eben noch so kapitalübermütig, nimmt plötzlich die anspruchslose Haltung seines eignen Arbeiters an.	ch07_clean.en-ch07_clean.de
Have I not performed the labour of superintendence, of overseeing the spinner?	Hat er nicht selbst gearbeitet? nicht die Arbeit der Überwachung, der Oberaufsicht über den Spinner verrichtet?	ch07_clean.en-ch07_clean.de
And does not this labour, too, create value?’	Bildet diese seine Arbeit nicht auch Wert?	ch07_clean.en-ch07_clean.de
The capitalist’s own overseer and manager shrug their shoulders.	Sein eigner overlooker <Aufseher> und sein Manager zucken die Achseln.	ch07_clean.en-ch07_clean.de
In the meantime, with a hearty laugh, he recovers his composure.	Unterdes hat er aber bereits mit heitrem Lächeln seine alte Physiognomie wieder angenommen.	ch07_clean.en-ch07_clean.de
The whole litany he has just recited was simply meant to pull the wool over our eyes.	Er foppte uns mit der ganzen Litanei.	ch07_clean.en-ch07_clean.de
He himself does not care twopence for it.	Er gibt keinen Deut darum.	ch07_clean.en-ch07_clean.de
He leaves this and all similar subterfuges and conjuring tricks to the professors of political economy, who are paid for it.	Er überläßt diese und ähnliche faule Ausflüchte und hohle Flausen den dafür eigens bezahlten Professoren der politischen Ökonomie.	ch07_clean.en-ch07_clean.de
He himself is a practical man, and although he does not always consider what he says outside his business, within his business he knows what he is doing.	Er selbst ist ein praktischer Mann, der zwar nicht immer bedenkt, was er außerhalb des Geschäfts sagt, aber stets weiß, was er im Geschäft tut.	ch07_clean.en-ch07_clean.de
Let us examine the matter more closely.	Sehn wir näher zu.	ch07_clean.en-ch07_clean.de
The value of a day’s labour-power amounts to 3 shillings, because on our assumption half a day’s labour is objectified in that quantity of labour-power, i.e. because the means of subsistence required every day for the production of labour-power cost half a day’s labour.	Der Tageswert der Arbeitskraft betrug 3 sh., weil in ihr selbst ein halber Arbeitstag vergegenständlicht ist, d.h. weil die täglich zur Produktion der Arbeitskraft nötigen Lebensmittel einen halben Arbeitstag kosten.	ch07_clean.en-ch07_clean.de
But the past labour embodied in the labour-power and the living labour it can perform, and the daily cost of maintaining labour-power and its daily expenditure in work, are two totally different things.	Aber die vergangne Arbeit, die in der Arbeitskraft steckt, und die lebendige Arbeit, die sie leisten kann, ihre täglichen Erhaltungskosten und ihre tägliche Verausgabung, sind zwei ganz verschiedne Größen.	ch07_clean.en-ch07_clean.de
The former determines the exchange-value of the labour-power, the latter is its use-value.	Die erstere bestimmt ihren Tauschwert, die andre bildet ihren Gebrauchswert.	ch07_clean.en-ch07_clean.de
The fact that half a day’s labour is necessary to keep the worker alive during 24 hours does not in any way prevent him from working a whole day.	Daß ein halber Arbeitstag nötig, um ihn während 24 Stunden am Leben zu erhalten, hindert den Arbeiter keineswegs, einen ganzen Tag zu arbeiten.	ch07_clean.en-ch07_clean.de
Therefore the value of labour-power, and the value which that labour-power valorizes [verwertet] in the labour-process, are two entirely different magnitudes; and this difference was what the capitalist had in mind when he was purchasing the labour-power.	Der Wert der Arbeitskraft und ihre Verwertung im Arbeitsprozeß sind also zwei verschiedne Größen. Diese Wertdifferenz hatte der Kapitalist im Auge, als er die Arbeitskraft kaufte.	ch07_clean.en-ch07_clean.de
The useful quality of labour-power, by virtue of which it makes yarn or boots, was to the capitalist merely the necessary condition for his activity; for in order to create value labour must be expended in a useful manner.	Ihre nützliche Eigenschaft, Garn oder Stiefel zu machen, war nur eine conditio sine qua non, weil Arbeit in nützlicher Form verausgabt werden muß, um Wert zu bilden.	ch07_clean.en-ch07_clean.de
What was really decisive for him was the specific use-value which this commodity possesses of being a source not only of value, but of more value than it has itself.	Was aber entschied, war spezifische Gebrauchswert dieser Ware, Quelle von Wert zu sein und von mehr Wert, als sie selbst hat.	ch07_clean.en-ch07_clean.de
This is the specific service the capitalist expects from labour-power, and in this transaction he acts in accordance with the eternal laws of commodity-exchange.	Dies ist der spezifische Dienst, den der Kapitalist von ihr erwartet. Und er verfährt dabei den ewigen Gesetzen des Warenaustausches gemäß.	ch07_clean.en-ch07_clean.de
In fact, the seller of labour-power, like the seller of any other commodity, realizes [realisiert] its exchange-value, and alienates [veräussert] its use-value.	In der Tat, der Verkäufer der Arbeitskraft, wie der Verkäufer jeder andren Ware, realisiert ihren Tauschwert und veräußert ihren Gebrauchswert.	ch07_clean.en-ch07_clean.de
He cannot take the one without giving the other.	Er kann den einen nicht erhalten, ohne den andren wegzugeben.	ch07_clean.en-ch07_clean.de
The use-value of labour-power, in other words labour, belongs just as little to its seller as the use-value of oil after it has been sold belongs to the dealer who sold it.	Der Gebrauchswert der Arbeitskraft, die Arbeit selbst, gehört ebensowenig ihrem Verkäufer, wie der Gebrauchswert des verkauften Öls dem Ölhändler.	ch07_clean.en-ch07_clean.de
The owner of the money has paid the value of a day’s labour-power; he therefore has the use of it for a day, a day’s labour belongs to him.	Der Geldbesitzer hat den Tageswert der Arbeitskraft gezahlt; ihm gehört daher ihr Gebrauch während des Tages, die tagelange Arbeit.	ch07_clean.en-ch07_clean.de
On the one hand the daily sustenance of labour-power costs only half a day’s labour, while on the other hand the very same labour-power can remain effective, can work, during a whole day, and consequently the value which its use during one day creates is double what the capitalist pays for that use; this circumstance is a piece of good luck for the buyer, but by no means an injustice towards the seller.	Der Umstand, daß die tägliche Erhaltung der Arbeitskraft nur einen halben Arbeitstag kostet, obgleich die Arbeitskraft einen ganzen Tag wirken, arbeiten kann, daß daher der Wert, den ihr Gebrauch während eines Tags schafft, doppelt so groß ist als ihr eigner Tageswert, ist ein besondres Glück für den Käufer, aber durchaus kein Unrecht gegen den Verkäufer.	ch07_clean.en-ch07_clean.de
Our capitalist foresaw this situation, and that was the cause of his laughter.	Unser Kapitalist hat den Kasus, der ihn lachen macht, vorgesehn.	ch07_clean.en-ch07_clean.de
The worker therefore finds, in the workshop, the means of production necessary for working not just 6 but 12 hours.	Der Arbeiter findet daher in der Werkstätte die nötigen Produktionsmittel nicht nur für einen sechsstündigen, sondern für einen zwölfstündigen Arbeitsprozeß.	ch07_clean.en-ch07_clean.de
If 10 lb. of cotton could absorb 6 hours’ labour, and become 10 lb. of yarn, now 20 lb. of cotton will absorb 12 hours’ labour and be changed into 20 lb. of yarn.	Saugten 10 Pfund Baumwolle 6 Arbeitsstunden ein und verwandelten sich in 10 Pfund Garn, so werden 20 Pfund Baumwolle 12 Arbeitsstunden einsaugen und in 20 Pfund Garn verwandelt.	ch07_clean.en-ch07_clean.de
Let us examine the product of this extended labour-process.	Betrachten wir das Produkt des verlängerten Arbeitsprozesses.	ch07_clean.en-ch07_clean.de
Now five days of labour are objectified in this 20 lb. of yarn; four days are due to the cotton and the lost steel of the spindle, the remaining day has been absorbed by the cotton during the spinning process.	In den 20 Pfund Garn sind jetzt 5 Arbeitstage vergegenständlicht, 4 in der verzehrten Baumwoll- und Spindelmasse, 1 von der Baumwolle eingesaugt während des Spinnprozesses.	ch07_clean.en-ch07_clean.de
Expressed in gold, the labour of five days is 30 shillings.	Der Goldausdruck von 5 Arbeitstagen ist aber 30 sh. oder 1 Pfd.St.	ch07_clean.en-ch07_clean.de
This is therefore the price of the 20 lb. of yarn, giving, as before, 1s.	10 sh. Dies also der Preis der 20 Pfund Garn.	ch07_clean.en-ch07_clean.de
6d. as the price of 1 lb.	Das Pfund Garn kostet nach wie vor 1 sh.	ch07_clean.en-ch07_clean.de
But the sum of the values of the commodities thrown into the process amounts to 27 shillings.	6 d. Aber die Wertsumme der in den Prozeß geworfenen Waren betrug 27 sh.	ch07_clean.en-ch07_clean.de
The value of the yarn is 30 shillings.	Der Wert des Garns beträgt 30 sh.	ch07_clean.en-ch07_clean.de
Therefore the value of the product is one-ninth greater than the value advanced to produce it; 27 shillings have turned into 30 shillings; a surplus-value of 3 shillings has been precipitated.	Der Wert des Produkts ist um 1/9 gewachsen über den zu seiner Produktion vorgeschoßnen Wert. So haben sich 27 sh. in 30 sh. verwandelt. Sie haben einen Mehrwert von 3 sh. gesetzt.	ch07_clean.en-ch07_clean.de
The trick has at last worked: money has been transformed into capital.	Das Kunststück ist endlich gelungen. Geld ist in Kapital verwandelt.	ch07_clean.en-ch07_clean.de
Every condition of the problem is satisfied, while the laws governing the exchange of commodities have not been violated in any way.	Alle Bedingungen des Problems sind gelöst und die Gesetze des Warenaustausches in keiner Weise verletzt.	ch07_clean.en-ch07_clean.de
Equivalent has been exchanged for equivalent.	Äquivalent wurde gegen Äquivalent ausgetauscht.	ch07_clean.en-ch07_clean.de
For the capitalist as buyer paid the full value for each commodity, for the cotton, for the spindle and for the labour-power.	Der Kapitalist zahlte als Käufer jede Ware zu ihrem Wert, Baumwolle, Spindelmasse, Arbeitskraft.	ch07_clean.en-ch07_clean.de
He then did what is done by every purchaser of commodities: he consumed their use-value.	Er tat dann, was jeder andre Käufer von Waren tut. Er konsumierte ihren Gebrauchswert.	ch07_clean.en-ch07_clean.de
The process of consuming labour-power, which was also the process of producing commodities, resulted in 20 lb. of yarn, with a value of 30 shillings.	Der Konsumtionsprozeß der Arbeitskraft, der zugleich Produktionsprozeß der Ware, ergab ein Produkt von 20 Pfund Garn mit einem Wert von 30 sh.	ch07_clean.en-ch07_clean.de
The capitalist, formerly a buyer, now returns to the market as a seller.	Der Kapitalist kehrt nun zum Markt zurück und verkauft Ware, nachdem er Ware gekauft hat.	ch07_clean.en-ch07_clean.de
He sells his yarn at Is.	Er verkauft das Pfund Garn zu 1 sh.	ch07_clean.en-ch07_clean.de
6d. a pound, which is its exact value.	6 d., keinen Deut über oder unter seinem Wert.	ch07_clean.en-ch07_clean.de
Yet for all that he withdraws 3 shillings more from circulation than he originally threw into it.	Und doch zieht er 3 sh. mehr aus der Zirkulation heraus, als er ursprünglich in sie hineinwarf.	ch07_clean.en-ch07_clean.de
This whole course of events, the transformation of money into capital, both takes place and does not take place in the sphere of circulation.	Dieser ganze Verlauf, die Verwandlung seines Geldes in Kapital, geht in der Zirkulationssphäre vor und geht nicht in ihr vor.	ch07_clean.en-ch07_clean.de
It takes place through the mediation of circulation because it is conditioned by the purchase of the labour-power in the market; it does not take place in circulation because what happens there is only an introduction to the valorization process, which is entirely confined to the sphere of production.	Durch die Vermittlung der Zirkulation, weil bedingt durch den Kauf der Arbeitskraft auf dem Warenmarkt.	ch07_clean.en-ch07_clean.de
And so ‘everything is for the best in the best of all possible worlds’.	Nicht in der Zirkulation, denn sie leitet nur den Verwertungsprozeß ein, der sich in der Produktionssphäre zuträgt.	ch07_clean.en-ch07_clean.de
By turning his money into commodities which serve as the building materials for a new product, and as factors in the labour process, by incorporating living labour into their lifeless objectivity, the capitalist simultaneously transforms value, i.e. past labour in its objectified and lifeless form, into capital, value which can perform its own valorization process, an animated monster which begins to ‘work’, ‘as if its body were by love possessed’. * If we now compare the process of creating value with the process of valorization, we see that the latter is nothing but the continuation of the former beyond a definite point.	Und so ist "tout pour le mieux dans le meilleur des mondes possibles" <"Alles ist auf Beste bestellt in der besten der möglichen Welten"> Indem der Kapitalist Geld in Waren verwandelt, die als Stoffbildner eines neuen Produkts oder als Faktoren des Arbeitsprozesses dienen, indem er ihrer toten Gegenständlichkeit lebendige Arbeitskraft einverleibt, verwandelt er Wert, vergangne, vergegenständlichte, tote Arbeit in Kapital, sich selbst verwertenden Wert, ein beseeltes Ungeheuer, das zu "arbeiten" beginnt, als hätt' es Lieb' im Leibe.	ch07_clean.en-ch07_clean.de
If the process is not carried beyond the point where the value paid by the capitalist for the labour-power is replaced by an exact equivalent, it is simply a process of creating value; but if it is continued beyond that point, it becomes a process of valorization.	Vergleichen wir nun Wertbildungsprozeß und Verwertungsprozeß, so ist der Verwertungsprozeß nichts als ein über einen gewissen Punkt hinaus verlängerter Wertbildungsprozeß. Dauert der letztre nur bis zu dem Punkt, wo der vom Kapital gezahlte Wert der Arbeitskraft durch ein neues Äquivalent ersetzt ist, so ist er einfacher Wertbildungsprozeß.	ch07_clean.en-ch07_clean.de
	Dauert der Wertbildungsprozeß über diesen Punkt hinaus, so wird er Verwertungsprozeß.	ch07_clean.en-ch07_clean.de
If we proceed further, and compare the process of creating value with the labour process, we find that the latter consists in the useful labour which produces use-values.	Vergleichen wir ferner den Wertbildungsprozeß mit dem Arbeitsprozeß, so besteht der letztre in der nützlichen Arbeit, die Gebrauchswerte produziert.	ch07_clean.en-ch07_clean.de
Here the movement of production is viewed qualitatively, with regard to the particular kind of article produced, and in accordance with the purpose and content of the movement.	Die Bewegung wird hier qualitativ betrachtet, in ihrer besondren Art und Weise, nach Zweck und Inhalt.	ch07_clean.en-ch07_clean.de
But if it is viewed as a value-creating process the same labour process appears only quantitatively.	Derselbe Arbeitsprozeß stellt sich im Wertbildungsprozeß nur von seiner quantitativen Seite dar.	ch07_clean.en-ch07_clean.de
Here it is a question merely of the time needed to do the work, of the period, that is, during which the labour-power is usefully expended.	Es handelt sich nur noch um die Zeit, welche die Arbeit zu ihrer Operation braucht, oder um die Dauer, während deren die Arbeitskraft nützlich verausgabt wird.	ch07_clean.en-ch07_clean.de
Here the commodities which enter into the labour process no longer count as functionally determined and material elements on which labour-power acts with a given purpose.	Hier gelten auch die Waren, die in den Arbeitsprozeß eingehn, nicht mehr als funktionell bestimmte, stoffliche Faktoren der zweckmäßig wirkenden Arbeitskraft.	ch07_clean.en-ch07_clean.de
They count merely as definite quantities of objectified labour.	Sie zählen nur noch als bestimmte Quanta vergegenständlichter Arbeit.	ch07_clean.en-ch07_clean.de
Whether it was already contained in the means of production, or has just been added by the action of labour-power, that labour counts only according to its duration.	Ob in den Produktionsmittel enthalten oder durch die Arbeitskraft zugesetzt, die Arbeit zählt nur noch nach ihrem Zeitmaß.	ch07_clean.en-ch07_clean.de
It amounts to so many hours, or days, etc. Moreover, the time spent in production counts only in so far as it is socially necessary for the production of a use-value.	Sie beträgt so viel Stunden, Tage usw. Sie zählt jedoch nur, soweit die zur Produktion des Gebrauchswerts verbrauchte Zeit gesellschaftlich notwendig ist.	ch07_clean.en-ch07_clean.de
This has various consequences.	Es umfaßt dies Verschiednes.	ch07_clean.en-ch07_clean.de
First, the labour-power must be functioning under normal conditions.	Die Arbeitskraft muß unter normalen Bedingungen funktionieren.	ch07_clean.en-ch07_clean.de
If a self-acting mule is the socially predominant instrument of labour for spinning, it would be impermissible to supply the spinner with a spinning-wheel.	Ist die Spinnmaschine das gesellschaftlich herrschende Arbeitsmittel für die Spinnerei, so darf dem Arbeiter nicht ein Spinnrad in die Hand gegeben werden.	ch07_clean.en-ch07_clean.de
The cotton too must not be such rubbish as to tear at every other moment, but must be of suitable quality.	Statt Baumwolle von normaler Güte muß er nicht Schund erhalten, der jeden Augenblick reißt.	ch07_clean.en-ch07_clean.de
Otherwise the spinner would spend more time than socially necessary in producing his pound of yarn, and in this case the excess of time would create neither value nor money.	In beiden Fällen würde er mehr als die gesellschaftlich notwendige Arbeitszeit zur Produktion eines Pfundes Garn verbrauchen, diese überschüssige Zeit aber nicht Wert oder Geld bilden.	ch07_clean.en-ch07_clean.de
But whether the objective factors of labour are normal or not does not depend on the worker, but rather on the capitalist.	Der normale Charakter der gegenständlichen Arbeitsfaktoren hängt jedoch nicht vom Arbeiter, sondern vom Kapitalisten ab.	ch07_clean.en-ch07_clean.de
A further condition is that the labour-power itself must be of normal effectiveness.	Fernere Bedingung ist der normale Charakter der Arbeitskraft selbst.	ch07_clean.en-ch07_clean.de
In the trade in which it is being employed, it must possess the average skill, dexterity and speed prevalent in that trade, and our capitalist took good care to buy labour-power of such normal quality.	In dem Fach, worin sie verwandt wird, muß sie das herrschende Durchschnittsmaß von Geschick, Fertigkeit und Raschheit besitzen. Aber unser Kapitalist kaufte auf dem Arbeitsmarkt Arbeitskraft von normaler Güte.	ch07_clean.en-ch07_clean.de
It must be expended with the average amount of exertion and the usual degree of intensity; and the capitalist is as careful to see that this is done, as he is to ensure that his workmen are not idle for a single moment.	Diese Kraft muß in dem gewöhnlichen Durchschnittsmaß der Anstrengung, mit dem gesellschaftlich üblichen Grad von Intensität verausgabt werden.	ch07_clean.en-ch07_clean.de
He has bought the use of the labour-power for a definite period, and he insists on his rights.	Darüber wacht der Kapitalist ebenso ängstlich, als daß keine Zeit ohne Arbeit vergeudet wird.	ch07_clean.en-ch07_clean.de
	Er hat die Arbeitskraft für bestimmte Zeitfrist gekauft.	ch07_clean.en-ch07_clean.de
He has no intention of being robbed.	Er hält darauf, das Seine zu haben.	ch07_clean.en-ch07_clean.de
Lastly – and for this purpose our friend has a penal code of his own – all wasteful consumption of raw material or instruments of labour is strictly forbidden, because what is wasted in this way represents a superfluous expenditure of quantities of objectified labour, labour that does not count in the product or enter into its value.	Er will nicht bestohlen sein. Endlich - und hierfür hat derselbe Herr einen eignen code pénal <ein eignes Strafgesetzbuch> - darf kein zweckwidriger Konsum von Rohmaterial und Arbeitsmitteln stattfinden, weil vergeudetes Material oder Arbeitsmittel überflüssig verausgabte Quanta vergegenständlichter Arbeit darstellen, also nicht zählen und nicht in das Produkt der Wertbildung eingehn.	ch07_clean.en-ch07_clean.de
We now see that the difference between labour, considered on the one hand as producing utilities, and on the other hand as creating value, a difference which we discovered by our analysis of a commodity, resolves itself into a distinction between two aspects of the production process.	Man sieht: der früher aus der Analyse der Ware gewonnene Unterschied zwischen der Arbeit, soweit sie Gebrauchswert, und derselben Arbeit, soweit sie Wert schafft, hat sich jetzt als Unterscheidung der verschiednen Seiten des Produktionsprozesses dargestellt.	ch07_clean.en-ch07_clean.de
The production process, considered as the unity of the labour process and the process of creating value, is the process of production of commodities; considered as the unity of the labour process and the process of valorization, it is the capitalist process of production, or the capitalist form of the production of commodities.	Als Einheit von Arbeitsprozeß und Wertbildungsprozeß ist der Produktionsprozeß Produktionsprozeß von Waren; als Einheit von Arbeitsprozeß und Verwertungsprozeß ist er kapitalistischer Produktionsprozeß, kapitalistische Form der Warenproduktion.	ch07_clean.en-ch07_clean.de
We stated on a previous page that in the valorization process it does not in the least matter whether the labour appropriated by the capitalist is simple labour of average social quality, or more complex labour, labour with a higher specific gravity as it were.	Es wurde früher bemerkt, daß es für den Verwertungsprozeß durchaus gleichgültig, ob die vom Kapitalisten angeeignete Arbeit einfache, gesellschaftliche Durchschnittsarbeit oder kompliziertere Arbeit, Arbeit von höherem spezifischen Gewicht ist.	ch07_clean.en-ch07_clean.de
All labour of a higher, or more complicated, character than average labour is expenditure of labour-power of a more costly kind, labour-power whose production has cost more time and labour than unskilled or simple labour-power, and which therefore has a higher value.	Die Arbeit, die als höhere, kompliziertere Arbeit gegenüber der gesellschaftlichen Durchschnittsarbeit gilt, ist die Äußerung einer Arbeitskraft, worin höhere Bildungskosten eingehn, deren Produktion mehr Arbeitszeit kostet und die daher einen höheren Wert hat als die einfache Arbeitskraft.	ch07_clean.en-ch07_clean.de
This power being of higher value, it expresses itself in labour of a higher sort, and therefore becomes objectified, during an equal amount of time, in proportionally higher values.	Ist der Wert dieser Kraft höher, so äußert sie sich daher auch in höherer Arbeit und vergegenständlicht sich daher, in denselben Zeiträumen, in verhältnismäßig höheren Werten.	ch07_clean.en-ch07_clean.de
Whatever difference in skill there may be between the labour of a spinner and that of a jeweller, the portion of his labour by which the jeweller merely replaces the value of his own labour-power does not in any way differ in quality from the additional portion by which he creates surplus-value.	Welches jedoch immer der Gradunterschied zwischen Spinnarbeit und Juwelierarbeit, die Portion Arbeit, wodurch der Juwelenarbeiter nur den Wert seiner eignen Arbeitskraft ersetzt, unterscheidet sich qualitativ in keiner Weise von der zusätzlichen Portion Arbeit, wodurch er Mehrwert schafft.	ch07_clean.en-ch07_clean.de
In both cases, the surplus-value results only from a quantitative excess of labour, from a lengthening of one and the same labour-process: in the one case, the process of making jewels, in the other, the process of making yarn.	Nach wie vor kommt der Mehrwert nur heraus durch einen quantitativen Überschuß von Arbeit, durch die verlängerte Dauer desselben Arbeitsprozesses, in dem einen Fall Prozeß der Garnproduktion, in dem andren Fall Prozeß der Juwelenproduktion.	ch07_clean.en-ch07_clean.de
But, on the other hand, in every process of creating value the reduction of the higher type of labour to average social labour, for instance one day of the former to x days of the latter, is unavoidable.	Andrerseits muß in jedem Wertbildungsprozeß die höhere Arbeit stets auf gesellschaftliche Durchschnittsarbeit reduziert werden, z.B. ein Tag höherer Arbeit auf x Tage einfacher Arbeit.	ch07_clean.en-ch07_clean.de
We therefore save ourselves a superfluous operation, and simplify our analysis, by the assumption that the labour of the worker employed by the capitalist is average simple labour.	Man erspart also eine überflüssige Operation und vereinfacht die Analyse durch die Annahme, daß der vom Kapital verwandte Arbeiter einfache gesellschaftliche Durchschnittsarbeit verrichtet.	ch07_clean.en-ch07_clean.de

