Chapter 8: Constant Capital and Variable Capital The various factors of the labour process play different parts in forming the value of the product.	SECHSTES KAPITEL Konstantes Kapital und variables Kapital Die verschiednen Faktoren des Arbeitsprozesses nehmen verschiednen Anteil an der Bildung des Produkten-Werts.	ch08_clean.en-ch08_clean.de
The worker adds fresh value to the material of his labour by expending on it a given amount of additional labour, no matter what the specific content, purpose and technical character of that labour may be.	Der Arbeiter setzt dem Arbeitsgegenstand neuen Wert zu durch Zusatz eines bestimmten Quantums von Arbeit, abgesehn vom bestimmten Inhalt, Zweck und technischen Charakter seiner Arbeit.	ch08_clean.en-ch08_clean.de
On the other hand, the values of the means of production used up in the process are preserved, and present themselves afresh as constituent parts of the value of the product; the values of the cotton and the spindle, for instance, re-appear again in the value of the yarn.	Andrerseits finden wir die Werte der verzehrten Produktionsmittel wieder als Bestandteile des Produkten- Werts, z.B. die Werte von Baumwolle und Spindel im Garnwert.	ch08_clean.en-ch08_clean.de
The value of the means of production is therefore preserved by being transferred to the product.	Der Wert der Produktionsmittel wird also erhalten durch seine Übertragung auf das Produkt.	ch08_clean.en-ch08_clean.de
This transfer takes place during the conversion of those means into a product, in other words during the labour process.	Dies Übertragen geschieht während der Verwandlung der Produktionsmittel in Produkt, im Arbeitsprozeß.	ch08_clean.en-ch08_clean.de
It is mediated through labour.	Es ist vermittelt durch die Arbeit.	ch08_clean.en-ch08_clean.de
But how is this done?	Aber wie?	ch08_clean.en-ch08_clean.de
The worker does not perform two pieces of work simultaneously, one in order to add value to the cotton, the other in order to preserve the value of the means of production, or, what amounts to the same thing, to transfer to the yarn, as product, the value of the cotton on which he works, and part of the value of the spindle with which he works.	Der Arbeiter arbeitet nicht doppelt in derselben Zeit, nicht einmal, um der Baumwolle durch seine Arbeit einen Wert zuzusetzten, und das andremal, um ihren alten Wert zu erhalten, oder, was dasselbe, um den Wert der Baumwolle, die er verarbeitet, und der Spindel, womit er arbeitet, auf das Produkt, das Garn, zu übertragen.	ch08_clean.en-ch08_clean.de
But by the very act of adding new value he preserves their former values.	Sondern durch bloßes Zusetzen von neuem Wert erhält er den alten Wert.	ch08_clean.en-ch08_clean.de
Since however the addition of new value to the material of his labour, and the preservation of its former value, are two entirely distinct results, it is plain that this twofold nature of the result can be explained only by the twofold nature of his labour; it must at the same time create value through one of its properties and preserve or transfer value through another.	Da aber der Zusatz von neuem Wert zum Arbeitsgegenstand und die Erhaltung der alten Werte im Produkt zwei ganz verschiedne Resultate sind, die der Arbeiter in derselben Zeit hervorbringt, obgleich er nur einmal in derselben Zeit arbeitet, kann diese Doppelseitigkeit des Resultats offenbar nur aus der Doppelseitigkeit seiner Arbeit selbst erklärt werden.	ch08_clean.en-ch08_clean.de
	In demselben Zeitpunkt muß sie in einer Eigenschaft Wert schaffen und in einer andren Eigenschaft Wert erhalten oder übertragen.	ch08_clean.en-ch08_clean.de
Now how does every worker add fresh labour-time and therefore fresh value?	Wie setzt jeder Arbeiter Arbeitszeit und daher Wert zu?	ch08_clean.en-ch08_clean.de
Evidently, only by working productively in a particular way.	Immer nur in der Form seiner eigentümlich produktiven Arbeitsweise.	ch08_clean.en-ch08_clean.de
The spinner adds labour-time by spinning, the weaver by weaving, the smith by forging.	Der Spinner setzt nur Arbeitszeit zu, indem er spinnt, der Weber, indem er webt, der Schmied, indem er schmiedet.	ch08_clean.en-ch08_clean.de
But although these operations add labour as such, and therefore new values, it is only through the agency of labour directed to a particular purpose, by means of the spinning, the weaving and the forging respectively, that the means of production, the cotton and the spindle, the yarn and the loom, and the iron and the anvil, become constituent elements of the product, of a new use-value.	Durch die zweckbestimmte Form aber, worin sie Arbeit überhaupt zusetzen und daher Neuwert, durch das Spinnen, Weben, Schmieden werden die Produktionsmittel, Baumwolle und Spindel, Garn und Webstuhl, Eisen und Amboß, zu Bildungselementen eines Produkts, eines neuen Gebrauchswerts.	ch08_clean.en-ch08_clean.de
The old form of the use-value disappears, but it is taken up again in a new form of use-value.	Die alte Form ihres Gebrauchswert vergeht, aber nur um in einer neuen Form von Gebrauchswert aufzugehn.	ch08_clean.en-ch08_clean.de
We saw, when we were considering the process of creating value, that if a use-value is effectively consumed in the production of a new use-value, the quantity of labour expended to produce the article which has been consumed forms a part of the quantity of labour necessary to produce the new use-value; this portion is therefore labour transferred from the means of production to the new product.	Bei Betrachtung des Wertbildungsprozesses ergab sich aber, daß, soweit ein Gebrauchswert zweckgemäß vernutzt wird zur Produktion eines neuen Gebrauchswerts, die zur Herstellung des vernutzten Gebrauchswerts notwendige Arbeitszeit einen Teil der zur Herstellung des neuen Gebrauchswerts notwendigen Arbeitszeit bildet, also Arbeitszeit ist, die vom vernutzten Produktionsmittel auf das neue Produkt übertragen wird.	ch08_clean.en-ch08_clean.de
Hence the worker preserves the values of the already consumed means of production or transfers them to the product as portions of its value, not by virtue of his additional labour as such, but by virtue of the particular useful character of that labour, by virtue of its specific productive form.	Der Arbeiter erhält also die Werte der vernutzten Produktionsmittel oder überträgt sie als Wertbestandteile auf das Produkt, nicht durch sein Zusetzen von Arbeit überhaupt, sondern durch den besondren nützlichen Charakter, durch die spezifisch produktive Form dieser zusätzlichen Arbeit.	ch08_clean.en-ch08_clean.de
Therefore, in so far as labour is productive activity directed to a particular purpose, in so far as it is spinning, weaving or forging, etc., it raises the means of production from the dead merely by entering into contact with them, infuses them with life so that they become factors of the labour process, and combines with them to form new products.	Als solche zweckgemäße produktive Tätigkeit, Spinnen, Weben, Schmieden, erweckt die Arbeit durch ihren bloßen Kontakt die Produktionsmittel von den Toten, begeistet sie zu Faktoren des Arbeitsprozesses und verbindet sich mit ihnen zu Produkten.	ch08_clean.en-ch08_clean.de
If the specific productive labour of the worker were not spinning, he could not convert the cotton into yarn, and therefore he could not transfer the values of the cotton and spindle to the yarn.	Wäre die spezifische produktive Arbeit des Arbeiters nicht Spinnen, so würde er die Baumwolle nicht in Garn verwandeln, also auch die Werte von Baumwolle und Spindel nicht auf das Garn übertragen.	ch08_clean.en-ch08_clean.de
Suppose the same worker were to change his trade to that of a joiner, he would still by a day’s labour add value to the material he worked on.	Wechselt dagegen derselbe Arbeiter das Metier und wird Tischler, so wird er nach wie vor durch einen Arbeitstag seinem Material Wert zusetzen.	ch08_clean.en-ch08_clean.de
We see therefore that the addition of new value takes place not by virtue of his labour being spinning in particular, or joinery in particular, but because it is labour in general, abstract social labour; and we see also that the value added is of a certain definite amount, not because his labour has a particular useful content, but because it lasts for a definite length of time.	Er setzt ihn also zu durch seine Arbeit, nicht soweit sie Spinnarbeit oder Tischlerarbeit, sondern soweit sie abstrakte, gesellschaftliche Arbeit überhaupt, und er setzt eine bestimmte Wertgröße zu, nicht weil seine Arbeit einen besondren nützlichen Inhalt hat, sondern weil sie eine bestimmte Zeit dauert.	ch08_clean.en-ch08_clean.de
On the one hand, it is by virtue of its general character as expenditure of human labour-power in the abstract that spinning adds new value to the values of the cotton and the spindle; and on the other hand, it is by virtue of its special character as a concrete, useful process that the same labour of spinning both transfers the values of the means of production to the product and preserves them in the product.	In ihrer abstrakten, allgemeinen Eigenschaft also, als Verausgabung menschlicher Arbeitskraft, setzt die Arbeit des Spinners den Werten von Baumwolle und Spindel Neuwert zu, und in ihrer konkreten, besondren, nützlichen Eigenschaft als Spinnprozeß, überträgt sie den Wert dieser Produktionsmittel auf das Produkt und erhält so ihren Wert im Produkt.	ch08_clean.en-ch08_clean.de
Hence a twofold result emerges within the same period of time.	Daher die Doppelseitigkeit ihres Resultats in demselben Zeitpunkt.	ch08_clean.en-ch08_clean.de
By the simple addition of a certain quantity of labour, new value is added, and by the quality of this added labour, the original values of the means of production are preserved in the product.	Durch das bloß quantitative Zusetzen von Arbeit wird neuer Wert zugesetzt, durch die Qualität der zugesetzten Arbeit werden die alten Werte der Produktionsmittel im Produkt erhalten.	ch08_clean.en-ch08_clean.de
This twofold effect, resulting from the twofold character of labour, appears quite plainly in numerous phenomena.	Diese doppelseitige Wirkung derselben Arbeit infolge ihres doppelseitigen Charakters zeigt sich handgreiflich an verschiednen Erscheinungen.	ch08_clean.en-ch08_clean.de
Let us assume that some invention enables the spinner to spin as much cotton in 6 hours as he was able to spin before in 36 hours.	Nimm an, irgendeine Erfindung befähige den Spinner, in 6 Stunden so viel Baumwolle zu verspinnen wie früher in 36 Stunden.	ch08_clean.en-ch08_clean.de
His labour is now six times as effective as it was, considered as useful productive activity directed to a given purpose.	Als zweckmäßig nützliche, produktive Tätigkeit hat seine Arbeit ihre Kraft versechsfacht.	ch08_clean.en-ch08_clean.de
The product of 6 hours’ labour has increased sixfold, from 6 lb. to 36 lb.	Ihr Produkt ist ein sechsfaches, 36 statt 6 Pfund Garn.	ch08_clean.en-ch08_clean.de
But now the 36 lb. of cotton absorb only the same amount of labour as did the 6 lb. formerly.	Aber die 36 Pfund Baumwolle saugen jetzt nur so viel Arbeitszeit ein als früher 6 Pfund.	ch08_clean.en-ch08_clean.de
One-sixth as much new labour is absorbed by each pound of cotton, and consequently the value added by the labour to each pound is only one-sixth of what it formerly was.	Sechsmal weniger neue Arbeit wird ihnen zugesetzt als mit der alten Methode, daher nur noch ein Sechstel des früheren Werts.	ch08_clean.en-ch08_clean.de
On the other hand, in the product (the 36 lb. of yarn) the value transferred from the cotton is six times as great as before.	Andrerseits existiert jetzt der sechsfache Wert von Baumwolle im Produkt, den 36 Pfund Garn.	ch08_clean.en-ch08_clean.de
The value of the raw material preserved and transferred to the product by the 6 hours of spinning is six times as great as before, although the new value added by the labour of the spinner to each pound of the very same raw material is one-sixth of what it was formerly.	In den 6 Spinnstunden wird ein sechsmal größerer Wert von Rohmaterial erhalten und auf das Produkt übertragen, obgleich demselben Rohmaterial ein sechsmal kleinerer Neuwert zugesetzt wird.	ch08_clean.en-ch08_clean.de
This shows that the two properties of labour, by virtue of which it is enabled in one case to preserve value and in the other to create value, within the same indivisible process, are different in their very essence.	Dies zeigt, wie die Eigenschaft, worin die Arbeit während desselben unteilbaren Prozesses Werte erhält, wesentlich unterschieden ist von der Eigenschaft, worin sie Wert schafft.	ch08_clean.en-ch08_clean.de
On the one hand, the longer the time necessary to spin a given weight of cotton into yarn, the greater the amount of fresh value added to the cotton; but, on the other hand, the greater the weight of the cotton spun in a given time, the greater is the value preserved, by being transferred from it to the product.	Je mehr notwendige Arbeitszeit während der Spinnoperation auf dasselbe Quantum Baumwolle geht, desto größer der Neuwert, der der Baumwolle zugesetzt wird, aber je mehr Pfunde Baumwolle in derselben Arbeitszeit versponnen werden, desto größer der alte Wert, der im Produkt erhalten wird.	ch08_clean.en-ch08_clean.de
Let us now assume that the productivity of the spinner’s labour, instead of varying, remains constant, that he therefore requires the same time as he formerly did to convert one pound of cotton into yarn, but that the exchange-value of the cotton varies, either by rising to six times its former value or by falling to one-sixth of that value.	Nimm umgekehrt an, die Produktivität der Spinnarbeit bleibe unverändert, der Spinner brauche also nach wie vor gleich viel Zeit, um ein Pfund Baumwolle in Garn zu verwandeln. Aber der Tauschwert der Baumwolle selbst wechsle, ein Pfund Baumwolle steige oder falle um das Sechsfache seines Preises.	ch08_clean.en-ch08_clean.de
In both these cases, the spinner puts the same quantity of labour into a pound of cotton, and therefore adds as much value, as he did before the change in the value; he also produces a given weight of yarn in the same time as he did before.	In beiden Fällen fährt der Spinner fort, demselben Quantum Baumwolle dieselbe Arbeitszeit zuzusetzen, also denselben Wert, und in beiden Fällen produziert er in gleicher Zeit gleich viel Garn.	ch08_clean.en-ch08_clean.de
Nevertheless, the value he transfers from the cotton to the yarn is either six times what it was before, or, in the second case, one-sixth as much.	Dennoch ist der Wert, den er von der Baumwolle auf das Garn, das Produkt, überträgt, das eine Mal sechsmal kleiner, das andre Mal sechsmal größer als zuvor.	ch08_clean.en-ch08_clean.de
The same result occurs when the value of the instruments of labour rises or falls, while their usefulness in the labour process remains unaltered.	Ebenso wenn die Arbeitsmittel sich verteuern oder verwohlfeilern, aber stets denselben Dienst im Arbeitsprozeß leisten.	ch08_clean.en-ch08_clean.de
Again, if the technical conditions of the spinning process remain unchanged, and no change of value takes place in the means of production, the spinner continues to consume in equal working-times equal quantities of raw material and equal quantities of machinery of unvarying value.	Bleiben die technischen Bedingungen des Spinnprozesses unverändert und geht gleichfalls kein Wertwechsel mit seinen Produktionsmitteln vor, so verbraucht der Spinner nach wie vor in gleichen Arbeitszeiten gleiche Quanta Rohmaterial und Maschinerie von gleichbleibenden Werten.	ch08_clean.en-ch08_clean.de
The value preserved in the product is directly proportional to the new value added to the product.	Der Wert, den er im Produkt erhält, steht dann in direktem Verhältnis zu dem Neuwert, den er zusetzt.	ch08_clean.en-ch08_clean.de
In two weeks the spinner adds twice as much labour, and therefore twice as much value, as in one week, and during the same time he consumes twice as much material, and wears out twice as much machinery, of double the value in each case; he therefore preserves, in the product of two weeks, twice as much value as in the product of one week.	In zwei Wochen setzt er zweimal mehr Arbeit zu als in einer Woche, also zweimal mehr Wert, und zugleich vernutzt er zweimal mehr Material von zweimal mehr Wert, und verschleißt zweimal mehr Maschinerie von zweimal mehr Wert, erhält also im Produkt von zwei Wochen zweimal mehr Wert als im Produkt einer Woche.	ch08_clean.en-ch08_clean.de
As long as the conditions of production remain the same, the more value the worker adds by fresh labour, the more value he transfers and preserves. However, this does not happen because he adds new value, but because the addition of new value takes place under unvaried conditions which are independent of his own labour.	Unter gegebnen gleichbleibenden Produktionsbedingungen erhält der Arbeiter um so mehr Wert, je mehr Wert er zusetzt, aber er erhält nicht mehr Wert, weil er mehr Wert zusetzt, sondern weil er ihn unter gleichbleibenden und von seiner eignen Arbeit unabhängigen Bedingungen zusetzt.	ch08_clean.en-ch08_clean.de
Of course it may be said, in a relative sense, that the worker always preserves old value in proportion to the added quantity of new value.	Allerdings kann in einem relativen Sinn gesagt werden, daß der Arbeiter stets in derselben Proportion alte Werte erhält, worin er Neuwert zusetzt.	ch08_clean.en-ch08_clean.de
Whether the value of cotton rises from one shilling to two shillings, or falls to sixpence, the worker invariably preserves in the product of one hour only half as much value as he preserves in two hours.	Ob die Baumwolle von 1 sh. auf 2 sh. steige oder auf 6 d. falle, er erhält in dem Produkt einer Stunde stets nur halb soviel Baumwollwert, wie der auch wechsle, als in dem Produkt von zwei Stunden.	ch08_clean.en-ch08_clean.de
Similarly, if the productivity of his own labour rises or falls, he will in the course of one hour spin either more or less cotton then he did before, and will consequently preserve more or less of the value of the cotton in the product of one hour; but, all the same, he will preserve twice as much value by two hours’ labour as he will by one.	Wechselt ferner die Produktivität seiner eignen Arbeit, sie steige oder falle, so wird er z.B. in einer Arbeitsstunde mehr oder weniger Baumwolle verspinnen als früher, und dementsprechend mehr oder weniger Baumwollwert im Produkt einer Arbeitsstunde erhalten.	ch08_clean.en-ch08_clean.de
Value exists only in use-values, in things, if we leave aside its purely symbolic representation in tokens.	Mit alledem wird er in zwei Arbeitsstunden zweimal mehr Wert erhalten als in einer Arbeitsstunde.	ch08_clean.en-ch08_clean.de
	Wert, von seiner nur symbolischen Darstellung im Wertzeichen abgesehn, existiert nur in einem Gebrauchswert, einem Ding.	ch08_clean.en-ch08_clean.de
(Man himself, viewed merely as the physical existence of labour-power, is a natural object, a thing, although a living, conscious thing, and labour is the physical manifestation [dingliche Aüsserung] of that power.)	(Der Mensch selbst, als bloßes Dasein von Arbeitskraft betrachtet, ist ein Naturgegenstand, ein Ding, wenn auch lebendiges, selbstbewußtes Ding, und die Arbeit selbst ist dingliche Äußerung jener Kraft.)	ch08_clean.en-ch08_clean.de
If therefore an article loses its use-value it also loses its value.	Geht daher der Gebrauchswert verloren, so geht auch der Wert verloren.	ch08_clean.en-ch08_clean.de
The reason why means of production do not lose their value at the same time as they lose their use-value is that they lose in the labour process the original form of their use-value only to assume in the product the form of a new use-value.	Die Produktionsmittel verlieren mit ihrem Gebrauchswert nicht zugleich ihren Wert, weil sie durch den Arbeitsprozeß die ursprüngliche Gestalt ihres Gebrauchswerts in der Tat nur verlieren, um im Produkt die Gestalt eines andren Gebrauchswerts zu gewinnen.	ch08_clean.en-ch08_clean.de
But however important it may be to value that it should have some use-value to exist in, it is still a matter of complete indifference what particular object serves this purpose.	So wichtig es aber für den Wert ist, in irgendeinem Gebrauchswert zu existieren, so gleichgültig ist es, in welchem er existiert, wie die Metamorphose der Waren zeigt.	ch08_clean.en-ch08_clean.de
We saw this when dealing with the metamorphosis of commodities. Hence it follows that in the labour process the means of production transfer their value to the product only in so far as they lose their exchange-value along with their independent use-value.	Es folgt hieraus, daß im Arbeitsprozeß Wert vom Produktionsmittel auf das Produkt nur übergeht, soweit das Produktionsmittel mit seinem selbständigen Gebrauchswert auch seinen Tauschwert verliert.	ch08_clean.en-ch08_clean.de
They only give up to the product the value they themselves lose as means of production.	Es gibt nur den Wert an das Produkt ab, den es als Produktionsmittel verliert.	ch08_clean.en-ch08_clean.de
But in this respect the objective factors of the labour process do not all behave in the same way.	Die gegenständlichen Faktoren des Arbeitsprozesses verhalten sich aber in dieser Hinsicht verschieden.	ch08_clean.en-ch08_clean.de
The coal burnt under the boiler vanishes without leaving a trace; so too the oil with which the axles of wheels are greased. Dye-stuffs and other auxiliary substances also vanish, but re-appear in the properties of the product.	Die Kohle, womit die Maschine geheizt wird, verschwindet spurlos, ebenso das Öl, womit man die Achse des Rades schmiert usw. Farbe und andre Hilfsstoffe verschwinden, zeigen sich aber in den Eigenschaften des Produkts.	ch08_clean.en-ch08_clean.de
The raw material forms the substance of the product, but only after it has undergone a change in its form.	Das Rohmaterial bildet die Substanz des Produkts, hat aber seine Form verändert.	ch08_clean.en-ch08_clean.de
Hence raw material and auxiliary substances lose the independent form with which they entered into the labour process.	Rohmaterial und Hilfsstoffe verlieren also die selbständige Gestalt, womit sie in den Arbeitsprozeß als Gebrauchswerte eintraten.	ch08_clean.en-ch08_clean.de
It is otherwise with the actual instruments of labour.	Anders mit den eigentlichen Arbeitsmitteln.	ch08_clean.en-ch08_clean.de
Tools, machines, factory buildings and containers are only of use in the labour process as long as they keep their original shape, and are ready each morning to enter into it in the same form.	Ein Instrument, eine Maschine, ein Fabrikgebäude, ein Gefäß usw. dienen im Arbeitsprozeß nur, solange sie ihre ursprüngliche Gestalt bewahren und morgen wieder in ebenderselben Form in den Arbeitsprozeß eingehn wie gestern.	ch08_clean.en-ch08_clean.de
And just as during their lifetime, that is to say during the labour process, they retain their shape independently of the product, so too after their death.	Wie sie während ihres Lebens, des Arbeitsprozesses, ihre selbständige Gestalt dem Produkt gegenüber bewahren, so auch nach ihrem Tode.	ch08_clean.en-ch08_clean.de
The mortal remains of machines, tools, workshops etc., always continue to lead an existence distinct from that of the product they helped to turn out.	Die Leichen von Maschinen, Werkzeugen, Arbeitsgebäuden usw. existieren immer noch getrennt von den Produkten, die sie bilden halfen.	ch08_clean.en-ch08_clean.de
If we now consider the case of any instrument of labour during the whole period of its service, from the day of its entry into the workshop to the day of its banishment to the lumber room, we find that during this period its use-value has been completely consumed, and therefore its exchange-value completely transferred to the product.	Betrachten wir nun die ganze Periode, während deren ein solches Arbeitsmittel dient, von dem Tag seines Eintritts in die Werkstätte bis zum Tage seiner Verbannung in die Rumpelkammer, so ist während dieser Periode sein Gebrauchswert von der Arbeit vollständig verzehrt worden und sein Tauschwert daher vollständig auf das Produkt übergegangen.	ch08_clean.en-ch08_clean.de
For instance, if a spinning machine lasts for ten years, it is plain that during that working period its total value is gradually transferred to the product of the ten years.	Hat eine Spinnmaschine z.B. in 10 Jahren ausgelebt, so ist während des zehnjährigen Arbeitsprozesses ihr Gesamtwert auf das zehnjährige Produkt übergegangen.	ch08_clean.en-ch08_clean.de
The lifetime of an instrument of labour is thus spent in the repetition of a greater or lesser number of similar operations.	Die Lebensperiode eines Arbeitsmittels umfängt also eine größere oder kleinere Anzahl stets von neuem mit ihm wiederholter Arbeitsprozesse.	ch08_clean.en-ch08_clean.de
The instrument suffers the same fate as the man.	Und es geht dem Arbeitsmittel wie dem Menschen.	ch08_clean.en-ch08_clean.de
Every day brings a man twenty-four hours nearer to his grave, although no one can tell accurately, merely by looking at a man, how many days he has still to travel on that road.	Jeder Mensch stirbt täglich um 24 Stunden ab. Man sieht aber keinem Menschen genau an, wieviel Tage er bereits verstorben ist.	ch08_clean.en-ch08_clean.de
This difficulty, however, does not prevent life insurance companies from using the theory of averages to draw very accurate, and what is more, very profitable conclusions about the length of a man’s life.	Dies verhindert Lebensversicherungsgesellschaften jedoch nicht, aus dem Durchschnittsleben der Menschen sehr sichre, und was noch viel mehr ist, sehr profitliche Schlüsse zu ziehn.	ch08_clean.en-ch08_clean.de
So it is with the instruments of labour.	So mit dem Arbeitsmittel.	ch08_clean.en-ch08_clean.de
It is known by experience how long on the average a machine of a particular kind will last.	Man weiß aus der Erfahrung, wie lang ein Arbeitsmittel, z.B. eine Maschine von gewisser Art, durchschnittlich vorhält.	ch08_clean.en-ch08_clean.de
Suppose its use-value in the labour process lasts only six days.	Gesetzt, sein Gebrauchswert im Arbeitsprozeß daure nur 6 Tage.	ch08_clean.en-ch08_clean.de
It then loses on average one-sixth of its use-value every day, and therefore parts with one-sixth of its value to each day’s product.	So verliert es im Durchschnitt jeden Arbeitstag 1/6 seines Gebrauchswerts und gibt daher 1/6 seines Werts an das tägliche Produkt ab.	ch08_clean.en-ch08_clean.de
The deterioration of all instruments, their daily loss of use-value, and the corresponding quantity of value they part with to the product, are accordingly calculated on this basis.	In dieser Art wird der Verschleiß aller Arbeitsmittel berechnet, also z.B. ihr täglicher Verlust an Gebrauchswert und ihr entsprechende tägliche Wertabgabe an das Produkt.	ch08_clean.en-ch08_clean.de
It is thus strikingly clear that means of production never transfer more value to the product than they themselves lose during the labour process by the destruction of their own use-value.	Es zeigt sich so schlagend, daß ein Produktionsmittel nie mehr Wert an das Produkt abgibt, als es im Arbeitsprozeß durch Vernichtung seines eignen Gebrauchswerts verliert.	ch08_clean.en-ch08_clean.de
If an instrument of production has no value to lose, i.e. if it is not the product of human labour, it transfers no value to the product.	Hätte es keinen Wert zu verlieren, d.h. wäre es nicht selbst Produkt menschlicher Arbeit, so würde es keinen Wert an das Produkt abgeben.	ch08_clean.en-ch08_clean.de
It helps to create use-value without contributing to the formation of exchange-value.	Es diente als Bildner von Gebrauchswert, ohne als Bildner von Tauschwert zu dienen.	ch08_clean.en-ch08_clean.de
This is true of all those means of production supplied by nature without human assistance, such as land, wind, water, metals in the form of ore, and timber in virgin forests. Here we are confronted with another interesting phenomenon.	Dies ist daher der Fall mit allen Produktionsmitteln, die von Natur, ohne menschliches Zutun, vorhanden sind, mit Erde, Wind, Wasser, dem Eisen in der Erzader, dem Holze des Urwaldes usw. Ein andres interessantes Phänomen tritt uns hier entgegen.	ch08_clean.en-ch08_clean.de
Suppose a machine is worth £1,000, and wears out in 1, days.	Eine Maschine sei z.B. 1.000 Pfd.St. wert und schleiße sich in 1.000 Tagen ab.	ch08_clean.en-ch08_clean.de
Then every day one-thousandth of the value of the machine is transferred to the day’s product.	In diesem Fall geht täglich 1/1.000 des Werts der Maschine von ihr selbst auf ihr tägliches Produkt über.	ch08_clean.en-ch08_clean.de
At the same time the machine as a whole continues to take part in the labour process, though with diminishing vitality.	Zugleich, wenn auch mit abnehmender Lebenskraft, wirkt stets die Gesamtmaschine im Arbeitsprozeß.	ch08_clean.en-ch08_clean.de
Thus it appears that one factor of the labour process, a means of production, continually enters as a whole into that process, while it only enters in parts into the valorization process.	Es zeigt sich also, daß ein Faktor des Arbeitsprozesses, ein Produktionsmittel, ganz in den Arbeitsprozeß, aber nur zum Teil in den Verwertungsprozeß eingeht.	ch08_clean.en-ch08_clean.de
The distinction between the labour process and the valorization process is reflected here in their objective factors, in that one and the same means of production, in one and the same process of production, counts in its totality as an element in the labour process, but only piece by piece as an element in the creation of value.	Der Unterschied von Arbeitsprozeß und Verwertungsprozeß reflektiert sich hier an ihren gegenständlichen Faktoren, indem dasselbe Produktionsmittel als Element des Arbeitsprozesses ganz und als Element der Wertbildung nur stückweis in demselben Produktionsprozeß zählt. Andrerseits kann umgekehrt ein Produktionsmittel ganz in den Verwertungsprozeß eingehn, obgleich nur stückweis in den Arbeitsprozeß.	ch08_clean.en-ch08_clean.de
On the other hand a means of production may enter as a whole into the valorization process, although it enters only piece by piece into the labour process.	Nimm an, beim Verspinnen der Baumwolle fielen täglich auf 115 Pfund 15 Pfund ab, die kein Garn, sondern nur devil's dust <Baumwollstaub> bilden.	ch08_clean.en-ch08_clean.de
Suppose that in spinning cotton, the waste for every 115 lb. used amounts to 15 lb., which is converted, not into yarn, but into ‘devil’s dust’. * Now, although this amount of waste is normal and inevitable under average conditions of spinning, the value of the 15 lb. of cotton is just as surely transferred to the value of the yarn as is the value of the 100 lb. that form the substance of the yarn.	Dennoch, wenn dieser Abfall von 15 Pfund normal, von der Durchschnittsverarbeitung der Baumwolle unzertrennlich ist, geht der Wert der 15 Pfund Baumwolle, die kein Element des Garns, ganz ebensosehr in den Garnwert ein, wie der Wert der 100 Pfund, die seine Substanz bilden.	ch08_clean.en-ch08_clean.de
The use-value of 15 lb. of cotton must vanish into dust before 100 lb. of yarn can be made.	Der Gebrauchswert von 15 Pfund Baumwolle muß verstauben, um 100 Pfund Garn zu machen.	ch08_clean.en-ch08_clean.de
The destruction of this cotton is therefore a necessary condition for the production of the yarn.	Der Untergang dieser Baumwolle ist also eine Produktionsbedingung des Garns.	ch08_clean.en-ch08_clean.de
And because it is a necessary condition, and for no other reason, the value of that cotton is transferred to the product.	Ebendeswegen gibt sie ihren Wert an das Garn ab.	ch08_clean.en-ch08_clean.de
The same holds good for every kind of refuse resulting from a labour process, where that refuse cannot be further employed as a means in the production of new and independent use-values.	Dies gilt von allen Exkrementen des Arbeitsprozesses, in dem Grad wenigstens, worin diese Exkremente nicht wieder neue Produktionsmittel und daher neue selbständige Gebrauchswerte bilden.	ch08_clean.en-ch08_clean.de
Such an employment of refuse can be seen in the large machine-building factories at Manchester, where mountains of iron turnings are carted away to the foundry in the evening, only to re-appear the next morning in the workshops as solid masses of iron.	So sieht man in den großen Maschinenfabriken zu Manchester Berge von Eisenabfällen, durch zyklopische Maschinen gleich Hobelspänen abgeschält, am Abend auf großen Wagen aus der Fabrik in die Eisengießerei wandern, um den andren Tag wieder als massives Eisen aus der Eisengießerei in die Fabrik zurückzuwandern.	ch08_clean.en-ch08_clean.de
We have seen that the means of production transfer value to the new product only when during the labour process they lose value in the shape of their old use-value.	Nur soweit Produktionsmittel während des Arbeitsprozesses Wert in der Gestalt ihrer alten Gebrauchswerte verlieren, übertragen sie Wert auf die neue Gestalt des Produkts.	ch08_clean.en-ch08_clean.de
The maximum loss of value the means of production can suffer in the process is plainly limited by the amount of the original value with which they entered into it, or, in other words, by the labour-time required to produce them.	Das Maximum des Wertverlustes, den sie im Arbeitsprozeß erleiden können, ist offenbar beschränkt durch die ursprüngliche Wertgröße, womit sie in den Arbeitsprozeß eintreten, oder durch die zu ihrer eignen Produktion erheischte Arbeitszeit;.	ch08_clean.en-ch08_clean.de
Therefore the means of production can never add more value to the product than they themselves possess independently of the process in which they assist.	Produktionsmittel können dem Produkt daher nie mehr Wert zusetzen, als sie unabhängig vom Arbeitsprozeß, dem sie dienen, besitzen.	ch08_clean.en-ch08_clean.de
However useful a given kind of raw material, or a machine, or other means of production may be, even if it cost £ or, say, 500 days of labour, it cannot under any circumstances add more than £ to the value of the product.	Wie nützlich auch ein Arbeitsmaterial, eine Maschine, ein Produktionsmittel: wenn es 150 Pf. St., sage 500 Arbeitstage, kostet, setzt es dem Gesamtprodukt, zu dessen Bildung es dient, nie mehr als 150 Pfd.St. zu.	ch08_clean.en-ch08_clean.de
Its value is determined not by the labour process into which it enters as a means of production, but by that out of which it has issued as a product.	Sein Wert ist bestimmt nicht durch den Arbeitsprozeß, worin es als Produktionsmittel eingeht, sondern durch den Arbeitsprozeß, woraus es als Produkt herauskommt.	ch08_clean.en-ch08_clean.de
In the labour process it serves only as a use-value, a thing with useful properties, and cannot therefore transfer any value to the product unless it possessed value before its entry into the process.	In dem Arbeitsprozeß dient es nur als Gebrauchswert, als Ding mit nützlichen Eigenschaften, und gäbe daher keinen Wert an das Produkt ab, hätte es nicht Wert besessen vor seinem Eintritt in den Prozeß.	ch08_clean.en-ch08_clean.de
While productive labour is changing the means of production into constituent elements of a new product, their value undergoes a metempsychosis.	Indem die produktive Arbeit Produktionsmittel in Bildungselemente eines neuen Produkts verwandelt, geht mit deren Wert eine Seelenwandrung vor.	ch08_clean.en-ch08_clean.de
It deserts the consumed body to occupy the newly created one.	Er geht aus dem verzehrten Leib in den neu gestalteten Leib über.	ch08_clean.en-ch08_clean.de
But this transmigration takes place, as it were, behind the back of the actual labour in progress.	Aber diese Seelenwandrung ereignet sich gleichsam hinter dem Rücken der wirklichen Arbeit.	ch08_clean.en-ch08_clean.de
The worker is unable to add new labour, to create new value, without at the same time preserving old values, because the labour he adds must be of a specific useful kind, and he cannot do work of a useful kind without employing products as the means of production of a new product, and thereby transferring their value to the new product.	Der Arbeiter kann neue Arbeit nicht zusetzen, also nicht neuen Wert schaffen, ohne alte Werte zu erhalten, denn er muß die Arbeit immer in bestimmter nützlicher Form zusetzen, und er kann sie nicht in nützlicher Form zusetzen, ohne Produkte zu Produktionsmitteln eines neuen Produkts zu machen und dadurch ihren Wert auf das neue Produkt zu übertragen.	ch08_clean.en-ch08_clean.de
The property therefore which labour-power in action, living labour, possesses of preserving value, at the same time that it adds it, is a gift of nature which costs the worker nothing, but is very advantageous to the capitalist since it preserves the existing value of his capital.	Es ist also eine Naturgabe der sich betätigenden Arbeitskraft, der lebendigen Arbeit, Wert zu erhalten, indem sie Wert zusetzt, eine Naturgabe, die dem Arbeiter nichts kostet, aber dem Kapitalisten viel einbringt, die Erhaltung des vorhandnen Kapitalwerts.	ch08_clean.en-ch08_clean.de
As long as trade is good, the capitalist is too absorbed in making profits to take notice of this gratuitous gift of labour.	(22a) Solange das Geschäft flott geht, ist der Kapitalist zu sehr in die Plusmacherei vertieft, um diese Gratisgabe der Arbeit zu sehn.	ch08_clean.en-ch08_clean.de
Violent interruptions of the labour process, crises, make him painfully aware of it.	Gewaltsame Unterbrechungen des Arbeitsprozesses, Krisen, machen sie ihm empfindlich bemerksam.	ch08_clean.en-ch08_clean.de
As regards the means of production, what is really consumed is their use-value, and the consumption of this use-value by labour results in the product.	Was überhaupt an den Produktionsmitteln verzehrt wird, ist ihr Gebrauchswert, durch dessen Konsumtion die Arbeit Produkte bildet.	ch08_clean.en-ch08_clean.de
There is in fact no consumption of their value and it would therefore be inaccurate to say that it is reproduced.	Ihr Wert wird in der Tat nicht konsumiert , kann also auch nicht reproduziert werden.	ch08_clean.en-ch08_clean.de
It is rather preserved; not by reason of any operation it itself undergoes in the labour process but because the use-value in which it originally existed vanishes (although when it vanishes, it does so into another use-value).	Er wird erhalten, aber nicht weil eine Operation mit ihm selbst im Arbeitsprozeß vorgeht, sondern weil der Gebrauchswert, worin er ursprünglich existiert, zwar verschwindet, aber nur in einem andren Gebrauchswert verschwindet.	ch08_clean.en-ch08_clean.de
Hence the value of the means of production re-appears in the value of the product, but it is not strictly speaking reproduced in that value.	Der Wert der Produktionsmittel erscheint daher wieder im Wert des Produkts, aber er wird, genau gesprochen, nicht reproduziert.	ch08_clean.en-ch08_clean.de
What is produced is a new use-value in which the old exchange-value re-appears.	Was produziert wird, ist der neue Gebrauchswert, worin der alte Tauschwert wieder erscheint.	ch08_clean.en-ch08_clean.de
It is otherwise with the subjective factor of the labour process, labour-power, which sets itself in motion independently.	Anders mit dem subjektiven Faktor des Arbeitsprozesses, der sich betätigenden Arbeitskraft.	ch08_clean.en-ch08_clean.de
While labour, because it is directed to a specific purpose, preserves and transfers to the product the value of the means of production, at the same time, throughout every instant it is in motion, it is creating an additional value, a new value.	Während die Arbeit durch ihre zweckmäßige Form den Wert der Produktionsmittel auf das Produkt überträgt und erhält, bildet jedes Moment ihrer Bewegung zusätzlichen Wert, Neuwert.	ch08_clean.en-ch08_clean.de
Suppose the process of production breaks off just when the worker has produced an equivalent for the value of his own labour-power, when for example by six hours of labour he has added a value of three shillings.	Gesetzt, der Produktionsprozeß breche ab beim Punkt, wo der Arbeiter ein Äquivalent für den Wert seiner eignen Arbeitskraft produziert, durch sechsstündige Arbeit z.B. einen Wert von 3 sh. zugesetzt hat.	ch08_clean.en-ch08_clean.de
This value is the excess of the total value of the product over the portion of its value contributed by the means of production.	Dieser Wert bildet den Überschuß des Produktenwerts über seine dem Wert der Produktionsmittel geschuldeten Bestandteile.	ch08_clean.en-ch08_clean.de
It is the only original value formed during this process, the only portion of the value of the product created by the process itself.	Er ist der einzige Originalwert, der innerhalb dieses Prozesses entstand, der einzige Wertteil des Produkts, der durch den Prozeß selbst produziert ist.	ch08_clean.en-ch08_clean.de
Of course, we do not forget that this new value only replaces the money advanced by the capitalist in purchasing labour-power, and spent by the worker on means of subsistence.	Allerdings ersetzt er nur das vom Kapitalisten beim Kauf der Arbeitskraft vorgeschoßne, vom Arbeiter selbst in Lebensmitteln verausgabte Geld.	ch08_clean.en-ch08_clean.de
With regard to the three shillings which have been expended, the new value of three shillings appears merely as a reproduction.	Mit Bezug auf die verausgabten 3 sh. erscheint der Neuwert von 3 sh. nur als Reproduktion.	ch08_clean.en-ch08_clean.de
Nevertheless, it is a real reproduction, and not, as in the case of the value of the means of production, simply an apparent one.	Aber er ist wirklich reproduziert, nicht nur scheinbar, wie der Wert der Produktionsmittel.	ch08_clean.en-ch08_clean.de
The replacement of one value by another is here brought about by the creation of new value.	Der Ersatz eines Werts durch den andren ist hier vermittelt durch neue Wertschöpfung.	ch08_clean.en-ch08_clean.de
We know however from what has gone before that the labour process may continue beyond the time necessary to reproduce and incorporate in the product a mere equivalent for the value of the labour-power.	Wir wissen jedoch bereits, daß der Arbeitsprozeß über den Punkt hinaus fortdauert, wo ein bloßes Äquivalent für den Wert der Arbeitskraft reproduziert und dem Arbeitsgegenstand zugesetzt wäre.	ch08_clean.en-ch08_clean.de
For this, six hours alone would be sufficient: but the process lasts longer, say for twelve hours.	Statt der 6 Stunden, die hierzu genügen, währt der Prozeß z.B. 12 Stunden.	ch08_clean.en-ch08_clean.de
The activity of labour-power, therefore, not only reproduces its own value, but produces value over and above this.	Durch die Betätigung der Arbeitskraft wird also nicht nur ihr eigner Wert reproduziert, sondern ein überschüssiger Wert produziert.	ch08_clean.en-ch08_clean.de
This surplus-value is the difference between the value of the product and the value of the elements consumed in the formation of the product, in other words the means of production and the labour-power.	Dieser Mehrwert bildet den Überschuß des Produktenwerts über den Wert der verzehrten Produktbildner, d.h. der Produktionsmittel und der Arbeitskraft.	ch08_clean.en-ch08_clean.de
In presenting the different parts played by the various factors of the labour process in the formation of the product’s value, we have in fact characterized the different functions allotted to the different elements of capital in its own valorization process.	Indem wir die verschiednen Rollen dargestellt, welche die verschiednen Faktoren des Arbeitsprozesses in der Bildung des Produktenwerts spielen, haben wir in der Tat die Funktionen der verschiednen Bestandteile des Kapitals in seinem eignen Verwertungsprozeß charakterisiert.	ch08_clean.en-ch08_clean.de
The excess of the total value of the product over the sum of the values of its constituent elements is the excess of the capital which has been valorized over the value of the capital originally advanced.	Der Überschuß des Gesamtwerts des Produkts über die Wertsumme seiner Bildungselemente ist der Überschuß des verwerteten Kapitals über den ursprünglich vorgeschoßnen Kapitalwert.	ch08_clean.en-ch08_clean.de
The means of production on the one hand, labour-power on the other, are merely the different forms of existence which the value of the original capital assumed when it lost its monetary form and was transformed into the various factors of the labour process.	Produktionsmittel auf der einen Seite, Arbeitskraft auf der andren sind nur die verschiednen Existenzformen, die der ursprüngliche Kapitalwert annahm bei Abstreifung seiner Geldform und seiner Verwandlung in die Faktoren des Arbeitsprozesses.	ch08_clean.en-ch08_clean.de
That part of capital, therefore, which is turned into means of production, i.e. the raw material, the auxiliary material and the instruments of labour, does not undergo any quantitative alteration of value in the process of production.	Der Teil des Kapitals also, der sich in Produktionsmittel, d.h. in Rohmaterial, Hilfsstoffe und Arbeitsmittel umsetzt, verändert seine Wertgröße nicht im Produktionsprozeß.	ch08_clean.en-ch08_clean.de
For this reason, I call it the constant part of capital, or more briefly, constant capital.	Ich nenne ihn daher konstanten Kapitalteil, oder kürzer: konstantes Kapital.	ch08_clean.en-ch08_clean.de
On the other hand, that part of capital which is turned into labour-power does undergo an alteration of value in the process of production.	Der in Arbeitskraft umgesetzte Teil des Kapitals verändert dagegen seinen Wert im Produktionsprozeß.	ch08_clean.en-ch08_clean.de
It both reproduces the equivalent of its own value and produces an excess, a surplus-value, which may itself vary, and be more or less according to circumstances.	Er reproduziert sein eignes Äquivalent und einen Überschuß darüber, Mehrwert, der selbst wechseln, größer oder kleiner sein kann.	ch08_clean.en-ch08_clean.de
This part of capital is continually being transformed from a constant into a variable magnitude.	Aus einer konstanten Größe verwandelt sich dieser Teil des Kapitals fortwährend in eine variable.	ch08_clean.en-ch08_clean.de
I therefore call it the variable part of capital, or more briefly, variable capital.	Ich nenne ihn daher variablen Kapitalteil, oder kürzer: variables Kapital.	ch08_clean.en-ch08_clean.de
The same elements of capital which, from the point of view of the labour process, can be distinguished respectively as the objective and subjective factors, as means of production and labour-power, can be distinguished, from the point of view of the valorization process, as constant and variable capital.	Dieselben Kapitalbestandteile, die sich vom Standpunkt des Arbeitsprozesses als objektive und subjektive Faktoren, als Produktionsmittel und Arbeitskraft unterscheiden, unterscheiden sich vom Standpunkt des Verwertungsprozesses als konstantes Kapital und variables Kapital.	ch08_clean.en-ch08_clean.de
The definition of constant capital given above by no means excludes the possibility of a change of value in its elements.	Der Begriff des konstanten Kapitals schließt eine Wertrevolution seiner Bestandteile in keiner Weise aus.	ch08_clean.en-ch08_clean.de
Suppose that the price of cotton is one day sixpence a pound, and the next day, as a result of a failure of the cotton crop, a shilling a pound.	Nimm an, das Pfund Baumwolle koste heute 6 d. und steige morgen, infolge eines Ausfalls der Baumwollernte, auf 1 sh.	ch08_clean.en-ch08_clean.de
Each pound of the cotton bought at sixpence, and worked up after the rise in value, transfers to the product a value of one shilling; and the cotton already spun before the rise, and perhaps circulating in the market as yarn, similarly transfers to the product twice its original value.	Die alte Baumwolle, die fortfährt, verarbeitet zu werden, ist zum Wert von 6 d. gekauft, fügt aber jetzt dem Produkt einen Wertteil von 1 sh. zu. Und die bereits versponnene, vielleicht schon als Garn auf dem Markt zirkulierende Baumwolle fügt dem Produkt ebenfalls das Doppelte ihres ursprünglichen Werts zu.	ch08_clean.en-ch08_clean.de
It is plain, however, that these changes of value are independent of the valorization of the cotton in the spinning process itself.	Man sieht jedoch, daß diese Wertwechsel unabhängig sind von der Verwertung der Baumwolle im Spinnprozeß selbst.	ch08_clean.en-ch08_clean.de
If the old cotton had never been spun, it could be resold at a shilling a pound after the rise, instead of at sixpence.	Wäre die alte Baumwolle noch gar nicht in den Arbeitsprozeß eingegangen, so könnte sie jetzt zu 1 sh. statt zu 6 d. wieder verkauft werden.	ch08_clean.en-ch08_clean.de
Further, the fewer the processes the cotton has gone through, the more certain is this result.	Umgekehrt: Je weniger Arbeitsprozesse sie noch durchlaufen hat, desto sichrer ist dies Resultat.	ch08_clean.en-ch08_clean.de
We therefore find that speculators make it a rule, when such sudden changes in value occur, to speculate in the raw material in its least worked-up form: to speculate, therefore, in yarn rather than in cloth, and indeed in cotton itself rather than in yarn.	Es ist daher Gesetz der Spekulation, bei solchen Wertrevolutionen auf das Rohmaterial in seiner mindest verarbeiteten Form zu spekulieren, also eher auf Garn als auf Gewebe und eher auf die Baumwolle selbst als auf das Garn.	ch08_clean.en-ch08_clean.de
The change of value in the case we have been considering originates not in the process in which the cotton plays the part of a means of production, and in which it therefore functions as constant capital, but in the process in which the cotton itself is produced.	Die Wertänderung entspringt hier in dem Prozeß, der Baumwolle produziert, nicht in dem Prozeß, worin sie als Produktionsmittel und daher als konstantes Kapital funktioniert.	ch08_clean.en-ch08_clean.de
The value of a commodity is certainly determined by the quantity of labour contained in it, but this quantity is itself socially determined.	Der Wert einer Ware ist zwar bestimmt durch das Quantum der in ihr enthaltnen Arbeit, aber dies Quantum selbst ist gesellschaftlich bestimmt.	ch08_clean.en-ch08_clean.de
If the amount of labour-time socially necessary for the production of any commodity alters – and a given weight of cotton represents more labour after a bad harvest than after a good one – this reacts back on all the old commodities of the same type, because they are only individuals of the same species, and their value at any given time is measured by the labour socially necessary to produce them, i.e. by the labour necessary under the social conditions existing at the time.	Hat sich die gesellschaftlich zu ihrer Produktion erheischte Arbeitszeit verändert - und dasselbe Quantum Baumwolle z.B. stellt in ungünstigen Ernten größeres Quantum Arbeit dar, als in günstigen - , so findet eine Rückwirkung auf die alte Ware statt, die immer nur als einzelnes Exemplar ihrer Gattung gilt , deren Wert stets durch gesellschaftlich notwendige, also auch stets unter gegen- wärtigen gesellschaftlichen Bedingungen notwendige Arbeit gemessen wird.	ch08_clean.en-ch08_clean.de
As the value of the raw material may change, so too may that of the instruments of labour, the machinery, etc. employed in the process; and consequently that portion of the value of the product transferred to it from them may also change.	Wie der Wert des Rohmaterials, mag der Wert bereits im Produktionsprozeß dienender Arbeitsmittel, der Maschinerie usw., wechseln, also auch der Wertteil, den sie dem Produkt abgeben.	ch08_clean.en-ch08_clean.de
If, as a result of a new invention, machinery of a particular kind can be produced with a lessened expenditure of labour, the old machinery undergoes a certain amount of depreciation, and therefore transfers proportionately less value to the product.	Wird z.B. infolge einer neuen Erfindung Maschinerie derselben Art mit verminderter Ausgabe von Arbeit reproduziert, so entwertet die alte Maschinerie mehr oder minder und überträgt daher auch verhältnismäßig weniger Wert auf das Produkt.	ch08_clean.en-ch08_clean.de
But here too the change in value originates outside the process in which the machine is acting as a means of production.	Aber auch hier entspringt der Wertwechsel außerhalb des Produktionsprozesses, worin die Maschine als Produktionsmittel funktioniert.	ch08_clean.en-ch08_clean.de
Once engaged in this process the machine cannot transfer more value than it possesses independently of the process.	In diesem Prozeß gibt sie nie mehr Wert ab, als sie unabhängig von diesem Prozeß besitzt.	ch08_clean.en-ch08_clean.de
Just as a change in the value of the means of production, even after they have begun to take part in the labour process, does not alter their character as constant capital, so too a change in the proportion of constant to variable capital does not affect the distinction in their functions.	Wie ein Wechsel im Wert der Produktionsmittel, ob auch rückwirkend nach ihrem bereits erfolgten Eintritt in den Prozeß, ihren Charakter als konstantes Kapital nicht verändert, ebensowenig berührt ein Wechsel in der Proportion zwischen konstantem und variablem Kapital ihren funktionellen Unterschied.	ch08_clean.en-ch08_clean.de
The technical conditions of the labour process may be revolutionized to such an extent that where formerly ten men using ten implements of small value worked up a relatively small quantity of raw material, one man may now, with the aid of one expensive machine, work up one hundred times as much raw material.	Die technischen Bedingungen des Arbeitsprozesses mögen z.B. so umgestaltet werden, daß, wo früher 10 Arbeiter mit 10 Werkzeugen von geringem Wert eine verhältnismäßig kleine Masse von Rohmaterial verarbeiteten, jetzt 1 Arbeiter mit einer teuren Maschine das hundertfache Rohmaterial verarbeitet.	ch08_clean.en-ch08_clean.de
In the latter case we have an enormous increase in the constant capital, i.e. the total value of the means of production employed, and at the same time a great reduction in the variable part of the capital, which has been laid out in labour-power.	In diesem Fall wäre das konstante Kapital, d.h. die Wertmasse der angewandten Produktionsmittel, sehr gewachsen und der variable Teil des Kapitals, der in Arbeitskraft vorgeschoßne, sehr gefallen.	ch08_clean.en-ch08_clean.de
This change however alters only the quantitative relation between the constant and the variable capital, or the proportion in which the total capital is split up into its constant and variable constituents; it has not in the least degree affected the essential difference between the two.	Dieser Wechsel ändert jedoch nur das Größenverhältnis zwischen konstantem und variablem Kapital oder die Proportion, worin das Gesamtkapital in konstante und variable Bestandteile zerfällt, berührt dagegen nicht den Unterschied von konstant und variabel.	ch08_clean.en-ch08_clean.de

