Chapter 9: The Rate of Surplus-Value 1. THE DEGREE OF EXPLOITATION OF LABOUR-POWER The surplus-value generated in the production process by C, the capital advanced, i.e. the valorization of the value of the capital C, presents itself to us first as the amount by which the value of the product exceeds the value of its constituent elements.	SIEBENTES KAPITEL Die Rate des Mehrwerts 1. Der Exploitationsgrad der Arbeitskraft Der Mehrwert, den das vorgeschoßne Kapital C im Produktionsprozeß erzeugt hat, oder die Verwertung des vorgeschoßnen Kapitalwerts C stellt sich zunächst dar als Überschuß des Werts des Produkts über die Wertsumme seiner Produktionselemente.	ch09_clean.en-ch09_clean.de
The capital C is made up of two components, one the sum of money c laid out on means of production, and the other the sum of money v expended on labour-power; c represents the portion of value which has been turned into constant capital, v that turned into variable capital.	Das Kapital C zerfällt in zwei Teile, eine Geldsumme c, die für Produktionsmittel, und eine andre Geldsumme v, die für Arbeitskraft verausgabt wird; c stellt den in konstantes, v den in variables Kapital verwandelten Wertteil vor.	ch09_clean.en-ch09_clean.de
At the beginning, then, C= c+ v: for example, if £ is the capital advanced, its components may be such that the £ = £ constant + £ variable.	Ursprünglich ist also C = c + v, z.B. das vorgeschoßne Kapital von 500 Pfd.St. = 410 Pfd.St. + 90 Pfd.St.	ch09_clean.en-ch09_clean.de
When the process of production is finished, we get a commodity whose value = (c + v) + s, where s is the surplus-value; or, taking our former figures, the value of this commodity is (£ constant + £ variable) + £ surplus.	Am Ende des Produktionsprozesses kommt Ware heraus, deren Wert = c + v + m, wo m der Mehrwert, z.B. 410 Pfd.St. + 90 Pfd.St. + 90 Pfd.St.	ch09_clean.en-ch09_clean.de
The original capital has now changed from C to C′, from £ to £590.	Das ursprüngliche Kapital C hat sich in C' verwandelt, aus 500 Pfd.St. in 590 Pfd.St.	ch09_clean.en-ch09_clean.de
The difference is s, or a surplus-value of £90. Since the value of the constituent elements of the product is equal to the value of the capital advanced, it is a mere tautology to say that the excess of the value of the product over the value of its constituent elements is equal to the valorization of the value of the capital advanced, or to the surplus-value produced.	Die Differenz zwischen beiden ist = m, einem Mehrwert von 90. Da der Wert der Produktionselemente gleich dem Wert des vorgeschoßnen Kapitals, so ist es in der Tat eine Tautologie, daß der Überschuß des Produktenwerts über den Wert seiner Produktionselemente gleich der Verwertung des vorgeschoßnen Kapitals oder gleich dem produzierten Mehrwert.	ch09_clean.en-ch09_clean.de
Nevertheless, we must examine this tautology a little more closely.	Indes erfordert diese Tautologie eine nähere Bestimmung.	ch09_clean.en-ch09_clean.de
The equation being made is between the value of the product and the value of its constituents consumed in the process of production.	Was mit dem Produktenwert verglichen wird, ist der Wert der in seiner Bildung aufgezehrten Produktionselemente.	ch09_clean.en-ch09_clean.de
Now we have seen how that portion of the constant capital which consists of the instruments of labour transfers to the product only a fraction of its value, while the remainder of that value continues in its old form of existence.	Nun haben wir aber gesehn, daß der aus Arbeitsmitteln bestehende Teil des angewandten konstanten Kapitals nur ein Stück seines Werts an das Produkt abgibt, während ein andres Stück in seiner alten Existenzform fortdauert.	ch09_clean.en-ch09_clean.de
Since this remainder plays no part in the formation of value, we may at present leave it on one side.	Da das letztre keine Rolle in der Wertbildung spielt, ist hier davon zu abstrahieren.	ch09_clean.en-ch09_clean.de
To introduce it into the calculation would make no difference.	Sein Hineinziehen in die Rechnung würde nichts ändern.	ch09_clean.en-ch09_clean.de
For instance, taking our former example, c = £410: assume that this sum consists of £ value of raw material, £ value of auxiliary material and £ value of the machinery worn away in the process; and assume that the total value of the machinery employed is £1,054.	Nimm an, c = 410 Pfd.St. bestehe aus Rohmaterial zu 312 Pfd.St., Hilfsstoffen zu 44 Pfd.St. und im Prozeß verschleißender Maschinerie von 54 Pfd.St., der Wert der wirklich angewandten Maschinerie betrage aber 1.054 Pfd.St.	ch09_clean.en-ch09_clean.de
Out of this latter sum, then, we reckon as advanced for the purpose of turning out the product the sum of £ alone, which the machinery loses by wear and tear while performing its function, and therefore parts with to the product.	Als vorgeschossen zur Erzeugung des Produktenwerts berechnen wir nur den Wert von 54 Pfd.St., den die Maschinerie durch ihre Funktion verliert und daher dem Produkt abgibt.	ch09_clean.en-ch09_clean.de
Now if we also reckoned the remaining £1,000, which continues to exist in its old form in the machinery, as transferred to the product, we would also have to reckon it as part of the value advanced, and thus make it appear on both sides of our calculation.	Rechneten wir die 1.000 Pfd.St. mit, die in ihrer alten Form fortexistieren als Dampfmaschine usw., so müßten wir sie auf beiden Seiten mitrechnen, auf Seite des vorgeschoßnen Werts und auf Seite des Produktenwerts (26a), und erhielten so resp.	ch09_clean.en-ch09_clean.de
We should, in this way, get £1, on one side and £1, on the other.	1.500 Pfd.St. und 1.590 Pfd.St.	ch09_clean.en-ch09_clean.de
The difference between these two sums, or the surplus-value, would still be £90.	Die Differenz oder der Mehrwert wäre nach wie vor 90 Pfd.St.	ch09_clean.en-ch09_clean.de
When we refer, therefore, to constant capital advanced for the production of value, we always mean the value of the means of production actually consumed in the course of production, unless the context demonstrates the reverse.	Unter dem zur Wertproduktion vorgeschoßnen konstanten Kapital verstehen wir daher, wo das Gegenteil nicht aus dem Zusammenhang erhellt, stets nur den Wert der in der Produktion verzehrten Produktionsmittel.	ch09_clean.en-ch09_clean.de
This being so, let us return to the formula C′= c + v, which we saw was transformed into C = (c + v) + s, C becoming C′.	Dies vorausgesetzt, kehren wir zurück zur Formel C = c + v, die sich in C' = c + v + m und eben dadurch C in C' verwandelt.	ch09_clean.en-ch09_clean.de
We know that the value of the constant capital is transferred to the product, and merely re-appears in it.	Man weiß, daß der Wert des konstanten Kapitals im Produkt nur wieder erscheint.	ch09_clean.en-ch09_clean.de
The new value actually created in the process, the ‘value-product’, is therefore not the same as the value of the product; it is not, as it would at first sight appear, (c + v) + s or £ constant + £ variable + £ surplus, but rather v + s or £ variable + £ surplus. In other words, not £ but £180.	Das im Prozeß wirklich neu erzeugte Wertprodukt ist also verschieden von dem aus dem Prozeß erhaltnen Produktenwert, daher nicht, wie es auf den ersten Blick scheint, c + v + m oder 410 Pfd.St. + 90 Pfd.St. + 90, sondern v + m oder 90 Pfd.St. + 90 Pfd.St., nicht 590 Pfd.St., sondern 180 Pfd.St.	ch09_clean.en-ch09_clean.de
If c, the constant capital, = O, in other words if there were branches of industry in which the capitalist could dispense with all means of production made by previous labour, whether raw material, auxiliary material, or instruments, employing only labour-power and materials supplied by nature, if that were the case, there would be no constant capital to transfer to the product.	Wäre c, das konstante Kapital, = 0, in andren Worten, gäbe es Industriezweige, worin der Kapitalist keine produzierten Produktionsmittel, weder Rohmaterial noch Hilfsstoffe, noch Arbeitsinstrumente, sondern nur von Natur vorhandne Stoffe und Arbeitskraft anzuwenden hätte, so wäre kein konstanter Wertteil auf das Produkt zu übertragen.	ch09_clean.en-ch09_clean.de
This component of the value of the product, i.e. the £ in our example, would be eliminated, but the sum of £180, the amount of new value created, or the value produced, which contains £ of surplus-value, would remain just as great as if c represented the highest value imaginable.	Dies Element des Produktenwerts, in unsrem Beispiel 410 Pfd.St., fiele fort, aber das Wertprodukt von 180 Pfd.St., welches 90 Pfd.St.	ch09_clean.en-ch09_clean.de
We should have C = (O + v) = v, and C′ the valorized capital = v + s, and therefore C′– C = s as before.	Mehrwert enthält, bliebe ganz ebenso groß, als ob c die größte Wertsumme darstellte.	ch09_clean.en-ch09_clean.de
On the other hand, if s = O, in other words if the labour-power whose value is advanced in the form of variable capital were to produce only its equivalent, we should have C = c + v, and C′ (the value of the product) = (c + v) + O, hence C = C′.	Wir hätten C = 0 + v = v, und C', das verwertete Kapital, = v + m, C' - C nach wie vor = m. Wäre umgekehrt m = 0, in andren Worten, hätte die Arbeitskraft, deren Wert im variablen Kapital vorgeschossen wird, nur ein Äquivalent produziert, so C = c + v, und C' (der Produktenwert) = c + v + 0, daher C = C'.	ch09_clean.en-ch09_clean.de
In this case the capital advanced would not have valorized its value.	Das vorgeschoßne Kapital hätte sich nicht verwertet.	ch09_clean.en-ch09_clean.de
From what has gone before we know that surplus-value is purely the result of an alteration in the value of v, of that part of the capital which was converted into labour-power; consequently, v+s = v + Δv (v plus an increment of v).	Wir wissen in der Tat bereits, daß der Mehrwert bloß Folge der Wertveränderung ist, die mit v, dem in Arbeitskraft umgesetzten Kapitalteil vorgeht, daß also v + m = v + Dv (v plus Inkrement von v) ist.	ch09_clean.en-ch09_clean.de
But the fact that it is v alone that varies, and the conditions of that variation, are obscured by the circumstance that in consequence of the increase in the variable component of the capital, there is also an increase in the sum total of the capital advanced.	Aber die wirkliche Wertveränderung und das Verhältnis, worin sich der Wert ändert, werden dadurch verdunkelt, daß infolge des Wachstums seines variierenden Bestandteils auch das vorgeschoßne Gesamtkapital wächst.	ch09_clean.en-ch09_clean.de
It was originally £ and becomes £590.	Es war 500, und es wird 590.	ch09_clean.en-ch09_clean.de
Therefore, in order that our investigation may lead to accurate results, we must make abstraction from that portion of the value of the product in which constant capital alone appears, and thus posit the constant capital as zero or make c = O. This is merely an application of a mathematical rule, employed whenever we operate with constant and variable magnitudes, related to each other only by the symbols of addition and subtraction.	Die reine Analyse des Prozesses erheischt also von dem Teil des Produktenwerts, worin nur konstanter Kapitalwert wieder erscheint, ganz zu abstrahieren, also das konstante Kapital c = 0 zu setzen, und damit ein Gesetz der Mathematik anzuwenden, wo sie mit variablen und konstanten Größen operiert und die konstante Größe nur durch Addition oder Subtraktion mit der variablen verbunden ist.	ch09_clean.en-ch09_clean.de
A further difficulty is caused by the original form of the variable capital.	Eine andre Schwierigkeit entspringt aus der ursprünglichen Form des variablen Kapitals.	ch09_clean.en-ch09_clean.de
	So im obigen Beispiel ist C' = 410 Pfd.St. konstantes Kapital + 90 Pfd.St. variables Kapital + 90 Pfd.St.	ch09_clean.en-ch09_clean.de
In our example, C′ = £ constant + £ variable+£ surplus; but £ is a given and therefore a constant quantity and hence it appears absurd to treat it as variable.	Mehrwert. Neunzig Pfd.St. sind aber eine gegebne, also konstante Größe, und es scheint daher ungereimt, sie als variable Größe zu behandeln.	ch09_clean.en-ch09_clean.de
In fact, however, the £ variable is here merely a symbol for the process undergone by this value.	Aber 90 Pfd.St. oder 90 Pfd.St. variables Kapital ist hier in der Tat nur Symbol für den Prozeß, den dieser Wert durchläuft.	ch09_clean.en-ch09_clean.de
The portion of the capital invested in the purchase of labour-power is a definite quantity of objectified labour, a constant value like the value of the labour-power purchased.	Der im Ankauf der Arbeitskraft vorgeschoßne Kapitalteil ist ein bestimmtes Quantum vergegenständlichter Arbeit, also konstante Wertgröße, wie der Wert der gekauften Arbeitskraft.	ch09_clean.en-ch09_clean.de
But in the process of production the place of the £ is taken by labour-power which sets itself in motion, dead labour is replaced by living labour, something stagnant by something flowing, a constant by a variable.	Im Produktionsprozeß selbst aber tritt an die Stelle der vorgeschoßnen 90 Pfd.St. die sich betätigende Arbeitskraft, an die Stelle toter, lebendige Arbeit, an die Stelle einer ruhenden eine fließende Größe, an die Stelle einer konstanten eine variable.	ch09_clean.en-ch09_clean.de
The result is the reproduction of v plus an increment of v. From the point of view of capitalist production, therefore, the whole process appears as the independent motion of what was originally constant value, but has now been transformed into labour-power.	Das Resultat ist die Reproduktion von v plus Inkrement von v. Vom Standpunkt der kapitalistischen Produktion ist dieser ganze Verlauf Selbstbewegung des in Arbeitskraft umgesetzten, ursprünglich konstanten Werts.	ch09_clean.en-ch09_clean.de
Both the process and its result are ascribed to this independent motion of value.	Ihm wird der Prozeß und sein Resultat zugut geschrieben.	ch09_clean.en-ch09_clean.de
If, therefore, such expressions as ‘£ variable capital’ or ‘such and such a quantity of self-valorizing value’ appear to contain contradictions, this is only because they express a contradiction immanent in capitalist production.	Erscheint die Formel 90 Pfd.St. variables Kapital oder sich verwertender Wert daher widerspruchsvoll, so drückt sie nur einen der kapitalistischen Produktion immanenten Widerspruch aus.	ch09_clean.en-ch09_clean.de
At first sight it appears strange to equate the constant capital to zero.	Die Gleichsetzung des konstanten Kapitals mit 0 befremdet auf den ersten Blick.	ch09_clean.en-ch09_clean.de
But we do this every day.	Indes vollzieht man sie beständig im Alltagsleben.	ch09_clean.en-ch09_clean.de
If, for example, we want to calculate the amount of profit gained by England from the cotton industry, we first of all deduct the sums paid for cotton to the United States, India, Egypt and various other countries, i.e. we posit the value of the capital that merely re-appears in the value of the product as a zero magnitude.	Will jemand z.B. Englands Gewinn an der Baumwollindustrie berechnen, so zieht er vor allem den an die Vereinigten Staaten, Indien, Ägypten usw. gezahlten Baumwollpreis ab; d.h., er setzt im Produktenwert nur wiedererscheinenden Kapitalwert = 0.	ch09_clean.en-ch09_clean.de
Of course, the ratio of surplus-value not only to that portion of the capital from which it directly arises, and whose change in value it represents, but also to the sum total of the capital advanced, is economically of very great importance.	Allerdings hat das Verhältnis des Mehrwerts nicht nur zum Kapitalteil, woraus er unmittelbar entspringt und dessen Wertverändrung er darstellt, sondern auch zum vorgeschoßnen Gesamtkapital seine große ökonomische Bedeutung.	ch09_clean.en-ch09_clean.de
We shall therefore deal exhaustively with this ratio in our third book. * In order to enable one portion of capital to realize its value by being converted into labour-power, it is necessary that another portion be converted into means of production.	Wir behandeln dies Verhältnis daher ausführlich im dritten Buch. Um einen Teil des Kapitals durch seinen Umsatz in Arbeitskraft zu verwerten, muß ein andrer Teil des Kapitals in Produktionsmittel verwandelt werden.	ch09_clean.en-ch09_clean.de
In order that variable capital may perform its function, constant capital must be advanced to an adequate proportion, the proportion appropriate to the special technical conditions of each labour process.	Damit das variable Kapital funktioniere, muß konstantes Kapital in entsprechenden Proportionen, je nach dem bestimmten technischen Charakter des Arbeitsprozesses, vorgeschossen werden.	ch09_clean.en-ch09_clean.de
However, the fact that retorts and other vessels are necessary to a chemical process does not prevent the chemist from ignoring them when he undertakes his analysis of the results.	Der Umstand jedoch, daß man zu einem chemischen Prozeß Retorten und andre Gefäße braucht, verhindert nicht, bei der Analyse von der Retorte selbst zu abstrahieren.	ch09_clean.en-ch09_clean.de
If we look at the creation and the alteration of value for themselves, i.e. in their pure form, then the means of production, this physical shape taken on by constant capital, provides only the material in which fluid, value-creating labour-power has to be incorporated.	Sofern Wertschöpfung und Wertverändrung für sich selbst, d.h. rein betrachtet werden, liefern die Produktionsmittel, diese stofflichen Gestalten des konstanten Kapitals, nur den Stoff, worin sich die flüssige, wertbildende Kraft fixieren soll. Die Natur dieses Stoffes ist daher auch gleichgültig, ob Baumwolle oder Eisen.	ch09_clean.en-ch09_clean.de
Neither the nature nor the value of this material is of any importance.	Auch der Wert dieses Stoffes ist gleichgültig.	ch09_clean.en-ch09_clean.de
All that is needed is a sufficient supply of material to absorb the labour expended in the process of production.	Er muß nur in hinreichender Masse vorhanden sein, um das während des Produktionsprozesses zu verausgabende Arbeitsquantum einsaugen zu können.	ch09_clean.en-ch09_clean.de
That supply once given, the material may rise or fall in value, or even be without any value in itself, like the land and the sea; but this will have no influence on the creation of value or on the variation in the quantity of value.	Diese Masse gegeben, mag ihr Wert steigen oder fallen, oder sie mag wertlos sein, wie Erde und Meer, der Prozeß der Wertschöpfung und Wertverändrung wird nicht davon berührt.	ch09_clean.en-ch09_clean.de
In the first place, therefore, we equate the constant part of capital with zero.	Wir setzen also zunächst den konstanten Kapitalteil gleich Null.	ch09_clean.en-ch09_clean.de
The capital advanced is consequently reduced from c+v to v, and instead of the value of the product (c+v)+s we now have the value produced (v+s). Given that the new value produced = £180, a sum which consequently represents the whole of the labour expended during the process, if we subtract £ from it, being the value of the variable capital, we have £ left, the amount of the surplus-value.	Das vorgeschoßne Kapital reduziert sich daher von c + v auf v, und der Produktenwert c + v + m auf das Wertprodukt v + m. Gegeben das Wertprodukt = 180 Pfd.St., worin sich die während der ganzen Dauer des Produktionsprozesses fließende Arbeit darstellt, so haben wir den Wert des variablen Kapitals = 90 Pfd.St. abzuziehn, um den Mehrwert = 90 Pfd.St. zu erhalten.	ch09_clean.en-ch09_clean.de
This sum of £90, or s, expresses the absolute quantity of surplus-value produced.	Die Zahl 90 Pfd.St. = m drückt hier die absolute Größe des produzierten Mehrwerts aus.	ch09_clean.en-ch09_clean.de
The relative quantity produced, or the ratio in which the variable capital has valorized its value, is plainly determined by the ratio of the surplus-value to the variable capital, and expressed by s/v. In our example this ratio is 90/90, or 100 per cent.	Seine proportionelle Größe aber, also das Verhältnis, worin das variable Kapital sich verwertet hat, ist offenbar bestimmt durch das Verhältnis des Mehrwerts zum variablen Kapital oder ist ausgedrückt in m/v. Im obigen Beispiel also in 90/90 = 100 %.	ch09_clean.en-ch09_clean.de
This relative increase in the value of the variable capital, or the relative magnitude of the surplus-value, is called here the rate of surplus-value.	Diese verhältnismäßige Verwertung des variablen Kapitals oder die Verhältnismäßige Größe des Mehrwerts nenne ich Rate des Mehrwerts.	ch09_clean.en-ch09_clean.de
We have seen that the worker, during one part of the labour process, produces only the value of his labour-power, i.e. the value of his means of subsistence.	Wir haben gesehn, daß der Arbeiter während eines Abschnitts des Arbeitsprozesses nur den Wert seiner Arbeitskraft produziert, d.h. den Wert seiner notwendigen Lebensmittel.	ch09_clean.en-ch09_clean.de
Since his work forms part of a system based on the social division of labour, he does not directly produce his own means of subsistence. Instead of this, he produces a particular commodity, yarn for example, with a value equal to the value of his means of subsistence, or of the money for it.	Da er in einem auf gesellschaftlicher Teilung der Arbeit beruhenden Zustand produziert, produziert er seine Lebensmittel nicht direkt, sondern in Form einer besonderen Ware, des Garns z.B., einen Wert gleich dem Wert seiner Lebensmittel oder dem Geld, womit er sie kauft.	ch09_clean.en-ch09_clean.de
The part of his day’s labour devoted to this purpose will be greater or less, in proportion to the value of his average daily requirements or, what amounts to the same thing, in proportion to the labour-time required on average to produce them.	Der Teil seines Arbeitstags, den er hierzu verbraucht, ist größer oder kleiner, je nach dem Wert seiner durchschnittlichen täglichen Lebensmittel, also je nach der zu ihrer Produktion erheischten durchschnittlichen täglichen Arbeitszeit.	ch09_clean.en-ch09_clean.de
If the value of his daily means of subsistence represents an average of 6 hours’ objectified labour, the worker must work an average of 6 hours to produce that value.	Wenn der Wert seiner täglichen Lebensmittel im Durchschnitt 6 vergegenständlichte Arbeitsstunden darstellt, so muß der Arbeiter im Durchschnitt täglich 6 Stunden arbeiten, um ihn zu produzieren.	ch09_clean.en-ch09_clean.de
If, instead of working for the capitalist, he worked independently on his own account, he would, other things being equal, still be obliged to work for the same number of hours in order to produce the value of his labour-power, and thereby to gain the means of subsistence necessary for his own preservation or continued reproduction.	Arbeitete er nicht für den Kapitalisten, sondern für sich selbst, unabhängig, so müßte er, unter sonst gleichbleibenden Umständen, nach wie vor im Durchschnitt denselben aliquoten Teil des Tags arbeiten, um den Wert seiner Arbeitskraft zu produzieren, und dadurch die zu seiner eignen Erhaltung oder beständigen Reproduktion nötigen Lebensmittel zu gewinnen.	ch09_clean.en-ch09_clean.de
But as we have seen, during that part of his day’s labour in which he produces the value of his labour-power, say 3 shillings, he produces only an equivalent for the value of his labour-power already advanced by the capitalist; the new value created only replaces the variable capital advanced.	Da er in dem Teil des Arbeitstags, worin er den Tageswert der Arbeitskraft, sage 3 sh., produziert, nur ein Äquivalent für ihren vom Kapitalisten bereits gezahlten (28a) Wert produziert, also durch den neu geschaffnen Wert nur den vorgeschoßnen variablen Kapitalwert ersetzt, erscheint diese Produktion von Wert als bloße Reproduktion.	ch09_clean.en-ch09_clean.de
It is owing to this fact that the production of the new value of 3 shillings has the appearance of a mere reproduction.	Den Teil des Arbeitstags also, worin diese Reproduktion vorgeht, nenne ich notwendige Arbeitszeit, die während derselben verausgabte Arbeit notwendige Arbeit.	ch09_clean.en-ch09_clean.de
I call the portion of the working day during which this reproduction takes place necessary labour-time, and the labour expended during that time necessary labour; necessary for the worker, because independent of the particular social form of his labour; necessary for capital and the capitalist world, because the continued existence of the worker is the basis of that world.	Notwendig für den Arbeiter, weil unabhängig von der gesellschaftlichen Form seiner Arbeit. Notwendig für das Kapital und seine Welt, weil das beständige Dasein des Arbeiters ihre Basis.	ch09_clean.en-ch09_clean.de
During the second period of the labour process, that in which his labour is no longer necessary labour, the worker does indeed expend labour-power, he does work, but his labour is no longer necessary labour, and he creates no value for himself.	Die zweite Periode des Arbeitsprozesses, die der Arbeiter über die Grenzen der notwendigen Arbeit hinaus schanzt, kostet ihm zwar Arbeit, Verausgabung von Arbeitskraft, bildet aber keinen Wert für ihn.	ch09_clean.en-ch09_clean.de
He creates surplus-value which, for the capitalist, has all the charms of something created out of nothing.	Sie bildet Mehrwert, der den Kapitalisten mit allem Reiz einer Schöpfung aus Nichts anlacht.	ch09_clean.en-ch09_clean.de
This part of the working day I call surplus labour-time, and to the labour expended during that time I give the name of surplus labour.	Diesen Teil des Arbeitstags nenne ich Surplusarbeitszeit, und die in ihr verausgabte Arbeit: Mehrarbeit (suplus labour).	ch09_clean.en-ch09_clean.de
It is just as important for a correct understanding of surplus-value to conceive it as merely a congealed quantity of surplus labour-time, as nothing but objectified surplus labour, as it is for a proper comprehension of value in general to conceive it as merely a congealed quantity of so many hours of labour, as nothing but objectified labour.	So entscheidend es für die Erkenntnis des Werts überhaupt, ihn als bloße Gerinnung von Arbeitszeit, als bloß vergegenständlichte Arbeit, so entscheidend ist es für die Erkenntnis des Mehrwerts, ihn als bloße Gerinnung von Surplusarbeitszeit, als bloß vergegenständlichte Mehrarbeit zu begreifen.	ch09_clean.en-ch09_clean.de
What distinguishes the various economic formations of society – the distinction between for example a society based on slave-labour and a society based on wage-labour – is the form in which this surplus labour is in each case extorted from the immediate producer, the worker.	Nur die Form, worin diese Mehrarbeit dem unmittelbaren Produzenten, dem Arbeiter, abgepreßt wird, unterscheidet die ökonomischen Gesellschaftsformationen, z.B. die Gesellschaft der Sklaverei von der der Lohnarbeit.	ch09_clean.en-ch09_clean.de
Since, on the one hand, the variable capital and the labour-power purchased by that capital are equal in value, and the value of this labour-power determines the necessary part of the working day; and since, on the other hand, the surplus-value is determined by the surplus part of the working day, it follows that surplus-value is in the same ratio to variable capital as surplus labour is to necessary labour. In other words, the rate of surplus value, s/ν = surplus labour/necessary labour.	Da der Wert des variablen Kapitals = Wert der von ihm gekauften Arbeitskraft, da der Wert dieser Arbeitskraft den notwendigen Teil des Arbeitstags bestimmt, der Mehrwert seinerseits aber bestimmt ist durch den überschüssigen Teil des Arbeitstags, so folgt: Der Mehrwert verhält sich zum variablen Kapital, wie die Mehrarbeit zur notwendigen, oder die Rate des Mehrwerts m/v = (Mehrarbeit)/(Notwendige Arbeit).	ch09_clean.en-ch09_clean.de
Both ratios, s/ν and surplus labour/necessary labour, express the necessary labour v necessary labour same thing in different ways; in the one case in the form of objectified labour, in the other in the form of living, fluid labour.	Beide Proportionen drücken dasselbe Verhältnis in verschiedner Form aus, das eine Mal in der Form vergegenständlichter, das andre Mal in der Form flüssiger Arbeit.	ch09_clean.en-ch09_clean.de
The rate of surplus-value is therefore an exact expression for the degree of exploitation of labour-power by capital, or of the worker by the capitalist.	Die Rate des Mehrwerts ist daher der exakte Ausdruck für den Exploitationsgrad der Arbeitskraft durch das Kapital oder des Arbeiters durch den Kapitalisten.	ch09_clean.en-ch09_clean.de
We assumed in our example that the value of the product = £ constant+£ variable+£ surplus, and that the capital advanced = £500.	(30a) Nach unsrer Annahme war der Wert des Produkts = 410 Pfd.St. + 90 Pfd. St + 90, das vorgeschoßne Kapital = 500 Pfd.St.	ch09_clean.en-ch09_clean.de
Since the surplus-value = £90, and the capital advanced = £500, we should, according to the usual way of reckoning, get 18 per cent as the rate of surplus-value (becauseit is generally confused with the rate of profit), a rate so low it might well cause a pleasant surprise to Mr Carey and other harmonizers. * But in fact the rate of surplus-value is not equal s/C or s/c+ν but to s/ν; thus it is not 90/ but 90/ = 100 per cent, which is more than five times the apparent degree of exploitation.	Da der Mehrwert = 90 und das vorgeschoßne Kapital = 500, würde man nach der gewöhnlichen Art der Berechnung herausbekommen, daß die Rate des Mehrwerts (die man mit der Profitrate verwechselt) = 18%, eine Verhältniszahl, deren Niedrigkeit Herrn Carey und andre Harmoniker rühren möchte. In der Tat aber ist die Rate des Mehrwerts nicht = m/C oder m/c + m, sondern = m/v, also nicht 90/500, sondern 90/90 =100%, mehr als das Fünffache des scheinbaren Exploitationsgrads.	ch09_clean.en-ch09_clean.de
Although, in the case we have supposed, we do not know the actual length of the working day, or the duration in days and weeks of the labour process, or the number of workers set in motion simultaneously by the variable capital of £90, the rate of surplus-value s/ν accurately discloses to us, by means of its equivalent expression, surplus labour/necessary labour, the relation between the two parts of the working day.	Obgleich wir nun im gegebnen Fall die absolute Größe des Arbeitstags nicht kennen, auch nicht die Periode des Arbeitsprozesses (Tag, Woche usw.), endlich nicht die Anzahl der Arbeiter, die das variable Kapital von 90 Pfd.St. gleichzeitig in Bewegung setzt, zeigt uns die Rate des Mehrwerts m/v durch ihre Konvertibilität in (Mehrarbeit)/(Notwendige Arbeit) genau das Verhältnis der zwei Bestandteile des Arbeitstags zueinander.	ch09_clean.en-ch09_clean.de
This relation is here one of equality, being 100 per cent.	Es ist 100%.	ch09_clean.en-ch09_clean.de
Hence the worker in our example works one half of the day for himself, the other half for the capitalist.	Also arbeitete der Arbeiter die eine Hälfte des Tags für sich und die andre für den Kapitalisten.	ch09_clean.en-ch09_clean.de
The method of calculating the rate of surplus-value is therefore, in brief, as follows. We take the total value of the product and posit the constant capital which merely re-appears in it as equal to zero.	Die Methode zur Berechnung der Rate des Mehrwerts ist also kurzgefaßt diese: Wir nehmen den ganzen Produktenwert und setzen den darin nur wiedererscheinenden konstanten Kapitalwert gleich Null.	ch09_clean.en-ch09_clean.de
What remains is the only value that has actually been created in the process of producing the commodity.	Die übrig- bleibende Wertsumme ist das einzige im Bildungsprozeß der Ware wirklich erzeugte Wertprodukt.	ch09_clean.en-ch09_clean.de
If the amount of surplus-value is given, we have only to deduct it from this remainder to find the variable capital.	Ist der Mehrwert gegeben, so ziehn wir ihn von diesem Wertprodukt ab, um das variable Kapital zu finden.	ch09_clean.en-ch09_clean.de
And vice versa if the latter is given and we need to find the surplus-value.	Umgekehrt, wenn letztres gegeben und wir den Mehrwert suchen.	ch09_clean.en-ch09_clean.de
If both are given, we have only to perform the concluding operation, namely calculate s/ν, the ratio of the surplus-value to the variable capital.	Sind beide gegeben, so ist nur noch die Schlußoperation zu verrichten, das Verhältnis des Mehrwerts zum variablen Kapital, m/v, zu berechnen.	ch09_clean.en-ch09_clean.de
Simple as the method is, it may not be amiss, by means of a few examples, to exercise the reader in the application of the novel principles underlying it.	So einfach die Methode, scheint es doch passend, den Leser in die ihr zu Grunde liegende und ihm ungewohnte Anschauungsweise durch einige Beispiele einzuexerzieren.	ch09_clean.en-ch09_clean.de
First we will take the case of a spinning mill containing 10, mule spindles, spinning No. yarn from American cotton, and producing 1 lb. of yarn weekly per spindle.	Zunächst das Beispiel Spinnerei von 10.000 Mulespindeln, die Nr. 32 Garn aus amerikanischer Baumwolle spinnt und 1 Pfund Garn wöchentlich per Spindel produziert.	ch09_clean.en-ch09_clean.de
We assume the waste to be 6 per cent: accordingly 10, lb. of cotton are consumed weekly, of which 600 lb. go to waste.	Der Abfall ist 6 %. Also werden 10.600 Pfund Baumwolle wöchentlich in 10.000 Pfund Garn und 600 Pfund Abfall verarbeitet.	ch09_clean.en-ch09_clean.de
The price of the cotton in April 1871 was 7 3/4d. per lb. ; the raw material therefore costs approximately £342.	Im April 1871 kostet diese Baumwolle 73/4 d. per Pfund, also für 10.600 Pfund rund 342 Pfd.St.	ch09_clean.en-ch09_clean.de
The 10, spindles, including machinery for preparation and motive power, cost, we will assume, £ per spindle, amounting to a total of £10,000.	Die 10.000 Spindeln, inklusive Vorspinnmaschinerie und Dampfmaschine, kosten 1 Pfd.St. per Spindel, also 10.000 Pfd.St.	ch09_clean.en-ch09_clean.de
Depreciation we put at 10 per cent, or £1, a year = £ a week.	Ihr Verschleiß beträgt 10% = 1.000 Pfd.St. oder wöchentlich 20 Pfd.St.	ch09_clean.en-ch09_clean.de
The rent of the building we suppose to be £ a year, or £ a week.	Die Miete des Fabrikgebäudes ist 300 Pfd.St. oder 6 Pfd.St. per Woche.	ch09_clean.en-ch09_clean.de
The amount of coal consumed (for 100 h.p. indicated, at 4 lb. of coal per horse-power per hour during 60 hours, and including coal consumed in heating the mill) is 11 tons a week at 8s.	Kohlen (4 Pfund per Stunde und Pferdekraft, auf 100 Pferdekraft (Indikator), und 60 Stunden per Woche inklusive Heizung des Gebäudes) 11 tons per Woche, zu 8 sh.	ch09_clean.en-ch09_clean.de
6d. a ton, and therefore comes to about £ 1/ a week; gas, £ a week, oil etc., £ 1/ a week. Total cost of the above auxiliary materials, £ a week.	6 d. die Tonne, kosten rund 41/2 Pfd.St. per Woche; Gas 1 Pfd.St. per Woche, Öl 41/2 Pfd.St. per Woche, also alle Hilfsstoffe 10 Pfd.St. per Woche.	ch09_clean.en-ch09_clean.de
Therefore the constant part of the value of the week’s product is £378.	Also ist der konstante Wertteil 378 Pfd.St. per Woche.	ch09_clean.en-ch09_clean.de
Wages amount to £ a week.		ch09_clean.en-ch09_clean.de
The price of the yarn is 12 1/4d. per lb., which gives, for the value of 10, lb., the sum of £510.	Der Arbeitslohn beträgt 52 Pfd.St. per Woche.	ch09_clean.en-ch09_clean.de
The surplus-value is therefore in this case £510– £ = £80.	Der Garnpreis ist 121/4 d. per Pfund oder 10.000 Pfd. = 510 Pfd.St., der Mehrwert also 510 - 430 = 80 Pfd.St.	ch09_clean.en-ch09_clean.de
We put the constant part of the value of the product equal to zero, as it plays no part in the creation of value.	Wir setzen den konstanten Wertteil von 378 Pfd.St. = 0, da er in der wöchentlichen Wertbildung nicht mitspielt.	ch09_clean.en-ch09_clean.de
There remains £ as the weekly value created, which = £ variable + £ surplus.	Bleibt das wöchentliche Wertprodukt von 132 = 52 + 80 Pfd.St.	ch09_clean.en-ch09_clean.de
The rate of surplus-value is therefore 80/ = 153 11/ per cent.	Die Rate des Mehrwerts also = 80/52 = 15311/13%.	ch09_clean.en-ch09_clean.de
In a working day of 10 hours with average labour the result is: necessary labour = 3 31/ hours, and surplus labour = 6 2/33.	Bei zehnstündigem durchschnittlichem Arbeitstag ergibt dies: Notwedige Arbeit = 331/33 Stunden und Mehrarbeit = 62/33 Stunden.	ch09_clean.en-ch09_clean.de
	Jacob gibt für das Jahr 1815, bei Annahme eines Weizenpreises von 80 sh. per Quarter und eines Durchschnittsertrags von 22 Buschels per acre, so daß der acre 11 Pfd.St. einbringt, folgende durch vorherige Kompensation verschiedner Posten sehr mangelhafte, aber für unsren Zweck genügende Rechnung. Wertproduktion per acre Samen(Weizen) 1 Pfd.St. 9 sh. Zehnten, Rates, Taxes 1 Pfd.St. 1 sh.	ch09_clean.en-ch09_clean.de
One more example.	Dünger 2 Pfd.St.	ch09_clean.en-ch09_clean.de
	10 sh.	ch09_clean.en-ch09_clean.de
Jacob gives the following calculation for the year 1815.	Rente 1 Pfd.St. 8 sh. Arbeitslohn 3 Pfd.St.	ch09_clean.en-ch09_clean.de
Owing to the previous adjustment of several items it is very imperfect; nevertheless it is sufficient for our purpose.	10 sh. Pächters Profit u. Zins 1 Pfd.St. 2 sh. Summa: 7 Pfd.St. 9 sh. Summa: 3 Pfd.St. 11 sh.	ch09_clean.en-ch09_clean.de
In it he assumes that the price of wheat is 8s. a quarter, and that the average yield per acre is 22 bushels. * Here the assumption is always made that the price of the product is the same as its value, and, moreover, surplus-value is distributed under the various headings of profit, interest, rent etc.	Der Mehrwert, stets unter der Voraussetzung, daß Preis des Produkts = seinem Wert, wird hier unter die verschiednen Rubriken, Profit, Zins, Zehnten usw. verteilt.	ch09_clean.en-ch09_clean.de
To us these headings are irrelevant We simply add them together, and the sum is a surplus-value of £ 11s.	Diese Rubriken sind uns gleichgültig. Wir addieren sie zusammen und erhalten einen Mehrwert von 3 Pfd.St.	ch09_clean.en-ch09_clean.de
0d. The sum of £ 19s.	11 sh. Die 3 Pfd.St.	ch09_clean.en-ch09_clean.de
0d. paid for seed and manure is constant capital, and we put it equal to zero.	19 sh. für Samen und Dünger setzen wir als konstanten Kapitalteil gleich Null.	ch09_clean.en-ch09_clean.de
There is left the sum of £ 10s.	Bleibt vorgeschoßnes variables Kapital von 3 Pfd.St.	ch09_clean.en-ch09_clean.de
0d., which is the variable capital advanced, and we see that a new value of £ 10s.	10 sh., an dessen Stelle ein Neuwert von 3 Pfd.St.	ch09_clean.en-ch09_clean.de
0d.+ £ 11s.	10 sh. + 3 Pfd.St.	ch09_clean.en-ch09_clean.de
0d. has been produced in its place.	11 sh. produziert worden ist.	ch09_clean.en-ch09_clean.de
Therefore s/ν = £ 11s.	Also beträgt m/v = (3 Pfd.St.	ch09_clean.en-ch09_clean.de
0d./£ 10s.	11 sh. )/(3 Pfd.St.	ch09_clean.en-ch09_clean.de
0d. i.e. more than 100 per cent.	10 sh. ), mehr als 100%.	ch09_clean.en-ch09_clean.de
The worker employs more than half his working day in producing the surplus-value, which different persons then share amongst themselves, on different pretexts.	Der Arbeiter verwendet mehr als die Hälfte seines Arbeitstags zur Produktion eines Mehrwerts, den verschiedne Personen auf verschiedne Verwände hin unter sich verteilen.	ch09_clean.en-ch09_clean.de
2. THE REPRESENTATION OF THE VALUE OF THE PRODUCT BY CORRESPONDING PROPORTIONAL PARTS OF THE PRODUCT Let us now return to the example which showed us how the capitalist converts money into capital.	(31a) 2. Darstellung des Produktenwerts in proportionellen Teilen des Produkts Kehren wir nun zum Beispiel zurück, das uns zeigte, wie der Kapitalist aus Geld Kapital macht.	ch09_clean.en-ch09_clean.de
The necessary labour of his spinning worker amounted to 6 hours, surplus labour was the same, the degree of exploitation of labour-power was therefore 100 per cent.	Die notwendige Arbeit seines Spinners betrug 6 Stunden, die Mehrarbeit desgleichen, der Exploitationsgrad der Arbeitskraft daher 100%.	ch09_clean.en-ch09_clean.de
The product of a working day of 12 hours is 20 lb. of yarn, having a value of 30s.	Das Produkt des zwölfstündigen Arbeitstags sind 20 Pfd.	ch09_clean.en-ch09_clean.de
No less than eight-tenths of this value, or 24s., is formed by the mere re-appearance in it of the value of the means of production ( lb. of cotton, value 20s., and the worn part of the spindle, 4s.).	Garn zum Wert von 30 sh. Nicht weniger als 8/10 dieses Garnwerts (24 sh.) sind gebildet durch den nur wieder erscheinenden Wert der verzehrten Produktionsmittel (20 Pfd.	ch09_clean.en-ch09_clean.de
In other words, this part consists of constant capital.	Baumwolle zu 20 sh., Spindel usw. zu 4 sh.) oder bestehn aus konstantem Kapital.	ch09_clean.en-ch09_clean.de
The remaining two-tenths, or 6s., is the new value created during the spinning process; one half of this replaces the value of the day’s labour-power, or the variable capital, the remaining half constitutes a surplus-value of 3s.	Die übrigen 2/10 sind der während des Spinnprozesses entstandne Neuwert von 6 sh., wovon eine Hälfte den vorgeschoßnen Tageswert der Arbeitskraft ersetzt oder das variable Kapital und die andre Hälfte eine Mehrwert von 3 sh. bildet.	ch09_clean.en-ch09_clean.de
The total value of the 20 lb. of yarn is thus made up as follows: 30s. value of yarn = 24s. constant + 3s. variable + 3s. surplus.	Der Gesamtwert der 20 Pfd. Garn ist also folgendermaßen zusammengesetzt: Garnwert von 30 sh. = 24 sh. + 3 sh. + 3 sh.	ch09_clean.en-ch09_clean.de
Since the whole of this value is contained in the 20 lb. of yarn produced, it follows that the various component parts of this value can be represented as being contained respectively in proportional parts of the product.	Da dieser Gesamtwert sich in dem Gesamtprodukt von 20 Pfd. Garn darstellt, müssen auch die verschiednen Wertelemente in proportionellen Teilen des Produkts darstellbar sein.	ch09_clean.en-ch09_clean.de
If the value of 30s. is contained in 20 lb. of yarn, then eight-tenths of this value, or the 24s. that forms its constant part, is contained in eight-tenths of the product, or in 16 lb. of yarn.	Existiert ein Garnwert von 30 sh. in 20 Pfd. Garn, so 8/10 dieses Werts, oder sein konstanter Teil von 24 sh. in 8/10 des Produkts, oder in 16 Pfd. Garn.	ch09_clean.en-ch09_clean.de
Of the latter, 13 1/ lb. represent the value of the raw material, the 20s. worth of cotton spun, and 2 2/ lb. represent the 4s. worth of spindle etc. worn away in the process.	Davon stellen 131/3 Pfd. den Wert des Rohmaterial dar, der versponnenen Baumwolle zu 20 sh. und 22/3 Pfd. den Wert der verzehrten Hilfsstoffe und Arbeitsmittel, Spindel usw. zu 4 sh.	ch09_clean.en-ch09_clean.de
	131/3 Pfund Garn stellen also alle im Gesamtprodukt vom 20 Pfd.	ch09_clean.en-ch09_clean.de
Hence the whole of the cotton used up in spinning the 20 lb. of yarn is represented by 13 1/ lb. of yarn.	Garn versponnene Baumwolle vor, das Rohmaterial des Gesamtprodukts, aber auch weiter nichts.	ch09_clean.en-ch09_clean.de
This latter weight of yarn admittedly contains by weight no more than 13 1/ lb. of cotton, worth 13 1/3s. ; but the 6 2/3s. additional value contained in it is the equivalent for the cotton consumed in spinning the remaining 6 2/ lb. of yarn.	In ihnen stecken zwar nur 131/3 Pfd. Baumwolle zum Wert von 131/3 sh., aber ihr zusätzlicher Wert von 62/3 sh. bildet ein Äquivalent für die in den andren 62/3 Pfd. Garn versponnene Baumwolle.	ch09_clean.en-ch09_clean.de
The effect is the same as if these 6 2/ lb. of yarn contained no cotton at all, and the whole 20 lb. of cotton were concentrated in the 13 1/ lb. of yarn.	Es ist, als ob letztren die Wolle ausgerupft und alle Wolle des Gesamtprodukts in 131/3 Pfd. Garn zusammengestopft wäre.	ch09_clean.en-ch09_clean.de
The latter weight, on the other hand, does not contain an atom of the value of the auxiliary materials and instruments of labour, or of the value newly created in the process.	Sie enthalten dagegen jetzt kein Atom des Werts der verbrauchten Hilfsstoffe und Arbeitsmittel noch des im Spinnprozeß geschaffnen Neuwerts.	ch09_clean.en-ch09_clean.de
In the same way, the 2 2/ lb. of yarn in which the 4s., the remainder of the constant capital, is embodied represent nothing but the value of the auxiliary materials and instruments of labour consumed in producing the 20 lb. of yarn.	Ebenso stellen weitre 22/3 Pfd. Garn, worin der Rest des konstanten Kapitals (= 4 sh.) steckt, nichts dar außer dem Wert der im Gesamtprodukt von 20 Pfd. Garn vernutzten Hilfsstoffe und Arbeitsmittel.	ch09_clean.en-ch09_clean.de
We have therefore arrived at this result: although eight-tenths of the product, or 16 lb. of yarn, seen in its physical existence as a use-value, is just as much the fabric of the spinner’s labour as the remainder of the same product, yet when viewed in this connection it does not contain and has not absorbed any labour expended during the process of spinning.	Acht Zehntel des Produkts, oder 16 Pfd. Garn, obgleich leiblich, als Gebrauchswert betrachtet, als Garn, ebensosehr Gebilde der Spinnarbeit wie die restierenden Produktteile, enthalten daher in diesem Zusammenhang keine Spinnarbeit, keine während des Spinnprozesses selbst eingesaugte Arbeit.	ch09_clean.en-ch09_clean.de
It is just as if the cotton had converted itself into yarn without any help, it is just as if the shape it had assumed was mere trickery and deceit.	Es ist, als ob sie sich ohne Spinnen in Garn verwandelt hätten und als wäre ihre Garngestalt reiner Lug und Trug.	ch09_clean.en-ch09_clean.de
In fact, when the capitalist has sold it for 24s. and, with the money, replaced his means of production it becomes evident that the 16 lb. of yarn is nothing more than cotton, spindle-waste and coal in disguise.	In der Tat, wenn der Kapitalist sie verkauft zu 24 sh. und damit seine Produktionsmittel zurückkauft, zeigt sich, daß 16 Pfd. Garn - nur verkleidete Baumwolle, Spindel, Kohle usw. sind.	ch09_clean.en-ch09_clean.de
On the other hand, the remaining two-tenths of the product, or 4 lb. of yarn, represent nothing but the new value of 6s. created during the 12 hours’ spinning process.	Umgekehrt stellen die übrigbleibenden 8/10 des Produkts oder 4 Pfd. Garn jetzt nichts dar außer dem im zwölfstündigen Spinnprozeß produzierten Neuwert von 6 sh.	ch09_clean.en-ch09_clean.de
All the value transferred to those 4 lb. from the raw material and instruments of labour consumed was so to speak intercepted in order to be incorporated in the 16 lb. first spun.	Was vom Wert der vernutzten Rohmaterialien und Arbeitsmittel in ihnen steckte, ward bereits ausgeweidet und den ersten 16 Pfd. Garn einverleibt. Die in 20 Pfd.	ch09_clean.en-ch09_clean.de
In this case, it is as if the spinner had spun 4 lb. of yarn out of air, or as if he had spun it with the aid of cotton and spindles which were available in nature, without human intervention, and therefore transferred no value to the product.	Garn verkörperte Spinnarbeit ist konzentriert auf 2/10 des Produkts. Es ist, als ob der Spinner 4 Pfd.	ch09_clean.en-ch09_clean.de
Of this 4 lb. of yarn, in which the whole of the value created in the daily process of spinning is condensed, one half represents the equivalent for the value of the labour consumed, or the 3s. of variable capital, the other half represents the 3s. of surplus-value.	Garn in der Luft gewirkt oder in Baumwolle und mit Spindeln, die ohne Zutat menschlicher Arbeit, von Natur vorhanden, dem Produkt keinen Wert zusetzen. Von den 4 Pfd. Garn, worin so das ganze Wertprodukt des täglichen Spinnprozesses existiert, stellt die eine Hälfte nur den Ersatzwert der vernutzten Arbeitskraft dar, also das variable Kapital von 3 sh., die andren 2 Pfd. Garn nur den Mehrwert von 3 sh.	ch09_clean.en-ch09_clean.de
Since 12 hours’ labour put in by the spinner are objectified in 6s., it follows that 60 hours’ labour are objectified in yarn of the value of 30s.	Da 12 Arbeitsstunden des Spinners sich in 6 sh. vergegenständlichen, sind im Garnwert von 30 sh. 60 Arbeitsstunden vergegenständlicht.	ch09_clean.en-ch09_clean.de
And this quantity of labour-time does in fact exist in the 20 lb. of yarn; for eight-tenths of the yarn, or 16 lb., is a materialization of the 48 hours’ labour expended before the beginning of the spinning process on the means of production; the other two-tenths, or 4 lb., is a materialization of the 12 hours’ labour expended during the process itself.	Sie existieren in 20 Pfd. Garn, wovon 8/10 oder 16 Pfd. die Materiatur von 48 vor dem Spinnprozeß vergangnen Arbeitsstunden sind, nämlich der in den Produktionsmitteln des Garns vergegenständlichten Arbeit, 2/10 oder 4 Pfd. dagegen die Materiatur der im Spinnprozeß selbst verausgabten 12 Arbeitsstunden.	ch09_clean.en-ch09_clean.de
On a former page* we saw that the value of the yarn is equal to the new value created during the production of that yarn plus the value previously existing in the means of production.	Früher sahen wir, daß der Garnwert gleich der Summe des in seiner Produktion erzeugten Neuwerts plus der bereits in seinen Produktionsmitteln präexistierenden Werte ist.	ch09_clean.en-ch09_clean.de
It has now been shown how the different constituents of the value of the product, distinguished according to their function or according to their concept, may be represented by corresponding proportional parts of the product itself.	Jetzt hat sich gezeigt, wie die funktionell oder begrifflich verschiednen Bestandteile des Produktenwerts in proportionellen Teilen des Produkts selbst darstellbar sind.	ch09_clean.en-ch09_clean.de
In this way, the product, i.e. the result of the process of production, is split up into different parts, one part representing only the labour previously spent on the means of production, or the constant capital, another part only the necessary labour spent during the process of production, or the variable capital, and another and last part only the surplus labour expended during the process, or the surplus-value. The decomposition of the product is as simple a task as it is important; this will be seen later when we apply it to complex and hitherto unsolved problems.	Diese Zerfällung des Produkts - des Resultats des Produktionsprozesses - in ein Quantum Produkt, das nur die in den Produktionsmitteln enthaltne Arbeit oder den konstanten Kapitalteil, ein andres Quantum, das nur die im Produktionsprozeß zugesetzte notwendige Arbeit oder den variablen Kapitalteil, und ein letztes Quantum Produkt, das nur die im selben Prozeß zugesetzte Mehrarbeit oder den Mehrwert darstellt, ist ebenso einfach als wichtig, wie ihre spätre Anwendung auf verwickelte und noch ungelöste Probleme zeigen wird.	ch09_clean.en-ch09_clean.de
So far we have treated the total product as the final result, ready for use, of a working day of 12 hours.	Wir betrachteten eben das Gesamtprodukt als fertiges Resultat des zwölfstündigen Arbeitstags.	ch09_clean.en-ch09_clean.de
We can, however, also follow this total product through all the stages of its production; and in this way we shall arrive at the same result as before if we represent the partial products, precipitated at different stages, as functionally distinct parts of the final or total product.	Wir können es aber auch in seinem Entstehungsprozeß begleiten und dennoch die Teilprodukte als funktionell unterschiedne Produktenteile darstellen.	ch09_clean.en-ch09_clean.de
The spinner produces 20 lb. of yarn in 12 hours.	Der Spinner produziert in 12 Stunden 20 Pfd.	ch09_clean.en-ch09_clean.de
Hence he produces 1 2/ lb. in 1 hour, and 13 1/ lb. in 8 hours, or a partial product equal in value to all the cotton that is spun in a whole day.	Garn, daher in einer Stunde 12/3 und in 8 Stunden 131/3 Pfd., also ein Teilprodukt vom Gesamt- wert der Baumwolle, die während des ganzen Arbeitstags versponnen wird.	ch09_clean.en-ch09_clean.de
Similarly, the partial product of the next period of 1 hour and 36 minutes is 2 2/ lb. of yarn.	In derselben Art und Weise ist das Teilprodukt der folgenden Stunde und 36 Minuten = 22/3 Pfd.	ch09_clean.en-ch09_clean.de
This represents the value of the instruments of labour that are consumed in 12 hours.	Garn und stellt daher den Wert der während der 12 Arbeitsstunden vernutzten Arbeitsmittel dar.	ch09_clean.en-ch09_clean.de
In the following hour and 12 minutes the spinner produces 2 lb. of yarn worth 3s., a value equal to the whole value he creates in his 6 hours of necessary labour.		ch09_clean.en-ch09_clean.de
Finally, in the last hour and 12 minutes he produces another 2 lb. of yarn, whose value is equal to the surplus-value created by his surplus labour in the course of half a day.	Ebenso produziert der Spinner in der folgenden Stunde und 12 Minuten 2 Pfd.	ch09_clean.en-ch09_clean.de
This method of calculation serves the English manufacturer for everyday use; it shows, he will say, that in the first 8 hours, or 2/ of the working day, he gets back the value of his cotton; and so on for the remaining hours.	Garn = 3 sh., ein Produktenwert gleich dem ganzen Wertprodukt, das er in 6 Stunden notwendiger Arbeit schafft. Endlich produziert er in den letzten 6/5 Stunden ebenfalls 2 Pfd. Garn, deren Wert gleich dem durch seine halbtägige Mehrarbeit erzeugten Mehrwert.	ch09_clean.en-ch09_clean.de
It is also a perfectly correct method, since it is in fact the first method given above, only transferred from the spatial sphere, in which the different parts of the completed product lie side by side, to the temporal sphere, in which those parts are produced in succession.	Diese Art Berechnung dient dem englischen Fabrikanten zum Hausgebrauch, und er wird z.B. sagen, daß er in den ersten 8 Stunden oder 2/3 des Arbeitstags seine Baumwolle herausschlägt usw. Man sieht, die Formel ist richtig, in der Tat nur die erste Formel, übersetzt aus dem Raum, wo die Teile des Produkts fertig nebeneinander liegen, in die Zeit, wo sie aufeinander folgen.	ch09_clean.en-ch09_clean.de
But it can also be accompanied by very barbaric notions, especially in the heads of people who are as much interested, practically, in the valorization process, as they are, theoretically, in misunderstanding it.	Die Formel kann aber auch von sehr barbarischen Vorstellungen begleitet sein, namentlich in Köpfen, die ebenso praktisch im Verwertungsprozeß interessiert sind, als sie ein Interesse haben, ihn theoretisch mißzuverstehn.	ch09_clean.en-ch09_clean.de
It may be imagined, for instance, that our spinner produces or replaces in the first 8 hours of the working day the value of the cotton, in the following hour and 36 minutes the value of the deterioration in the instruments of labour, in the next hour and 12 minutes the value of his wages, and finally that he devotes only the famous ‘last hour’ to the production of surplus-value for the factory-owner.	So kann sich eingebildet werden, daß unser Spinner z.B. in den ersten 8 Stunden seines Arbeitstags den Wert der Baumwolle, in der folgenden Stunde und 36 Minuten den Wert der verzehrten Arbeitsmittel, in der folgenden Stunde und 12 Minuten den Wert des Arbeitslohns produziert oder ersetzt, und nur die vielberühmte "letzte Stunde" dem Fabrikherrn, der Produktion von Mehrwert widmet.	ch09_clean.en-ch09_clean.de
In this way the spinner is made to perform the twofold miracle not only of producing cotton, spindles, steam-engine, coal, oil, etc., at the same time as he is using them to spin, but also of turning one working day of a given level of intensity into five similar days.	Dem Spinner wird so das doppelte Wunder aufgebürdet, Baumwolle, Spindel, Dampfmaschine, Kohle, Öl usw. in demselben Augenblick zu produzieren, wo er mit ihnen spinnt, und aus einem Arbeitstag von gegebnem Intensitätsgrad fünf solcher Tage zu machen.	ch09_clean.en-ch09_clean.de
For, in the example we are considering, the production of the raw material and the instruments of labour requires 24 divided by 6 = 4 working days of 12 hours each, and their conversion into yarn requires another such day.	In unsrem Fall nämlich erfordert die Produktion des Rohmaterials und der Arbeitsmittel 24/6 = 4 zwölfstündige Arbeitstage und ihre Verwandlung in Garn einen andren zwölfstündigen Arbeitstag.	ch09_clean.en-ch09_clean.de
That the love of profit induces an easy belief in such miracles, and that there is no lack of sycophantic doctrinaires to prove their existence is demonstrated by the following famous historical example.	Daß die Raubgier solche Wunder glaubt und nie den doktrinären Sykophanten mißt, der sie beweist, zeige nun ein Beispiel von historischer Berühmtheit.	ch09_clean.en-ch09_clean.de
3. SENIOR’S ‘LAST HOUR’ One fine morning, in the year 1836, Nassau W. Senior, who may be called the Clauren* of the English economists, a man famed both for his economic science and his beautiful style, was summoned from Oxford to Manchester, to learn in the latter place the political economy he taught in the former.	3. Seniors "Letzte Stunde" An einem schönen Morgen des Jahres 1836 wurde der wegen seiner ökonomischen Wissenschaft und seines schönen Stils berufene Nassau W. Senior, gewissermaßen der Clauren unter den englischen Ökonomen, von Oxford nach Manchester zitiert, um hier politische Ökonomie zu lernen, statt sie in Oxford zu lehren.	ch09_clean.en-ch09_clean.de
The manufacturers chose him as their prize-fighter, not only against the newly passed Factory Act† but against the Ten Hours’ Agitation which aimed to go beyond it.	Die Fabrikanten erkoren ihn zum Preisfechter gegen den neulich erlaßnen Factory Act und die darüber noch hinausstrebende Zehnstundenagitation.	ch09_clean.en-ch09_clean.de
With their usual practical acuteness they had realized that the learned professor ‘wanted a good deal of finishing’; that is why they invited him to Manchester.	Mit gewohntem praktischen Scharfsinn hatten sie erkannt, daß der Herr Professor "wanted a good deal of finishing" <"noch tüchtigen Schliff brauchte">. Sie verschrieben ihn daher nach Manchester.	ch09_clean.en-ch09_clean.de
For his part, the professor has embodied the lecture he received from the Manchester manufacturers in a pamphlet entitled Letters on the Factory Act, as it Affects the Cotton Manufacture (London, 1837).	Der Herr Professor seinerseits hat die zu Manchester von den Fabrikanten erhaltne Lektion stilisiert in dem Pamphlet: "Letters on the Factory Act, as it affects the cotton manufacture", London 1837.	ch09_clean.en-ch09_clean.de
Here we find, amongst other things, the following edifying passage: ‘Under the present law, no mill in which persons under 18 years of age are employed… can be worked more than 11 1/ hours a day, that is, 12 hours for 5 days in the week, and 9 on Saturday.	Hier kann man u.a. folgendes Erbauliche lesen: "Unter dem gegenwärtigen Gesetz kann keine Fabrik, die Personen unter 18 Jahren beschäftigt, länger als 11 1/2 Stunden täglich arbeiten, d.h. 12 Stunden während der ersten 5 Tage und 9 Stunden am Sonnabend.	ch09_clean.en-ch09_clean.de
Now the following analysis (!) will show that in a mill so worked, the whole net profit is derived from the last hour.	Die folgende Analyse (!) zeigt nun, daß in einer solchen Fabrik der ganze Reingewinn von der letzten Stunde abgeleitet ist.	ch09_clean.en-ch09_clean.de
I will suppose a manufacturer to invest £100, – £80, in his mill and machinery, and £20, in raw material and wages.	Ein Fabrikant legt 100.000 Pfd.St. aus - 80.000 Pfd.St. in Fabrikgebäude und Maschinen, 20.000 in Rohmaterial und Arbeitslohn.	ch09_clean.en-ch09_clean.de
The annual return of that mill, supposing the capital to be turned once a year, and gross profits to be 15 per cent, ought to be goods worth £115,000… Of this £115, each of the twenty-three half-hours of work produces five 115ths, or one 23rd.	Der jährliche Umsatz der Fabrik, vorausgesetzt, das Kapital schlage jährlich einmal um und der Bruttogewinn betrage 15%, muß sich auf Waren zum Wert von 115.000 Pfd.St. belaufen ...	ch09_clean.en-ch09_clean.de
Of these twenty-three 23rds (constituting the whole £115,000), twenty, that is to say £100, out of the £115,000, simply replace the capital; one 23rd (or £5, out of the £115,000) makes up for the deterioration of the mill and machinery.	Von diesen 115.000 Pfd.St. produziert jede der 23 halben Arbeitsstunden täglich 5/115 oder 1/23. Von diesen 23/23, die das Ganze der 115.000 Pfd.St. bilden (constituting the whole 115.000 Pfd.St. ), ersetzen 20/23, d.h. 100.000 von den 115.000, nur das Kapital; 1/23 oder 5.000 Pfd.St. von den 15.000 Brutto-Gewinn (!) ersetzen die Abnutzung der Fabrik und Maschinerie.	ch09_clean.en-ch09_clean.de
The remaining two 23rds, that is the last two of the twenty-three half-hours of every day, produce the net profit of 10 per cent.	Die übrigbleibenden 2/23, d.h. die beiden letzten halben Stunden jedes Tages produzieren den Reingewinn von 10%.	ch09_clean.en-ch09_clean.de
If, therefore (prices remaining the same), the factory could be kept at work 13 hours instead of 11 1/2, with an addition of about £2, to the circulating capital, the net profit would be more than doubled.	Wenn daher bei gleichbleibenden Preisen die Fabrik 13 Stunden statt 11 1/2 arbeiten dürfte, so würde, mit einer Zulage von ungefähr 2.600 Pfd.St. zum zirkulierenden Kapital, der Reingewinn mehr als verdoppelt werden.	ch09_clean.en-ch09_clean.de
On the other hand, if the hours of working were reduced by one hour per day (prices remaining the same), the net profit would be destroyed – if they were reduced by one hour and a half, even the gross profit would be destroyed.’	Andrerseits, wenn die Arbeitsstunden täglich um 1 Stunde reduziert würden, würde der Reingewinn verschwinden, wenn um 1 1/2 Stunden, auch der Bruttogewinn."	ch09_clean.en-ch09_clean.de
And the professor calls this an ‘analysis’!	Und das nennt der Herr Professor eine "Analyse"!	ch09_clean.en-ch09_clean.de
If he believed the out-cries of the manufacturers to the effect that the workers spent the best part of the day in the production, i.e. the reproduction or replacement, of the value of the buildings, machinery, cotton, coal, etc., then his analysis was superfluous.	Glaubte er den Fabrikantenjammer, daß die Arbeiter die beste Zeit des Tags in der Produktion, daher der Reproduktion oder dem Ersatz des Werts von Baulichkeiten, Maschinen, Baumwolle, Kohle usw. vergeuden, so war jede Analyse überflüssig.	ch09_clean.en-ch09_clean.de
His answer could simply have been this: ‘Gentlemen!	Er hatte einfach zu antworten: Meine Herren!	ch09_clean.en-ch09_clean.de
If you work your mills for 10 hours instead of 11 1/2, then, other things being equal, the daily consumption of cotton, machinery etc. will decrease in proportion.	Wenn ihr 10 Stunden arbeiten laßt statt 111/2, wird, unter sonst gleichbleibenden Umständen, der tägliche Verzehr von Baumwolle, Maschinerie usw. um 11/2 Stunden abnehmen.	ch09_clean.en-ch09_clean.de
You gain just as much as you lose.	Ihr gewinnt also grade so viel, als ihr verliert.	ch09_clean.en-ch09_clean.de
Your workpeople will in future spend one hour and a half less time in reproducing or replacing the capital advanced.’	Eure Arbeiter werden in Zukunft 11/2 Stunden weniger für Reproduktion oder Ersatz des vorgeschoßnen Kapitalwerts vergeuden.	ch09_clean.en-ch09_clean.de
If, on the other hand, he did not take them at their word but, being an expert in such matters, considered it necessary to undertake an analysis, then he ought, in a question which turns exclusively on the relation of the net profit to the length of the working day, above all to have asked the manufacturers to be careful not to lump together machinery, workshops, raw material and labour, but to be good enough to place the constant capital, invested in buildings, machinery, raw material etc., on one side of the account and the capital advanced in wages on the other side.	Glaubte er ihnen nicht aufs Wort, sondern hielt als Sachverständiger eine Analyse für nötig, so mußte er vor allem, in einer Frage, die sich ausschließlich um das Verhältnis des Reingewinns zur Größe des Arbeitstags dreht, die Herren Fabrikanten ersuchen, Maschinerie und Fabrikgebäude, Rohmaterial und Arbeit nicht kunterbunt durcheinanderzuwirren, sondern gefälligst das in Fabrikgebäude, Maschinerie, Rohmaterial usw. enthaltne konstante Kapital auf die eine, das in Arbeitslohn vorgeschoßne Kapital auf die andre Seite zu stellen.	ch09_clean.en-ch09_clean.de
If it then turned out that, according to the calculations of the manufacturers, the worker reproduced or replaced his wages in 2 half hours, in that case, he should have continued his analysis as follows: ‘According to your figures, the workman produces his wages in the last hour but one, and your surplus-value, or net profit, in the last hour.	Ergab sich dann etwa, daß nach der Fabrikantenrechnung der Arbeiter in 2/2 Arbeitsstunden, oder in einer Stunde, den Arbeitslohn reproduziert oder ersetzt, so hatte der Analytiker fortzufahren: Nach eurer Angabe produziert der Arbeiter in der vorletzten Stunde seinen Arbeitslohn und in der letzten euren Mehrwert oder den Reingewinn.	ch09_clean.en-ch09_clean.de
Now, since in equal periods he produces equal values, the product of the last hour but one must have the same value as that of the last hour.	Da er in gleichen Zeiträumen gleiche Werte produziert, hat das Produkt der vorletzten Stunde denselben Wert wie das der letzten.	ch09_clean.en-ch09_clean.de
Further, it is only while he works that he produces any value at all, and the quantity of work he does is measured by his labour-time.	Er produziert ferner nur Wert, soweit er Arbeit verausgabt, und das Quantum seiner Arbeit ist gemessen durch seine Arbeitszeit.	ch09_clean.en-ch09_clean.de
This you say amounts to 11 1/ hours a day.	Diese beträgt nach eurer Angabe 111/2 Stunden per Tag.	ch09_clean.en-ch09_clean.de
He employs one portion of these 11 1/ hours in producing or replacing his wages, and the remaining portion in producing your net profit.	Einen Teil dieser 111/2 Stunden verbraucht er zur Produktion oder zum Ersatz seines Arbeitslohns, den andren zur Produktion eures Reingewinns.	ch09_clean.en-ch09_clean.de
Beyond this he does absolutely nothing.	Weiter tut er nichts während des Arbeitstags.	ch09_clean.en-ch09_clean.de
But since, on your assumption, his wages and the surplus-value he provides are of equal value, it is clear that he produces his wages in 5 3/ hours, and your net profit in the other 5 3/ hours.	Da aber, nach Angabe, sein Lohn und der von ihm gelieferte Mehrwert gleich große Werte sind, produziert er offenbar seinen Arbeitslohn in 53/4 Stunden und euren Reingewinn in andren 53/4 Stunden.	ch09_clean.en-ch09_clean.de
Again, since the value of the yarn produced in 2 hours is equal to the sum of the value of his wages and of your net profit, the measure of the value of this yarn must be 11 1/ working hours, of which 5 3/ hours measure the value of the yarn produced in the last hour but one, and 5 3/ hours the value of the yarn produced in the last hour of all.	Da ferner der Wert des zweistündigen Garnprodukts gleich der Wertsumme seines Arbeitslohns plus eures Reingewinns ist, muß dieser Garnwert durch 111/2 Arbeitsstunden gemessen sein, das Produkt der vorletzten Stunde durch 53/4 Arbeitsstunden, das der letzten ditto.	ch09_clean.en-ch09_clean.de
We now come to a ticklish point, so watch out!	Wir kommen jetzt zu einem häklichen Punkt.	ch09_clean.en-ch09_clean.de
The last working hour but one is, like the first, an ordinary working hour, neither more nor less.	Also aufgepaßt! Die vorletzte Arbeitsstunde ist eine gewöhnliche Arbeitsstunde wie die erste.	ch09_clean.en-ch09_clean.de
How then can the spinner produce in one hour, in the shape of yarn, a value that embodies 5 3/ hours’ labour?	Ni plus, ni moins. <Nicht mehr, nicht weniger.> Wie kann der Spinner daher in einer Arbeitsstunde einen Garnwert produzieren, der 53/4 Arbeitsstunden darstellt?	ch09_clean.en-ch09_clean.de
The truth is that he does not perform any such miracle.	Er verrichtet in der Tat kein solches Wunder.	ch09_clean.en-ch09_clean.de
The use-value produced by him in one hour is a definite quantity of yarn.	Was er in einer Arbeitsstunde an Gebrauchswert produziert, ist ein bestimmtes Quantum Garn.	ch09_clean.en-ch09_clean.de
The value of this yarn is measured by 5 3/ working hours, of which 4 3/ were, without any assistance from him, previously embodied in the means of production, in the cotton, the machinery, and so on; the remaining one hour alone is added by him.	Der Wert dieses Garns ist gemessen durch 53/4 Arbeitsstunden, wovon 43/4 ohne sein Zutun in den stündlich verzehrten Produktionsmitteln stecken, in Baumwolle, Maschinerie usw., 4/4 oder eine Stunde von ihm selbst zugesetzt ist.	ch09_clean.en-ch09_clean.de
Therefore, since his wages are produced in 5 3/ hours, and the yarn produced in one hour also contains 5 3/ hours’ work, there is no witchcraft in the result that the value created by his 5 3/ hours of spinning is equal to the value of the product spun in one hour.	Da also sein Arbeitslohn in 53/4 Stunden produziert wird und das Garnprodukt einer Spinnstunde ebenfalls 53/4 Arbeitsstunden enthält, ist es durchaus keine Hexerei, daß das Wertprodukt seiner 53/4 Spinnstunden gleich dem Produktenwert einer Spinnstunde.	ch09_clean.en-ch09_clean.de
You are altogether on the wrong track, if you think that he loses a single moment of his working day in reproducing or replacing the values of the cotton, the machinery and so on. On the contrary, it is because his labour converts the cotton and the spindles into yarn, because he spins, that the values of the cotton and spindles go over to the yarn of their own accord.	Ihr seid aber durchaus auf dem Holzweg, wenn ihr meint, er verliere ein einziges Zeitatom seines Arbeitstags mit der Reproduktion oder dem "Ersatz" der Werte von Baumwolle, Maschinerie usw. Dadurch, daß seine Arbeit aus Baumwolle und Spindel Garn macht, dadurch, daß er spinnt, geht der Wert von Baumwolle und Spindel von selbst auf das Garn über.	ch09_clean.en-ch09_clean.de
This is a result of the quality of his labour, not its quantity.	Es ist dies der Qualität seiner Arbeit geschuldet, nicht ihrer Quantität.	ch09_clean.en-ch09_clean.de
It is true that he will transfer to the yarn more value, in the shape of cotton, in one hour than he will in half an hour. But that is only because in one hour he spins up more cotton than in half an hour. You see then that your assertion that the workman produces, in the last hour but one, the value of his wages, and in the last hour your net profit, amounts to no more than this, that in the yarn produced by him in 2 working hours, whether they are the 2 first or the 2 last hours of the working day, there are incorporated 11 1/ working hours, i.e. precisely as many hours as there are in his working day.	Allerdings wird er in einer Stunde mehr Baumwollwert usw. auf Garn übertragen als in 1/2 Stunde, aber nur weil er in 1 Stunde mehr Baumwolle verspinnt als in 1/2. Ihr begreift also: Euer Ausdruck, der Arbeiter produziert in der vorletzten Stunde den Wert seines Arbeitslohns und in der letzten den Reingewinn, heißt weiter nichts, als daß in dem Garnprodukt von zwei Stunden seines Arbeitstags, ob sie vorn oder hinten stehen, 111/2 Arbeitsstunden verkörpert sind, grade so viel Stunden, als sein ganzer Arbeitstag zählt.	ch09_clean.en-ch09_clean.de
And my assertion that in the first 5 3/ hours he produces his wages, and in the last 5 3/ hours your net profit, amounts only to this, that you pay him for the former, but not for the latter.	Und der Ausdruck, daß er in den ersten 53/4 Stunden sei- nen Arbeitslohn und in den letzten 53/4 Stunden euren Reingewinn produziert, heißt wieder nichts, als daß ihr die ersten 53/4 Stunden zahlt und die letzten 53/4 Stunden nicht zahlt.	ch09_clean.en-ch09_clean.de
In speaking of payment of labour, instead of payment of labour-power, I am only using your own slang expression.	Ich spreche von Zahlung der Arbeit, statt der Arbeitskraft, um euren slang zu reden.	ch09_clean.en-ch09_clean.de
Now gentlemen, if you compare the working time you pay for with the working time you do not pay for, you will find that they are related to each other as half a day is to half a day; this gives a rate of 100 per cent, and a very pretty percentage it is.	Vergleicht ihr Herren nun das Verhältnis der Arbeitszeit, die ihr zahlt, zur Arbeitszeit, die ihr nicht zahlt, so werdet ihr finden, daß es halber Tag zu halbem Tag ist, also 100%, was allerdings ein artiger Prozentsatz.	ch09_clean.en-ch09_clean.de
Further, there is not the least doubt that if you make your “hands” toil for 13 hours instead of 11 1/2, and as may be expected from you, if you treat the work done in that extra one hour and a half as pure surplus labour, then the latter will be increased from 5 1/ hours’ labour to 7 1/ hours’ labour, and the rate of surplus-value will go up from 100 per cent to 126 2/ per cent.	Es unterliegt auch nicht dem geringsten Zweifel, daß, wenn ihr eure "Hände" statt 111/2 Stunden 13 abschanzt und, was euch so ähnlich sieht wie ein Ei dem andren, die überschüssigen 11/2 Stunden zur bloßen Mehrarbeit schlagt, letztre von 53/4 Stunden auf 71/4 Stunden wachsen wird, die Rate des Mehrwerts daher von 100% auf 1262/23%.	ch09_clean.en-ch09_clean.de
So that you are altogether too sanguine in expecting that by such an addition of 1 1/ hours to the working day the rate will rise from 100 per cent to 200 per cent and more, in other words that it will be “more than doubled”.	Dagegen seid ihr gar zu tolle Sanguiniker, wenn ihr hofft, sie werde durch den Zusatz von 11/2 Stunden von 100 auf 200% und gar mehr als 200% steigen, d.h. sich "mehr als verdoppeln".	ch09_clean.en-ch09_clean.de
On the other hand – the heart of man is a wonderful thing, especially when it is carried in his wallet – you take too pessimistic a view when you fear that a reduction of the hours of labour from 11 1/ to 10 will sweep away the whole of your net profit.	Andrerseits - des Menschen Herz ist ein wunderlich Ding, namentlich wenn der Mensch sein Herz im Beutel trägt - seid ihr gar zu verrückte Pessimisten, wenn ihr fürchtet, mit der Reduktion des Arbeitstags von 111/2 auf 101/2 Stunden werde euer ganzer Reingewinn in die Brüche gehn.	ch09_clean.en-ch09_clean.de
Not at all.	Beileibe nicht.	ch09_clean.en-ch09_clean.de
All other conditions remaining the same, the surplus labour will fall from 5 3/ hours to 4 3/ hours, a period that still gives a very profitable rate of surplus-value, namely 82 14/ per cent.	Alle andren Umstände als gleichbleibend vorausgesetzt, wird die Mehrarbeit von 53/4 auf 43/4 Stunden fallen, was immer noch eine ganz erkleckliche Rate des Mehrwerts gibt, nämlich 8214/23%.	ch09_clean.en-ch09_clean.de
But this fateful “last hour” about which you have invented more stories than the millenarians about the Day of Judgement, is “all bosh”.	Die verhängnisvolle "letzte Stunde" aber, von der ihr mehr gefabelt habt als die Chiliasten vom Weltuntergang, ist "all bosh" <"lauter Unsinn">.	ch09_clean.en-ch09_clean.de
If it goes, it will not cost you your “pure profit”, nor will it cost the boys and girls you employ their “pure minds”.11’ Whenever your “last hour” strikes in earnest, think of the Oxford professor.	Ihr Verlust wird weder euch den "Reingewinn" noch den von euch verarbeiteten Kindern beiderlei Geschlechts die "Seelenreinheit" kosten. (32a) Wenn einmal euer "letztes Stündlein" wirklich schlägt, denkt an den Professor von Oxford.	ch09_clean.en-ch09_clean.de
	Und nun: In einer beßren Welt wünsch' ich mir mehr von eurem werten Umgang.	ch09_clean.en-ch09_clean.de
And now, gentlemen, farewell, and may we meet again in a better world, but not before.’12… The battle-cry of the ‘last hour’, invented by Senior in 1836, was raised once again in the London Economist of 15 April 1848 by James Wilson, an economic mandarin of high standing, in a polemic against the Ten Hours’ Bill. * 4.	Addio! ... Das Signal der von Senior 1836 entdeckten "letzten Stunde" ward am 15. April 1848, polemisch gegen das Zehnstundengesetz, von James Wilson, einem der ökonomischen Hauptmandarine, im "London Economist" von neuem geblasen.	ch09_clean.en-ch09_clean.de
THE SURPLUS PRODUCT We call the portion of the product that represents surplus-value (i.e. one-tenth of the 20 lb., or 2 lb. of yarn, in the example given above) by the name of ‘surplus product’ (Mehrprodukt, produit net).	4. Das Mehrprodukt Den Teil des Produkts (1/10 von 20 Pfd. Garn oder 2 Pfd. Garn in dem Beispiel sub 2), worin sich der Mehrwert darstellt, nennen wir Mehrprodukt (surplus produce, produit net).	ch09_clean.en-ch09_clean.de
Just as the rate of surplus-value is determined by its relation, not to the sum total of the capital, but to its variable part, in the same way, the relative amount of the surplus product is determined by its ratio, not to the remaining part of the total product, but to that part of it in which necessary labour is incorporated.	Wie die Rate des Mehrwerts durch sein Verhältnis nicht zur Gesamtsumme, sondern zum variablen Bestandteil des Kapitals bestimmt wird, so die Höhe des Mehrprodukts durch sein Verhältnis nicht zum Rest des Gesamtprodukts, sondern zum Produktteil, worin sich die notwendige Arbeit darstellt.	ch09_clean.en-ch09_clean.de
Since the production of surplus-value is the determining purpose of capitalist production, the size of a given quantity of wealth must be measured, not by the absolute quantity produced, but by the relative magnitude of the surplus product.	Wie die Produktion von Mehrwert der bestimmende Zweck der kapitalistischen Produktion, so mißt nicht die absolute Größe des Produkts, sondern die relative Größe des Mehrprodukts den Höhegrad des Reichtums.	ch09_clean.en-ch09_clean.de
The sum of the necessary labour and the surplus labour, i.e. the sum of the periods of time during which the worker respectively replaces the value of his labour-power and produces the surplus-value, constitutes the absolute extent of his labour-time, i.e. the working day.	Die Summe der notwendigen Arbeit und der Mehrarbeit, der Zeitabschnitte, worin der Arbeiter den Ersatzwert seiner Arbeitskraft und den Mehrwert produziert, bildet die absolute Größe seiner Arbeitszeit - den Arbeitstag (working day).	ch09_clean.en-ch09_clean.de

