Chapter 11: The Rate and Mass of Surplus-Value In this chapter, as hitherto, the value of labour-power, and therefore the part of the working day necessary for – the reproduction or maintenance of that labour-power, is assumed to be a given, constant magnitude.	NEUNTES KAPITEL Rate und Masse des Mehrwerts Wie bisher wird in diesem Kapitel der Wert der Arbeitskraft, also der zur Reproduktion oder Erhaltung der Arbeitskraft notwendige Teil des Arbeitstags, als gegebne, konstante Größe unterstellt.	ch11_clean.en-ch11_clean.de
With this presupposition, the rate of surplus-value directly gives us the mass of surplus-value furnished to the capitalist by the worker within a definite period of time.	Dies also vorausgesetzt, ist mit der Rate zugleich die Masse des Mehrwerts gegeben, die der einzelne Arbeiter dem Kapitalisten in bestimmter Zeitperiode liefert.	ch11_clean.en-ch11_clean.de
If, for example, the necessary labour amounts to 6 hours a day, expressed in a quantity of gold equal to 3 shillings, then 3 shillings is the daily value of one labour-power, or the value of the capital advanced to buy one labour-power.	Beträgt z.B. die notwendige Arbeit täglich 6 Stunden, ausgedrückt in einem Goldquantum von 3 sh. = 1 Taler, so ist der Taler der Tageswert einer Arbeitskraft oder der im Ankauf einer Arbeitskraft vorgeschoßne Kapitalwert.	ch11_clean.en-ch11_clean.de
If, further, the rate of surplus-value is 100 per cent, this variable capital of 3 shillings produces a mass of surplus-value of 3 shillings, in other words, the worker supplies every day a mass of surplus labour of 6 hours.	Ist ferner die Rate des Mehrwerts 100%, so produziert dies variable Kapital von 1 Taler eine Masse Mehrwert von 1 Taler, oder der Arbeiter liefert täglich eine Masse Mehrarbeit von 6 Stunden.	ch11_clean.en-ch11_clean.de
But the variable capital is the monetary expression for the total value of all the labour-powers the capitalist employs simultaneously.	Das variable Kapital ist aber der Geldausdruck für den Gesamtwert aller Arbeitskräfte, die der Kapitalist gleichzeitig verwendet.	ch11_clean.en-ch11_clean.de
Its value is therefore equal to the average value of one labour-power multiplied by the number of labour-powers employed.	Sein Wert ist also gleich dem Durchschnittswert einer Arbeitskraft, multipliziert mit der Anzahl der verwandten Arbeitskräfte.	ch11_clean.en-ch11_clean.de
With a given value of labour-power, therefore, the magnitude of the variable capital varies directly with the number of workers employed simultaneously.	Bei gegebnem Wert der Arbeitskraft steht also die Größe des variablen Kapitals in direktem Verhältnis zur Anzahl der gleichzeitig beschäftigten Arbeiter.	ch11_clean.en-ch11_clean.de
If the daily value of one labour-power is 3 shillings, then a capital of 300 shillings must be advanced in order to exploit 100 labour-powers every day, and a capital of n× shillings must be advanced in order to exploit n labour-powers every day.	Ist der Tageswert einer Arbeitskraft = 1 Taler, so ist also ein Kapital vorzuschießen von 100 Talern, um 100, von n Talern, um n Arbeitskräfte täglich zu exploitieren.	ch11_clean.en-ch11_clean.de
In the same way, if a variable capital of 3 shillings, being the daily value of one labour-power, produces a daily surplus-value of 3 shillings, a variable capital of 300 shillings will produce a daily surplus-value of 300 shillings, and one of n × 3 shillings will produce a daily surplus-value of n × 3 shillings. The mass of surplus-value produced is therefore equal to the surplus-value provided by the working day of one worker multiplied by the number of workers employed.	Ebenso: Produziert ein variables Kapital von 1 Taler, der Tageswert einer Arbeitskraft, einen täglichen Mehrwert von 1 Taler, so ein variables Kapital von 100 Talern einen täglichen Mehrwert von 100, und eins von n Talern einen täglichen Mehrwert von 1 Taler x n. Die Masse des produzierten Mehrwerts ist also gleich dem Mehrwert, den der Arbeitstag des einzelnen Arbeiters liefert, multipliziert mit der Anzahl der angewandten Arbeiter.	ch11_clean.en-ch11_clean.de
But as the mass of surplus-value which a single worker produces (the value of labour-power being given) is determined by the rate of surplus-value, this first law follows: the mass of surplus-value produced is equal to the amount of the variable capital advanced multiplied by the rate of surplus-value; in other words: the mass of surplus-value is determined by the product of the number of labour-powers simultaneously exploited by the same capitalist and the degree of exploitation of each individual labour-power. Let the mass of the surplus value be S, the surplus-value supplied by the individual worker in the average day s, the variable capital advanced daily in the purchase of one individual labour-power v, the sum total of the variable capital V, the value of an average labour-power P, its degree of exploitation a′/a (surplus labour/necessary labour) and the number of workers employed, n; we have, then: We assume throughout, not only that the value of an average labour-power is constant, but that the workers employed by a capitalist are reduced to average workers.	Da aber ferner die Masse Mehrwert, die der einzelne Arbeiter produziert, bei gegebnem Wert der Arbeitskraft, durch die Rat des Mehrwerts bestimmt ist, so folgt dies erste Gesetz: Die Masse des produzierten Mehr- werts ist gleich der Größe des vorgeschoßnen variablen Kapitals multipliziert mit der Rate des Mehrwerts oder ist bestimmt durch das zusammengesetzte Verhältnis zwischen der Anzahl der von demselben Kapitalisten gleichzeitig exploitierten Arbeitskräfte und dem Exploitationsgrad der einzelnen Arbeitskraft. <In der autorisierten französischen Ausgabe wurde der zweite Teil dieses Satzes wie folgt wiedergegeben: "oder aber sie ist gleich dem Wert einer Arbeitskraft multipliziert mit dem Grad ihrer Exploitation und multipliziert mit der Anzahl der gleichzeitig exploitierten Arbeitskräfte. "> Nennen wir also die Masse des Mehrwerts M, den vom einzelnen Arbeiter im Tagesdurchschnitt gelieferten Mehrwert m, das im Ankauf der einzelnen Arbeitskraft täglich vorgeschoßne variable Kapital v, die Gesamtsumme des variablen Kapitals V, den Wert einer Durchschnitts-Arbeitskraft k, ihren Exploitationsgrad a'/a (Mehrarbeit)/(Notwendige Arbeit) und die Anzahl der angewandten Arbeiter n, so erhalten wir: M= { m/v * V k * a'/a * n. Es wird fortwährend unterstellt, nicht nur daß der Wert einer Durchschnitts-Arbeitskraft konstant ist, sondern daß die von einem Kapitalisten angewandten Arbeiter auf Durchschnitts-Arbeiter reduziert sind.	ch11_clean.en-ch11_clean.de
There do exist exceptional cases in which the surplus-value produced does not increase in proportion to the number of workers being exploited, but then the value of the labour-power does not remain constant.	Es gibt Ausnahmefälle, wo der produzierte Mehrwert nicht verhältnismäßig zur Anzahl der exploitierten Arbeiter wächst, aber dann bleibt auch der Wert der Arbeitskraft nicht konstant.	ch11_clean.en-ch11_clean.de
In the production of a definite mass of surplus-value, therefore, a decrease in one factor may be compensated for by an increase in the other.	In der Produktion einer bestimmten Masse Mehrwert kann daher die Abnahme des einen Faktors durch Zunahme des andren ersetzt werden.	ch11_clean.en-ch11_clean.de
If the variable capital diminishes, and at the same time the rate of surplus-value increases in the same ratio, the mass of surplus-value remains unaltered.	Wird das variable Kapital vermindert und gleichzeitig in demselben Verhältnis die Rate des Mehrwerts erhöht, so bleibt die Masse des produzierten Mehrwerts unverändert.	ch11_clean.en-ch11_clean.de
If, on our earlier assumption, the capitalist has to advance 300 shillings in order to exploit 100 workers each day, and if the rate of surplus-value amounts to 50 per cent, this variable capital of 300 shillings yields a surplus-value of 150 shillings, or 100× working hours.	Muß unter den frühern Annahmen der Kapitalist 100 Taler vorschießen, um 100 Arbeiter täglich zu exploitieren, und beträgt die Rate des Mehrwerts 50%, so wirft dies variable Kapital von 100 einen Mehrwert von 50 Talern ab oder von 100 x 3 Arbeitsstunden.	ch11_clean.en-ch11_clean.de
If the rate of surplus-value doubles, or the working day, instead of being extended from 6 to 9, is extended from 6 to 12 hours, and at the same time variable capital is reduced by half, i.e. to 150 shillings, it too yields a surplus-value of 150 shillings, or 50× working hours.	Wird die Rate des Mehrwerts verdoppelt, oder der Arbeitstag, statt von 6 zu 9, von 6 zu 12 Stunden verlängert, so wirft das um die Hälfte verminderte variable Kapital von 50 Talern ebenfalls einen Mehrwert von 50 Talern ab oder von 50 x 6 Arbeitsstunden.	ch11_clean.en-ch11_clean.de
A decrease in the variable capital may therefore be compensated for by a proportionate rise in the degree of exploitation of labour-power, or a decrease in the number of workers employed by a proportionate extension of the working day.	Verminderung des variablen Kapitals ist also ausgleichbar durch proportionelle Erhöhung im Exploitationsgrad der Arbeitskraft oder die Abnahme in der Anzahl der beschäftigten Arbeiter durch proportionelle Verlängerung des Arbeitstags.	ch11_clean.en-ch11_clean.de
Within certain limits, therefore, the supply of labour exploitable by capital is independent of the supply of workers.	Innerhalb gewisser Grenzen wird die vom Kapital erpreßbare Zufuhr der Arbeit also unabhängig von der Arbeiterzufuhr.	ch11_clean.en-ch11_clean.de
And, inversely, a fall in the rate of surplus-value leaves the mass of surplus-value which has been produced unaltered, if the amount of the variable capital, i.e. the number of workers employed, increases in the same proportion.	Umgekehrt läßt Abnahme in der Rate des Mehrwerts die Masse des produzierten Mehrwerts unverändert, wenn propotionell die Größe des variablen Kapitals oder die Anzahl der beschäftigten Arbeiter wächst.	ch11_clean.en-ch11_clean.de
Nevertheless there are limits, which cannot be overcome, to the compensation for a decrease in the number of workers employed, i.e. a decrease in the amount of variable capital advanced, provided by a rise in the rate of surplus-value, i.e. the lengthening of the working day.	Indes hat der Ersatz von Arbeiteranzahl oder Größe des variablen Kapitals durch gesteigerte Rate des Mehrwerts oder Verlängerung des Arbeitstags unüberspringbare Schranken.	ch11_clean.en-ch11_clean.de
Whatever the value of labour-power may be, whether the labour-time necessary for the maintenance of the worker is 2 hours or 10, the total value a worker can produce, day in, day out, is always less than the value in which 24 hours of labour are objectified. For instance, it is less than 12 shillings, if 12 shillings is the monetary expression for 24 hours of objectified labour.	Welches immer der Wert der Arbeitskraft sei, ob daher die zur Erhaltung des Arbeiters notwendige Arbeitszeit 2 oder 10 Stunden betrage, der Gesamtwert, den ein Arbeiter tagaus, tagein produzieren kann, ist immer kleiner als der Wert, worin sich 24 Arbeitsstunden vergegenständlichen, kleiner als 12 sh. oder 4 Taler, wenn dies der Geldausdruck von 24 vergegenständlichten Arbeitsstunden.	ch11_clean.en-ch11_clean.de
On our former assumption, according to which 6 hours of labour every day are necessary in order to reproduce the labour-power itself or to replace the value of the capital advanced to purchase it, a variable capital of 1, shillings, employing 500 workers at a rate of surplus-value of 100 per cent with a 12-hour working day, produces every day a surplus-value of 1, shillings, or 6 × 500 working hours.	Unter unsrer frühern Annahme, wonach täglich 6 Arbeitsstunden erheischt, um die Arbeitskraft selbst zu reproduzieren oder den in ihrem Ankauf vorgeschoßnen Kapitalwert zu ersetzen, produziert ein variables Kapital von 500 Talern, das 500 Arbeiter zu Mehrwertsrate von 100% oder mit zwölfstündigem Arbeitstag verwendet, täglich einen Mehrwert von 500 Talern oder 6 x 500 Arbeitsstunden.	ch11_clean.en-ch11_clean.de
A capital of 300 shillings, employing 100 workers a day with a rate of surplus value of 200 per cent, or with a working day of 18 hours, only produces a mass of surplus-value of 600 shillings, or 12 × 100 working hours; and its total value-product, the equivalent of the variable capital advanced plus the surplus-value, can, day in, day out, never reach the sum of 1, shillings or 24 × 100 working hours.	Ein Kapital von 100 Talern, das 100 Arbeiter täglich verwendet zur Mehrwertsrate von 200% oder mit 18stündigem Arbeitstag, produziert nur eine Mehrwertsmasse von 200 Talern oder 12 x 100 Arbeitsstunden. Und sein gesamtes Wertprodukt, Äquivalent des vorgeschoßnen variablen Kapitals plus Mehrwert, kann tagaus, tagein niemals die Summe von 400 Talern oder 24 x 100 Arbeitsstunden erreichen.	ch11_clean.en-ch11_clean.de
The absolute limit of the average working day – this being by nature always less than 24 hours – sets an absolute limit to the compensation for a reduction of variable capital by a higher rate of surplus-value, or for the decrease of the number of workers exploited by a higher degree of exploitation of labour-power.	Die absolute Schranke des durchschnittlichen Arbeitstags, der von Natur immer kleiner ist als 24 Stunden, bildet eine absolute Schranke für den Ersatz von vermindertem variablen Kapital durch gesteigerte Rate des Mehrwerts oder von verringerter exploitierten Arbeiteranzahl durch erhöhten Exploitationsgrad der Arbeitskraft.	ch11_clean.en-ch11_clean.de
This self-evident second law is of importance for the explanation of many phenomena, arising from the tendency of capital to reduce as much as possible the number of workers employed, i.e. the amount of its variable component, the part which is changed into labour-power (we shall develop this tendency later on),* which stands in contradiction with its other tendency to produce the greatest possible mass of surplus-value.	Dies handgreifliche zweite Gesetz ist wichtig zur Erklärung vieler Erscheinungen, entspringend aus der später zu entwickelnden Tendenz des Kapitals, die von ihm beschäftigte Arbeiteranzahl oder seinen variablen in Arbeitskraft umgesetzten Bestandteil soviel als immer möglich zu reduzieren, im Widerspruch zu seiner andren Tendenz, die möglichst große Masse von Mehrwert zu produzieren.	ch11_clean.en-ch11_clean.de
On the other hand, if the mass of labour-power employed or the amount of variable capital increases, but not in proportion to the fall in the rate of surplus-value, a diminution occurs in the mass of surplus-value produced.	Umgekehrt. Wächst die Masse der verwandten Arbeitskräfte oder die Größe des variablen Kapitals, aber nicht verhältnismäßig zur Abnahme in der Rate des Mehrwerts, so sinkt die Masse des produzierten Mehrwerts.	ch11_clean.en-ch11_clean.de
A third law results from the determination by the following two factors of the mass of surplus-value produced: rate of surplus-value and the amount of variable capital advanced.	Ein drittes Gesetz ergibt sich aus der Bestimmung der Masse des produzierten Mehrwerts durch die zwei Faktoren, Rate des Mehrwerts und Größe des vorgeschoßnen variablen Kapitals.	ch11_clean.en-ch11_clean.de
The rate of surplus-value, i.e. the degree of exploitation of labour-power, and the value of labour-power, i.e. the amount of the necessary labour-time, being given, it is self-evident that the greater the variable capital, the greater would be the mass of the value produced and of the surplus-value.	Die Rate des Mehrwerts oder den Exploitationsgrad der Arbeitskraft, und den Wert der Arbeitskraft oder die Größe der notwendigen Arbeitszeit gegeben, ist es selbstverständlich, daß, je größer das variable Kapital, desto größer die Masse des produzierten Werts und Mehrwerts.	ch11_clean.en-ch11_clean.de
If the limit of the working day is given, and also the limit of its necessary part, the mass of value and surplus-value produced by the individual capitalist is clearly exclusively dependent on the mass of labour that he sets in motion.	Ist die Grenze des Arbeitstags gegeben, ebenso die Grenze seines notwendigen Bestandteils, so hängt die Masse von Wert und Mehrwert, die ein einzelner Kapitalist produziert, offenbar ausschließlich ab von der Masse Arbeit, die er in Bewegung setzt.	ch11_clean.en-ch11_clean.de
But this, on the assumptions we have made above, depends on the mass of labour-power, or the number of workers he exploits, and this number in its turn is determined by the amount of the variable capital advanced.	Diese aber hängt, unter den gegebnen Annahmen, ab von der Masse Arbeitskraft oder der Arbeiteranzahl, die er exploitiert, und diese Anzahl ihrerseits ist bestimmt durch die Größe des von ihm vorgeschoßnen variablen Kapitals.	ch11_clean.en-ch11_clean.de
With a given rate of surplus-value, and a given value of labour-power, therefore, the masses of surplus-value produced vary directly as the amounts of the variable capitals advanced.	Bei gegebner Rate des Mehrwerts und gegebnem Wert der Arbeitskraft verhalten sich also die Massen des produzierten Mehrwerts direkt wie die Größen der vorgeschoßnen variablen Kapitale.	ch11_clean.en-ch11_clean.de
Now we know that the capitalist divides his capital into two parts.	Nun weiß man aber, daß der Kapitalist sein Kapital in zwei Teile teilt.	ch11_clean.en-ch11_clean.de
He lays out one part on means of production.	Einen Teil legt er aus in Produktionsmitteln.	ch11_clean.en-ch11_clean.de
This is the constant part of his capital.	Dies ist der konstante Teil seines Kapitals.	ch11_clean.en-ch11_clean.de
He lays out the other part on living labour-power.	Den andren Teil setzt er um in lebendige Arbeitskraft.	ch11_clean.en-ch11_clean.de
This part forms his variable capital.	Dieser Teil bildet sein variables Kapital.	ch11_clean.en-ch11_clean.de
On the basis of the same mode of production, the division of capital into constant and variable differs in different branches of production, and within the same branch of production, too, this relation changes with changes in the technical foundations and in the ways of linking together the processes of production in society.	Auf Basis derselben Produktionsweise findet in verschiednen Produktionszweigen verschiedne Teilung des Kapitals in konstanten und variablen Bestandteil statt.	ch11_clean.en-ch11_clean.de
But whatever the proportion between the constant and the variable part of a given capital, whether it is 1:2, or 1: or 1:x, the law just laid down is not affected by this.	Innerhalb desselben Produktionszweige wechselt dies Verhältnis mit wechselnder technischer Grundlage und gesellschaftlicher Kombination des Produktionsprozesses.	ch11_clean.en-ch11_clean.de
For, according to our previous analysis, the value of the constant capital re-appears in the value of the product, but does not enter into the newly produced value, the newly created value-product.	Wie aber ein gegebnes Kapital immer zerfalle in konstanten und variablen Bestandteil, ob der letztre sich zum erstren verhalte wie 1 : 2, 1 : 10 oder 1 : x, das eben aufgestellte Gesetz wird nicht davon berührt, da früherer Analyse gemäß der Wert des konstanten Kapitals im Produktenwert zwar wiedererscheint, aber nicht in das neugebildete Wertprodukt eingeht.	ch11_clean.en-ch11_clean.de
To employ 1, spinners, more raw material, spindles, etc. are of course required than to employ 100.	Um 1.000 Spinner zu verwenden, sind natürlich mehr Rohmaterialen, Spindeln usw. erheischt, als um 100 zu verwenden.	ch11_clean.en-ch11_clean.de
The value of these additional means of production, however, may rise, fall, remain unaltered, be large or small; it has no influence on the valorization process performed by the labour-powers which set the means of production in motion.	Der Wert dieser zuzusetzenden Produktionsmittel aber mag steigen, fallen, unverändert bleiben, groß oder klein sein, er bleibt ohne irgendeinen Einfluß auf den Verwertungsprozeß der sie bewegenden Arbeitskräfte.	ch11_clean.en-ch11_clean.de
The law demonstrated above therefore takes this form: the masses of value and of surplus-value produced by different capitals – the value of labour-power being given and its degree of exploitation being equal – vary directly as the amounts of the variable components of these capitals, i.e. the parts which have been turned into living labour-power.	Das oben konstatierte Gesetz nimmt also die Form an: Die von verschiednen Kapitalen produzierten Massen von Wert und Mehrwert verhalten sich bei gegebnem Wert und gleich großem Exploitationsgrad der Arbeitskraft direkt wie die Größen der variablen Bestandteile dieser Kapitale, d.h. ihrer in lebendige Arbeitskraft umgesetzten Bestandteile.	ch11_clean.en-ch11_clean.de
This law clearly contradicts all experience based on immediate appearances.	Dies Gesetz widerspricht offenbar aller auf den Augenschein gegründeten Erfahrung.	ch11_clean.en-ch11_clean.de
Everyone knows that a cotton spinner, who, if we consider the percentage over the whole of his applied capital, employs much constant capital and little variable capital, does not, on account of this, pocket less profit or surplus-value than a baker, who sets in motion relatively much variable capital and little constant capital.	Jedermann weiß, daß ein Baumwollspinner, der, die Prozentteile des angewandten Gesamtkapitals berechnet, relativ viel konstantes und wenig variables Kapital anwendet, deswegen keinen kleinren Gewinn oder Mehrwert erbeutet als ein Bäcker, der relativ viel variables und wenig konstantes Kapital in Bewegung setzt.	ch11_clean.en-ch11_clean.de
For the solution of this apparent contradiction, many intermediate terms are still needed, just as, from the standpoint of elementary algebra, many intermediate terms are needed before we can understand that 0/ may represent an actual magnitude.	Zur Lösung dieses scheinbaren Widerspruchs bedarf es noch vieler Mittelglieder, wie es vom Standpunkt der elementaren Algebra vieler Mittelglieder bedarf, um zu verstehn, daß 0/0 eine wirkliche Größe darstellen kann.	ch11_clean.en-ch11_clean.de
Classical economics holds instinctively to this law, although it has never actually formulated it, because it is a necessary consequence of the law of value.	Obgleich sie das Gesetz nie formuliert hat, hängt die klassische Ökonomie instinktiv daran fest, weil es eine notwendige Konsequenz des Wertgesetzes überhaupt ist.	ch11_clean.en-ch11_clean.de
It tries to rescue the law from the contradictions of immediate experience by making a violent abstraction.	Sie sucht es durch gewaltsame Abstraktion vor den Widersprüchen der Erscheinung zu retten.	ch11_clean.en-ch11_clean.de
We shall see later how the school of Ricardo came to grief on this stumbling-block.	Man wird später sehn, wie die Ricardosche Schule an diesem Stein des Anstoßes gestolpert ist.	ch11_clean.en-ch11_clean.de
Vulgar economics, which like the Bourbons ‘has really learnt nothing’, relies here as elsewhere on the mere semblance as opposed to the law which regulates and determines the phenomena.	Die Vulgärökonomie, die "wirklich auch nichts gelernt hat", pocht hier, wie überall, auf den Schein gegen das Gesetz der Erscheinung.	ch11_clean.en-ch11_clean.de
In antithesis to Spinoza, it believes that ‘ignorance is a sufficient reason’. * The labour which is set in motion by the total capital of a society, day in, day out, may be regarded as a single working day.	Sie glaubt im Gegensatz zu Spinoza, daß "die Unwissenheit ein hinreichender Grund ist". Die Arbeit, die vom Gesamtkapital einer Gesellschaft tagaus, tagein in Bewegung gesetzt wird, kann als ein einziger Arbeitstag betrachtet werden.	ch11_clean.en-ch11_clean.de
If, for example, the number of workers is a million, and the average working day is 10 hours, the social working day will consist of 10 million hours.	Ist z.B. die Zahl der Arbeiter eine Million und beträgt der Durchschnittsarbeitstag eines Arbeiters 10 Stunden, so besteht der gesellschaftliche Arbeitstag aus 10 Millionen Stunden.	ch11_clean.en-ch11_clean.de
With a given length of this working day, whether its limits are fixed physically or socially, the mass of surplus-value can be increased only by increasing the number of workers, i.e. the size of the working population.	Bei gegebner Länge dieses Arbeitstags, seien seine Grenzen physisch oder sozial gezogen, kann die Masse des Mehrwerts nur vermehrt werden durch Vermehrung der Arbeiteranzahl, d.h. der Arbeiterbevölkerung.	ch11_clean.en-ch11_clean.de
The growth of population here forms the mathematical limit to the production of surplus-value by the total social capital.	Das Wachstum der Bevölkrung bildet hier die mathematische Grenze für Produktion des Mehrwerts durch das gesellschaftliche Gesamtkapital. Umgekehrt.	ch11_clean.en-ch11_clean.de
And, inversely, with a given population this limit is formed by the possible lengthening of the working day.	Bei gegebner Größe der Bevölkrung wird diese Grenze gebildet durch die mögliche Verlängerung des Arbeitstags.	ch11_clean.en-ch11_clean.de
It will however be seen in the next chapter that this law holds only for the form of surplus-value dealt with up to the present.	Man wird im folgenden Kapitel sehn, daß dies Gesetz nur für die bisher behandelte Form des Mehrwerts gilt.	ch11_clean.en-ch11_clean.de
From the foregoing treatment of the production of surplus-value it follows that not every sum of money, or value, can be transformed into capital at will. In fact, it is a presupposition of this transformation that a certain minimum of money or of exchange-value is in the hands of the individual possessor of money or commodities.	Aus der bisherigen Betrachtung der Produktion des Mehrwerts ergibt sich, daß nicht jede beliebige Geld- oder Wertsumme in Kapital verwandelbar, zu dieser Verwandlung vielmehr ein bestimmtes Minimum von Geld oder Tauschwert in der Hand des einzelnen Geld- oder Warenbesitzers vorausgesetzt ist.	ch11_clean.en-ch11_clean.de
The minimum of variable capital is the cost price of a single labour-power employed the whole year through, day in, day out, for the production of surplus-value.	Das Minimum von variablem Kapital ist der Kostenpreis einer einzelnen Arbeitskraft, die das ganze Jahr durch, tagaus, tagein, zur Gewinnung von Mehrwert vernutzt wird.	ch11_clean.en-ch11_clean.de
If this worker were in possession of his own means of production, and were satisfied to live as a worker, he could make do with the amount of labour-time necessary to reproduce his means of subsistence, say 8 hours a day.	Wäre dieser Arbeiter im Besitz seiner eignen Produktionsmittel und begnügte er sich, als Arbeiter zu leben, so genügte ihm die zur Reproduktion seiner Lebensmittel notwendige Arbeitszeit, sage von 8 Stunden täglich.	ch11_clean.en-ch11_clean.de
In addition to this, he would only need means of production sufficient for 8 working hours.	Er brauchte also auch nur Produktionsmittel für 8 Arbeitsstunden.	ch11_clean.en-ch11_clean.de
The capitalist, on the other hand, who makes him do, besides these 8 hours, say 4 hours of surplus labour, requires an additional sum of money for furnishing the additional means of production.	Der Kapitalist dagegen, der ihn außer diesen 8 Stunden sage 4 Stunden Mehrarbeit verrichten läßt, bedarf einer zusätzlichen Geldsumme zur Beschaffung der zusätzlichen Produktionsmittel.	ch11_clean.en-ch11_clean.de
On our assumption, however, he would have to employ not one but two workers in order to live, on the surplus-value appropriated daily, as well as and no better than a worker, i.e. in order to be able to satisfy his needs.	Unter unsrer Annahme jedoch müßte er schon zwei Arbeiter anwenden, um von dem täglich angeeigneten Mehrwert wie ein Arbeiter leben, d.h. seine notwendigen Bedürfnisse befriedigen zu können.	ch11_clean.en-ch11_clean.de
In this case the mere maintenance of life would be the purpose of his production, not the increase of wealth. But capitalist production presupposes the increase of wealth.	In diesem Fall wäre bloßer Lebensunterhalt der Zweck seiner Produktion, nicht Vermehrung des Reichtums, und das letztre ist unterstellt bei der kapitalistischen Produktion.	ch11_clean.en-ch11_clean.de
To live only twice as well as an ordinary worker and, as well as that, turn half of the surplus-value produced into capital, he would have to multiply the number of workers and the minimum of the capital advanced by eight.	Damit er nur doppelt so gut lebe wie ein gewöhnlicher Arbeiter und die Hälfte des produzierten Mehrwerts in Kapital zurückverwandle, müßte er zugleich mit der Arbeiterzahl das Minimum des vorgeschoßnen Kapitals um das Achtfache steigern.	ch11_clean.en-ch11_clean.de
Of course he can, like the man who is working for him, participate directly in the process of production, but then he is only a hybrid, a man between capitalist and worker, a ‘small master’.	Allerdings kann er selbst, gleich seinem Arbeiter, unmittelbar Hand im Produktionsprozesse anlegen, aber ist dann auch nur ein Mittelding zwischen Kapitalist und Arbeiter, ein "kleiner Meister".	ch11_clean.en-ch11_clean.de
A certain stage of capitalist production necessitates that the capitalist be able to devote the whole of the time during which he functions as a capitalist, i.e. as capital personified, to the appropriation and therefore the control of the labour of others [fremde Arbeit], and to the sale of the products of that labour.	Ein gewisser Höhegrad der kapitalistischen Produktion bedingt, daß der Kapitalist die ganze Zeit, während deren er als Kapitalist, d.h. als personifiziertes Kapital funktioniert, zur Aneignung und daher Kontrolle fremder Arbeit und zum Verkauf der Produkte dieser Arbeit verwenden könne.	ch11_clean.en-ch11_clean.de
The guild system of the Middle Ages therefore tried forcibly to prevent the transformation of the master of a craft into a capitalist, by limiting the number of workers a single master could employ to a very low maximum.	Die Verwandlung des Handwerksmeisters in den Kapitalisten suchte das Zunftwesen des Mittelalters dadurch gewaltsam zu verhindern, daß es die Arbeiteranzahl, die ein einzelner Meister beschäftigen durfte, auf ein sehr geringes Maximum beschränkte.	ch11_clean.en-ch11_clean.de
Hence the possessor of money or commodities actually turns into a capitalist only where the minimum sum advanced for production greatly exceeds the known medieval maximum.	Der Geld- oder Warenbesitzer verwandelt sich erst wirklich in einen Kapitalisten, wo die für die Produktion vorgeschoßne Minimalsumme weit über dem mittelaltrigen Maximum steht.	ch11_clean.en-ch11_clean.de
Here, as in natural science, is shown the correctness of the law discovered by Hegel, in his Logic, that at a certain point merely quantitative differences pass over by a dialectical inversion into qualitative distinctions.	Hier, wie in der Naturwissenschaft, bewährt sich die Richtigkeit des von Hegel in seiner "Logik" entdeckten Gesetzes, daß bloß quantitative Verändrungen auf einem gewissen Punkt in qualitative Unterschiede umschlagen.	ch11_clean.en-ch11_clean.de
The minimum sum of value the individual possessor of money or commodities must command in order to metamorphose himself into a capitalist changes with the different stages of development of capitalist production, and is at given stages different in different spheres of production, according to their special technical conditions.	(205a) Das Minimum der Wertsumme, worüber der einzelne Geld- oder Warenbesitzer verfügen muß, um sich in einen Kapitalisten zu entpuppen, wechselt auf verschiednen Entwicklungsstufen der kapitalistischen Produktion und ist, bei gegebner Entwicklungsstufe, verschieden in verschiednen Produktionssphären, je nach ihren besondren technischen Bedingungen.	ch11_clean.en-ch11_clean.de
Certain spheres, even at the beginnings of capitalist production, require a minimum of capital which is not yet to be found in the hands of single individuals.	Gewisse Produktionssphären erheischen schon in den Anfängen der kapi- talistischen Produktion ein Minimum von Kapital, das sich noch nicht in der Hand einzelner Individuen vorfindet.	ch11_clean.en-ch11_clean.de
This situation gives rise partly to state subsidies to private persons, as in France in the time of Colbert and in some German states right into our own epoch, and partly to the formation of companies with a legally secured monopoly over the conduct of certain branches of industry and commerce – the forerunners of the modern joint-stock companies. We shall not examine in detail the changes which take place in the relation between the capitalist and the wage-labourer in the course of the process of production, nor shall we deal any further with the characteristics of capital itself.	Dies veranlaßt teils Staatssubsidien an solche Private, wie in Frankreich zur Zeit Colberts und wie in manchen deutschen Staaten bis in unsre Epoche hinein, teils die Bildung von Gesellschaften mit gesetzlichem Monopol für den Betrieb gewisser Industrie- und Handelszweige - die Vorläufer der modernen Aktiengesellschaften. __________ Wir halten uns nicht beim Detail der Verändrungen auf, die das Verhältnis von Kapitalist und Lohnarbeiter im Verlaufe des Produktionsprozesses erfuhr, also auch nicht bei den weitren Fortbestimmungen des Kapitals selbst.	ch11_clean.en-ch11_clean.de
Here we shall only emphasize certain main points.	Nur wenige Hauptpunkte seien hier betont.	ch11_clean.en-ch11_clean.de
Capital developed within the production process until it acquired command over labour, i.e. over self-activating labour-power, in other words the worker himself.	Innerhalb des Produktionsprozesses entwickelte sich das Kapital zum Kommando über die Arbeit, d.h. über die sich betätigende Arbeitskraft oder den Arbeiter selbst.	ch11_clean.en-ch11_clean.de
The capitalist, who is capital personified, now takes care that the worker does his work regularly and with the proper degree of intensity.	Das personifizierte Kapital, der Kapitalist, paßt auf, daß der Arbeiter sein Werk ordentlich und mit dem gehörigen Grad von Intensität verrichte.	ch11_clean.en-ch11_clean.de
Capital also developed into a coercive relation, and this compels the working class to do more work than would be required by the narrow circle of its own needs.	Das Kapital entwickelte sich ferner zu einem Zwangsverhältnis, welches die Arbeiterklasse nötigt, mehr Arbeit zu verrichten, als der enge Umkreis ihrer eignen Lebensbedürfnisse vorschrieb.	ch11_clean.en-ch11_clean.de
As an agent in producing the activity of others, as an extractor of surplus labour and an exploiter of labour-power, it surpasses all earlier systems of production, which were based on directly compulsory labour, in its energy and its quality of unbounded and ruthless activity.	Und als Produzent fremder Arbeitsamkeit, als Auspumper von Mehrarbeit und Exploiteur von Arbeitskraft übergipfelt es an Energie, Maßlosigkeit und Wirksamkeit alle frühern auf direkter Zwangsarbeit beruhenden Produktionssysteme.	ch11_clean.en-ch11_clean.de
At first capital subordinates labour on the basis of the technical conditions within which labour has been carried on up to that point in history.	Das Kapital ordnet sich zunächst die Arbeit unter mit den technischen Bedingungen, worin es sie historisch vorfindet.	ch11_clean.en-ch11_clean.de
It does not therefore directly change the mode of production.	Es verändert daher nicht unmittelbar die Produktionsweise.	ch11_clean.en-ch11_clean.de
The production of surplus-value in the form we have so far considered, by means of simple extension of the working day, appeared therefore independently of any change in the mode of production itself.	Die Produktion von Mehrwert in der bisher betrachteten Form, durch einfache Verlängrung des Arbeitstags, erschien daher von jedem Wechsel der Produktionsweise selbst unabhängig.	ch11_clean.en-ch11_clean.de
It was no less effective in the old-fashioned bakeries than in the modern cotton factories.	Sie war in der altmodischen Bäckerei nicht minder wirksam als in der modernen Baumwollspinnerei.	ch11_clean.en-ch11_clean.de
If we consider the process of production from the point of view of the simple labour-process, the worker is related to the means of production, not in their quality as capital, but as being the mere means and material of his own purposeful productive activity.	Betrachten wir den Produktionsprozeß unter dem Gesichtspunkt des Arbeitsprozesses, so verhielt sich der Arbeiter zu den Produktionsmitteln nicht als Kapital, sondern als bloßem Mittel und Material seiner zweckmäßigen produktiven Tätigkeit.	ch11_clean.en-ch11_clean.de
In tanning, for example, he deals with the skins as his simple object of labour.	In einer Gerberei z.B. behandelt er die Felle als seinen bloßen Arbeitsgegenstand.	ch11_clean.en-ch11_clean.de
It is not the capitalist whose skin he tans.	Es ist nicht der Kapitalist, dem er das Fell gerbt.	ch11_clean.en-ch11_clean.de
But it is different as soon as we view the production process as a process of valorization.	Anders, sobald wir den Produktionsprozeß unter dem Gesichtspunkt des Verwertungsprozesses betrachteten.	ch11_clean.en-ch11_clean.de
The means of production are at once changed into means for the absorption of the labour of others.	Die Produktionsmittel verwandelten sich sofort in Mittel zur Einsaugung fremder Arbeit.	ch11_clean.en-ch11_clean.de
It is no longer the worker who employs the means of production, but the means of production which employ the worker.	Es ist nicht mehr der Arbeiter, der die Produktionsmittel anwendet, sondern es sind die Produktionsmittel, die den Arbeiter anwenden.	ch11_clean.en-ch11_clean.de
Instead of being consumed by him as material elements of his productive activity, they consume him as the ferment necessary to their own life-process, and the life-process of capital consists solely in its own motion as self-valorizing value.	Statt von ihm als stoffliche Elemente seiner produktiven Tätigkeit verzehrt zu werden, verzehren sie ihn als Ferment ihres eignen Lebensprozesses, und der Lebensprozeß des Kapitals besteht nur in seiner Bewegung als sich selbst verwertender Wert.	ch11_clean.en-ch11_clean.de
Furnaces and workshops that stand idle by night, and absorb no living labour, are ‘a mere loss’ to the capitalist.	Schmelzöfen und Arbeitsgebäude, die des Nachts ruhn und keine lebendige Arbeit einsaugen, sind "reiner Verlust" ("mere loss") für den Kapitalisten.	ch11_clean.en-ch11_clean.de
Hence furnaces and workshops constitute ‘lawful claims upon the night-labour’ of the labour-powers.	Darum konstituieren Schmelzöfen und Arbeitsgebäude einen "Anspruch auf die Nachtarbeit" der Arbeitskräfte.	ch11_clean.en-ch11_clean.de
As soon as a certain sum of money is transformed into means of production, i.e. into the objective factors of the production process, the means of production themselves are transformed into a title, both by right and by might, to the labour and surplus labour of others.	Die bloße Verwandlung des Geldes in gegenständliche Faktoren des Produktionsprozesses, in Produktionsmittel, verwandelt letztre in Rechtstitel und Zwangstitel auf fremde Arbeit und Mehrarbeit.	ch11_clean.en-ch11_clean.de
An example will show, in conclusion, how this inversion, indeed this distortion, which is peculiar to and characteristic of capitalist production, of the relation between dead labour and living labour, between value and the force that creates value, is mirrored in the consciousness of the capitalist.	Wie diese der kapitalistischen Produktion eigentümliche und sie charakterisierende Verkehrung, ja Verrückung des Verhältnisses von toter und lebendiger Arbeit, von Wert und wertschöpferischer Kraft, sich im Bewußtsein der Kapitalistenköpfe abspiegelt, zeige schließlich noch ein Beispiel.	ch11_clean.en-ch11_clean.de
During the English manufacturers’ revolt of 1848–50, ‘the head of one of the oldest and most respectable houses in the West of Scotland, Messrs Carlile Sons & Co., of the linen and cotton thread factory at Paisley, a company which has now existed for about a century, which was in operation in 1752, and four generations of the same family have conducted it…’, this ‘very intelligent gentleman’ wrote a letter printed in the Glasgow Daily Mail of 25 April 1849, under the heading ‘The Relay System’, where the following grotesquely naïve passage, among others, crept in: ‘Let us now… see what evils will attend the limiting to 10 hours the working of the factory… They amount to the most serious damage to the mill-owner’s prospects and property.	Während der englischen Fabrikantenrevolte von 1848-1850 schrieb "der Chef der Leinen- und Baumwollspinnerei zu Paisley, einer der ältesten und respektabelsten Firmen von Westschottland, der Kompagnie Carlile, Söhne und Co., die seit 1752 besteht und Generation nach Generation von derselben Familie geführt wird" - dieser äußerst intelligente Gentleman also schrieb in die "Glasgow Daily Mail" vom 25. April 1849 einen Brief unter dem Titel: "Das Relaissystem", worin u.a. folgende grotesk naive Stelle unterläuft: "Laßt uns nun die Übel betrachten, die aus einer Reduktion der Arbeitszeit von 12 auf 10 Stunden fließen ... Sie 'belaufen' sich auf die allerernsthafteste Beschädigung der Aussichten und des Eigentums des Fabrikanten.	ch11_clean.en-ch11_clean.de
If he’ (i.e. his ‘hands’) ‘worked 12 hours before, and is limited to 10, then every 12 machines or spindles in his establishment shrink to 10, and should the works be disposed of, they will be valued only as 10, so that a sixth part would thus be deducted from the value of every factory in the country.’	Arbeitete er" (d.h. seine "Hände") "12 Stunden und wird er auf 10 beschränkt, dann schrumpfen je 12 Maschinen oder Spindeln seines Etablissements auf 10 zusammen (then every 12 machines or spindles, in his establischment, shrink to 10), und wollte er seine Fabrik verkaufen, so würden sie nur als 10 gewertschätzt werden, so daß so ein sechster Teil vom Wert einer jeden Fabrik im ganzen Lande abgezogen würde."	ch11_clean.en-ch11_clean.de
In this West of Scotland bourgeois brain, which has inherited the capitalist qualities of ‘four generations’, the value of the means of production, spindles, etc., is so inextricably confused with the quality they possess, as capital, of valorizing themselves, or swallowing up every day a definite quantity of the unpaid labour of others, that the head of the firm of Carlile & Co. actually imagines that if he sells his factory, not only will the value of the spindles be paid to him, but, in addition, their power of self-valorization, not only the labour contained in them, which is necessary to the production of spindles of this kind, but also the surplus labour which they help to pump out daily from the brave Scots of Paisley. This is why he thinks that with the shortening of the working day by 2 hours, the selling-price of 12 spinning machines dwindles to that of 10!	Diesem erbangestammten Kapitalhirn von Westschottland verschwimmt der Wert der Produktionsmittel, Spindeln usw., so sehr mit ihrer Kapitaleigenschaft, sich selbst zu verwerten oder täglich ein bestimmtes Quantum fremder Gratisarbeit einzuschlucken, daß der Chef des Hauses Carlile und Co. in der Tat wähnt, beim Verkauf seiner Fabrik werde ihm nicht nur der Wert der Spindeln gezahlt, sondern obendrein ihre Verwertung, nicht nur die Arbeit, die in ihnen steckt und zur Produktion von Spindeln derselben Art nötig ist, sondern auch die Mehrarbeit, die sie täglich aus den braven Westschotten von Paisley auspumpen helfen, und ebendeshalb, meint er, schrumpfe mit der Verkürzung des Arbeitstags um zwei Stunden der Verkaufspreis von je 12 Spinnmaschinen auf den von je 10 zusammen!	ch11_clean.en-ch11_clean.de

