Chapter 12: The Concept of Relative Surplus-Value That portion of the working day which merely produces an equivalent for the value paid by the capitalist for his labour-power has up to this point been treated by us as a constant magnitude. And so it is, under given conditions of production and at a given stage in the economic development of society.	ZEHNTES KAPITEL Begriff des relativen Mehrwerts Der Teil des Arbeitstags, der bloß ein Äquivalent für den vom Kapital gezahlten Wert der Arbeitskraft produziert, galt uns bisher als konstante Größe, was er in der Tat ist unter gegebnen Produktionsbedingungen, auf einer vorhandnen ökonomischen Entwicklungsstufe der Gesellschaft.	ch12_clean.en-ch12_clean.de
As we saw, the worker could continue to work for 2, 3, 4, 6, etc. hours beyond this, his necessary labour-time.	Über diese seine notwendige Arbeitszeit hinaus konnte der Arbeiter 2, 3, 4, 6 usw. Stunden arbeiten.	ch12_clean.en-ch12_clean.de
The rate of surplus-value and the length of the working day depended on how far this extra time was prolonged.	Von der Größe dieser Verlängrung hingen Rate des Mehrwerts und Größe des Arbeitstags ab.	ch12_clean.en-ch12_clean.de
Although the necessary labour-time was constant, we saw, on the other hand, that the total working day was variable.	War die notwendige Arbeitszeit konstant, so dagegen der Gesamtarbeitstag variabel.	ch12_clean.en-ch12_clean.de
Now suppose we have a working day whose length and whose division between necessary labour and surplus labour are given.	Unterstelle jetzt einen Arbeitstag, dessen Größe und dessen Teilung in notwendige Arbeit und Mehrarbeit gegeben sind.	ch12_clean.en-ch12_clean.de
Let the whole line AC, A––––––––––B––C represent, for example, a working day of 12 hours; the section AB represents 10 hours of necessary labour, and the section BC represents 2 hours of surplus labour.	Die Linie a c, a __________ b __ c, stelle z.B. einen zwölfstündigen Arbeitstag vor, das Stück a b 10 Stunden notwendig Arbeit, das Stück b c 2 Stunden Mehrarbeit.	ch12_clean.en-ch12_clean.de
How can the production of surplus-value be increased, i.e. how can surplus labour be prolonged, without any prolongation, or independently of any prolongation, of the line AC?	Wie kann nun die Produktion von Mehrwert vergrößert, d.h. die Mehrarbeit verlängert werden, ohne jede weitere Verlängrung oder unabhängig von jeder weiteren Verlängrung von a c?	ch12_clean.en-ch12_clean.de
Although the boundaries of the working day, A and C, are given, it would seem possible to lengthen the line BC, other than by extension beyond its end point C, which is also the end of the working day AC, by pushing back its starting point B in the direction of A. Assume that B’B in the line A–––––––––B’–B––C is equal to half of BC, or to 1 hour’s labour-time.	Trotz gegebner Grenzen des Arbeitstags a c scheint b c verlängerbar, wenn nicht durch Ausdehnung über seinen Endpunkt c, der zugleich der Endpunkt des Arbeitstags a c ist, so durch Verschiebung seines Anfangspunkts b in entgegengesetzter Richtung nach a hin. Nimm an, b' _ b in a _________ b' _ b __ c sei gleich der Hälfte von b c oder gleich einer Arbeitsstunde.	ch12_clean.en-ch12_clean.de
If now, in AC, the working day of 12 hours, we move point B to B′, then BC becomes B’C; the surplus labour increases by one half, from 2 hours to 3 hours, although the working day remains 12 hours as before.	Wird nun in dem zwölfstündigen Arbeitstag a c der Punkt b nach b' verrückt, so dehnt sich b c aus zu b' c, die Mehrarbeit wächst um die Hälfte, von 2 auf 3 Stunden, obgleich der Arbeitstag nach wie vor nur 12 Stunden zählt.	ch12_clean.en-ch12_clean.de
This extension of the surplus labour-time from BC to B’C, from 2 hours to 3 hours, is however evidently impossible without a simultaneous contraction of the necessary labour-time from AB to AB’, from 10 hours to 9 hours.	Diese Ausdehnung der Mehrarbeit von b c auf b' c, von 2 auf 3 Stunden, ist aber offenbar unmöglich ohne gleichzeitige Zusammenziehung der notwendigen Arbeit von a b auf a b', von 10 auf 9 Stunden.	ch12_clean.en-ch12_clean.de
The prolongation of surplus labour would correspond to a shortening of necessary labour; i.e. a portion of the labour-time previously consumed, in reality, for the worker’s own benefit would be converted into labour-time expended for the capitalist.	Der Verlängrung der Mehrarbeit entspräche die Verkürzung der notwendigen Arbeit, oder ein Teil der Arbeitszeit, die der Arbeiter bisher in der Tat für sich selbst verbraucht, verwandelt sich in Arbeitszeit für den Kapitalisten.	ch12_clean.en-ch12_clean.de
There would be an alteration, not in the length of the working day, but in its division into necessary labour-time and surplus labour-time.	Was verändert, wäre nicht die Länge des Arbeitstags, sondern seine Teilung in notwendige Arbeit und Mehrarbeit.	ch12_clean.en-ch12_clean.de
On the other hand, it is evident that the duration of surplus labour is given when the length of the working day and the value of labour-power are given.	Andrerseits ist die Größe der Mehrarbeit offenbar selbst gegeben mit gegebner Größe des Arbeitstags und gegebnem Wert der Arbeitskraft.	ch12_clean.en-ch12_clean.de
The value of labour-power, i.e. the labour-time necessary to produce labour-power, determines the labour-time necessary for the reproduction of the value of labour-power.	Der Wert der Arbeitskraft, d.h. die zu ihrer Produktion erheischte Arbeitszeit, bestimmt die zur Reproduktion ihres Werts notwendige Arbeitszeit.	ch12_clean.en-ch12_clean.de
If 1 hour of work is embodied in sixpence, and the value of a day’s labour-power is 5 shillings, the worker must work for 10 hours a day in order to replace the value paid by capital for his labour-power, or to produce an equivalent for the value of the means of subsistence he needs to consume every day.	Stellt sich eine Arbeitsstunde in einem Goldquantum von einem halben Shilling oder 6 d. dar, und beträgt der Tageswert der Arbeitskraft 5 sh., so muß der Arbeiter täglich 10 Stunden arbeiten, um den ihm vom Kapital gezahlten Tageswert seiner Arbeitskraft zu ersetzen oder ein Äquivalent für den Wert seiner notwendigen täglichen Lebensmittel zu produzieren.	ch12_clean.en-ch12_clean.de
Given the value of these means of subsistence, the value of his labour-power can be calculated; and given the value of his labour-power, the duration of his necessary labour-time.	Mit dem Wert dieser Lebensmittel ist der Wert seiner Arbeitskraft , mit dem Wert seiner Arbeitskraft ist die Größe seiner notwendigen Arbeitszeit gegeben.	ch12_clean.en-ch12_clean.de
The duration of the surplus labour, however, is arrived at by subtracting the necessary labour-time from the total working day: 10 from 12 leaves 2, and it is not easy to see how, under the given conditions, the surplus labour can possibly be prolonged beyond 2 hours.	Die Größe der Mehrarbeit aber wird erhalten durch Subtraktion der notwendigen Arbeitszeit vom Gesamtarbeitstag. Zehn Stunden subtrahiert von zwölf lassen zwei, und es ist nicht abzusehn, wie die Mehrarbeit unter den gegebnen Bedingungen über zwei Stunden hinaus verlängert werden kann.	ch12_clean.en-ch12_clean.de
No doubt the capitalist could, instead of 5s., pay the worker 4s.	Allerdings mag der Kapitalist statt 5 sh. dem Arbeiter nur 4 sh.	ch12_clean.en-ch12_clean.de
6d. or even less. hours’ labour-time would be sufficient to reproduce this value of 4s.	6 d. oder noch weniger zahlen. Zur Reproduktion dieses Werts von 4 sh.	ch12_clean.en-ch12_clean.de
6d. ; and consequently 3 hours of surplus labour, instead of 2, would accrue to the capitalist, and the surplus-value would rise from 1s. to 1s.	6 d. würden 9 Arbeitsstunden genügen, von dem zwölfstündigen Arbeitstag daher 3 statt 2 Stunden der Mehrarbeit anheimfallen und der Mehrwert selbst von 1 sh. auf 1 sh. 6 d. steigen.	ch12_clean.en-ch12_clean.de
6d. This result, however, could be attained only by pushing the wage of the worker down below the value of his labour-power.	Dies Resultat wäre jedoch nur erzielt durch Herabdrückung des Lohns des Arbeiters unter den Wert seiner Arbeitskraft.	ch12_clean.en-ch12_clean.de
With the 4s.	Mit den 4 sh.	ch12_clean.en-ch12_clean.de
6d. which he produces in 9 hours, he commands one-tenth less of the means of subsistence than before, and consequently the reproduction of his labour-power can take place only in a stunted form.	6 d., die er in 9 Stunden produziert, verfügt er über 1/10 weniger Lebensmittel als vorher, und so findet nur eine verkümmerte Reproduktion seiner Arbeitskraft statt.	ch12_clean.en-ch12_clean.de
The surplus labour would in this case be prolonged only by transgressing its normal limits; its domain would be extended only by a usurpation of part of the domain of necessary labour-time.	Die Mehrarbeit würde hier nur verlängert durch Überschreitung ihrer normalen Grenzen, ihre Domäne nur ausgedehnt durch usurpatorischen Abbruch von der Domäne der notwendigen Arbeitszeit.	ch12_clean.en-ch12_clean.de
Despite the important part which this method plays in practice, we are excluded from considering it here by our assumption that all commodities, including labour-power, are bought and sold at their full value.	Trotz der wichtigen Rolle, welche diese Methode in der wirklichen Bewegung des Arbeitslohnes spielt, ist sie hier ausgeschlossen durch die Voraussetzung, daß die Waren, also auch die Arbeitskraft, zu ihrem vollen Wert gekauft und verkauft werden.	ch12_clean.en-ch12_clean.de
If we once assume this, it follows that the labour-time necessary for the production of labour-power, or for the reproduction of its value, cannot be lessened by a fall in the worker’s wages below the value of his labour-power, but only by a fall in this value itself.	Dies einmal unterstellt, kann die zur Produktion der Arbeitskraft oder zur Reproduktion ihres Werts notwendige Arbeitszeit nicht abnehmen, weil der Lohn des Arbeiters unter den Wert seiner Arbeitskraft, sondern nur wenn dieser Wert selbst sinkt.	ch12_clean.en-ch12_clean.de
Given the length of the working day, the prolongation of the surplus labour must of necessity originate in the curtailment of the necessary labour-time; the latter cannot arise from the former.	Bei gegebner Länge des Arbeitstags des Arbeitstags muß die Verlängrung der Mehrarbeit aus der Verkürzung der notwendigen Arbeitszeit entspringen, nicht umgekehrt die Verkürzung der notwendigen Arbeitszeit aus der Verlängrung der Mehrarbeit.	ch12_clean.en-ch12_clean.de
In the example we chose, the value of labour-power had to fall in fact by one-tenth in order for the necessary labour-time to be diminished by one-tenth, i.e. from 10 hours to 9, and for the surplus labour to consequently be prolonged from 2 hours to 3.	In unsrem Beispiel muß der Wert der Arbeitskraft wirklich um 1/10 sinken, damit die notwendige Arbeitszeit um 1/10 abnehme, von 10 auf 9 Stunden, und daher die Mehrarbeit sich von 2 auf 3 Stunden verlängre.	ch12_clean.en-ch12_clean.de
A fall of this kind in the value of labour-power implies, however, that the same means of subsistence formerly produced in 10 hours can now be produced in 9 hours.	Eine solche Senkung des Werts der Arbeitskraft um 1/10 bedingt aber ihrerseits, daß dieselbe Masse Lebensmittel, die früher in 10, jetzt in 9 Stunden produziert wird.	ch12_clean.en-ch12_clean.de
But this is impossible without an increase in the productivity of labour.	Dies ist jedoch unmöglich ohne eine Erhöhung der Produktivkraft der Arbeit.	ch12_clean.en-ch12_clean.de
For example, suppose a cobbler, with a given set of tools, makes one pair of boots in one working day of 12 hours.	Mit gegebnen Mitteln kann ein Schuster z.B. ein Paar Stiefel in einem Arbeitstag von 12 Stunden machen.	ch12_clean.en-ch12_clean.de
If he is to make two pairs in the same time, the productivity of his labour must be doubled; and this cannot be done except by an alteration in his tools or in his mode of working, or both.	Soll er in derselben Zeit zwei Paar Stiefel machen, so muß sich die Produktivkraft seiner Arbeit verdoppeln, und sie kann sich nicht verdoppeln ohne eine Änderung in seinen Arbeitsmitteln oder seiner Arbeitsmethode oder beiden zugleich.	ch12_clean.en-ch12_clean.de
Hence the conditions of production of his labour, i.e. his mode of production, and the labour process itself, must be revolutionized.	Es muß daher eine Revolution in den Produktionsbedingungen seiner Arbeit eintreten, d.h. in seiner Produktionsweise und daher im Arbeitsprozeß selbst.	ch12_clean.en-ch12_clean.de
By an increase in the productivity of labour, we mean an alteration in the labour process of such a kind as to shorten the labour-time socially necessary for the production of a commodity, and to endow a given quantity of labour with the power of producing a greater quantity of use-value.	Unter Erhöhung der Produktivkraft der Arbeit verstehn wir hier überhaupt eine Verändrung im Arbeitsprozeß, wodurch die zur Produktion einer Ware gesellschaftlich erheischte Arbeitszeit verkürzt wird, ein kleinres Quantum Arbeit also die Kraft erwirbt, ein größres Quantum Gebrauchswert zu produzieren.	ch12_clean.en-ch12_clean.de
Hitherto, in dealing with the production of surplus-value in the above form, we have assumed that the mode of production is given and invariable. But when surplus-value has to be produced by the conversion of necessary labour into surplus labour, it by no means suffices for capital to take over the labour process in its given or historically transmitted shape, and then simply to prolong its duration.	Während also bei der Produktion des Mehrwerts in der bisher betrachteten Form die Produktionsweise als gegeben unterstellt war, genügt es für die Produktion von Mehrwert durch Verwandlung not- wendiger Arbeit in Mehrarbeit keineswegs, daß das Kapital sich des Arbeitsprozesses in seiner historisch überlieferten oder vorhandnen Gestalt bemächtigt und nur seine Dauer verlängert.	ch12_clean.en-ch12_clean.de
The technical and social conditions of the process and consequently the mode of production itself must be revolutionized before the productivity of labour can be increased. Then, with the increase in the productivity of labour, the value of labour-power will fall, and the portion of the working day necessary for the reproduction of that value will be shortened.	Es muß die technischen und gesellschaftlichen Bedingungen des Arbeitsprozesses, also die Produktionsweise selbst umwälzen, um die Produktivkraft der Arbeit zu erhöhn, durch die Erhöhung der Produktivkraft der Arbeit den Wert der Arbeitskraft zu senken und so den zur Reproduktion dieses Werts notwendigen Teil des Arbeitstags zu verkürzen.	ch12_clean.en-ch12_clean.de
I call that surplus-value which is produced by the lengthening of the working day, absolute surplus-value. In contrast to this, I call that surplus-value which arises from the curtailment of the necessary labour-time, and from the corresponding alteration in the respective lengths of the two components of the working day, relative surplus-value.	Durch Verlängrung des Arbeitstags produzierten Mehrwert nenne ich absoluten Mehrwert; den Mehrwert dagegen, der aus Verkürzung der notwendigen Arbeitszeit und entsprechender Verändrung im Größenverhältnis der beiden Bestandteile des Arbeitstags entspringt - relativen Mehrwert.	ch12_clean.en-ch12_clean.de
In order to make the value of labour-power go down, the rise in the productivity of labour must seize upon those branches of industry whose products determine the value of labour-power, and consequently either belong to the category of normal means of subsistence, or are capable of replacing them.	Um den Wert der Arbeitskraft zu senken, muß die Steigerung der Produktivkraft Industriezweige ergreifen, deren Produkte den Wert der Arbeitskraft bestimmen, also entweder dem Umkreis der gewohnheitsmäßigen Lebensmittel angehören oder sie ersetzen können.	ch12_clean.en-ch12_clean.de
But the value of a commodity is determined not only by the quantity of labour which gives it its final form, but also by the quantity of labour contained in the instruments by which it has been produced.	Der Wert einer Ware ist aber nicht nur bestimmt durch das Quantum der Arbeit, welche ihr die letzte Form gibt, sondern ebensowohl durch die in ihren Produktionsmitteln enthaltne Arbeitsmasse.	ch12_clean.en-ch12_clean.de
For instance, the value of a pair of boots depends not only on the labour of the cobbler, but also on the value of the leather, wax, thread, etc. Hence a fall in the value of labour-power is also brought about by an increase in the productivity of labour, and by a corresponding cheapening of commodities in those industries which supply the instruments of labour and the material for labour, i.e. the physical elements of constant capital which are required for producing the means of subsistence.	Z.B. der Wert eines Stiefels nicht nur durch die Schusterarbeit, sondern auch durch den Wert von Leder, Pech, Draht usw. Steigerung der Produktivkraft und entsprechende Verwohlfeilerung der Waren in den Industrien, welche die stofflichen Elemente des konstanten Kapitals, die Arbeitsmittel und das Arbeitsmaterial, zur Erzeugung der notwendigen Lebensmittel liefern, senken also ebenfalls den Wert der Arbeitskraft.	ch12_clean.en-ch12_clean.de
But an increase in the productivity of labour in those branches of industry which supply neither the necessary means of subsistence nor the means by which they are produced leaves the value of labour-power undisturbed.	In Produktionszweigen dagegen, die weder notwendige Lebensmittel liefern noch Produktionsmittel zu ihrer Herstellung, läßt die erhöhte Produktivkraft den Wert der Arbeitskraft unberührt.	ch12_clean.en-ch12_clean.de
The cheapening of the commodity, of course, causes only a relative fall in the value of labour-power, a fall proportional to the extent to which that commodity enters into the reproduction of labour-power.	Die verwohlfeilerte Ware senkt natürlich den Wert der Arbeitskraft nur pro tanto, d.h. nur im Verhältnis, worin sie in die Reproduktion der Arbeitskraft eingeht.	ch12_clean.en-ch12_clean.de
Shirts, for instance, are a necessary means of subsistence, but are only one out of many.	Hemden z.B. sind ein notwendiges Lebensmittel, aber nur eins von vielen.	ch12_clean.en-ch12_clean.de
The total sum of the necessary means of subsistence, however, consists of various commodities, each the product of a distinct industry; and the value of each of those commodities enters as a component part into the value of labour-power.	Ihre Verwohlfeilerung vermindert bloß die Ausgabe des Arbeiters für Hemden.	ch12_clean.en-ch12_clean.de
The latter value decreases with the decrease of the labour-time necessary for its reproduction.	Die Gesamtsumme der notwendigen Lebensmittel besteht jedoch nur aus verschiednen Waren, lauter Produkten besondrer Industrien, und der Wert jeder solchen Ware bildet stets einen aliquoten Teil vom Wert der Arbeitskraft.	ch12_clean.en-ch12_clean.de
The total decrease of necessary labour-time is equal to the sum of all the different reductions in labour-time which have occurred in those various distinct branches of production.	Dieser Wert nimmt ab mit der zu seiner Reproduktion notwendigen Arbeitszeit, deren Gesamtverkürzung gleich der Summe ihrer Verkürzungen in allen jenen besondren Produktionszweigen ist.	ch12_clean.en-ch12_clean.de
Here we treat this general result as if it were the direct result and the direct purpose in each individual case.	Wir behandeln dies allgemeine Resultat hier so, als wäre es unmittelbares Resultat und unmittelbarer Zweck in jedem einzelnen Fall.	ch12_clean.en-ch12_clean.de
When an individual capitalist cheapens shirts, for instance, by increasing the productivity of labour, he by no means necessarily aims to reduce the value of labour-power and shorten necessary labour-time in proportion to this. But he contributes towards increasing the general rate of surplus-value only in so far as he ultimately contributes to this result.	Wenn ein einzelner Kapitalist durch Steigerung der Produktivkraft der Arbeit z.B. Hemden verwohlfeilert, schwebt ihm keineswegs notwendig der Zweck vor, den Wert der Arbeitskraft und daher die notwendige Arbeitszeit pro tanto zu senken, aber nur soweit er schließlich zu diesem Resultat beiträgt, trägt er bei zur Erhöhung der allgemeinen Rate des Mehrwerts.	ch12_clean.en-ch12_clean.de
The general and necessary tendencies of capital must be distinguished from their forms of appearance.	Die allgemeinen und notwendigen Tendenzen des Kapitals sind zu unterscheiden von ihren Erscheinungsformen.	ch12_clean.en-ch12_clean.de
While it is not our intention here to consider the way in which the immanent laws of capitalist production manifest themselves in the external movement of the individual capitals, assert themselves as the coercive laws of competition, and therefore enter into the consciousness of the individual capitalist as the motives which drive him forward, this much is clear: a scientific analysis of competition is possible only if we can grasp the inner nature of capital, just as the apparent motions of the heavenly bodies are intellgible only to someone who is acquainted with their real motions, which are not perceptible to the senses.	Die Art und Weise, wie die immanenten Gesetze der kapitalistischen Produktion in der äußern Bewegung der Kapitale erscheinen, sich als Zwangsgesetze der Konkurrenz geltend machen und daher als treibende Motive dem individuellen Kapitalisten zum Bewußtsein kommen, ist jetzt nicht zu betrachten, aber soviel erhellt von vornherein: Wissenschaftliche Analyse der Konkurrenz ist nur möglich, sobald die innere Natur des Kapitals begriffen ist, ganz wie die scheinbare Bewegung der Himmelskörper nur dem verständlich, der ihre wirkliche, aber sinnlich nicht wahrnehmbare Bewegung kennt.	ch12_clean.en-ch12_clean.de
Nevertheless, for the understanding of the production of relative surplus-value, and merely on the basis of the results already achieved, we may add the following remarks.	Dennoch ist zum Verständnis der Produktion des relativen Mehrwerts und bloß auf Grundlage der bereits gewonnenen Resultate folgendes zu bemerken.	ch12_clean.en-ch12_clean.de
If 1 hour’s labour is embodied in 6d., a value of 6s. will be produced in a working day of 12 hours.	Stellt sich eine Arbeitsstunde in einem Goldquantum von 6 d. oder 1/2 sh. dar, so wird in zwölfstündigem Arbeitstag ein Wert von 6 sh. produziert.	ch12_clean.en-ch12_clean.de
Suppose that with labour of the currently prevailing productivity twelve articles are produced in these 12 hours.	Gesetzt, mit der gegebnen Produktivkraft der Arbeit würden 12 Stück Waren in diesen 12 Arbeitsstunden verfertigt.	ch12_clean.en-ch12_clean.de
Let the value of the means of production used up in each article be 6d. Under these circumstances, each article costs Is. : 6d. for the value of the means of production, and 6d. for the value newly added in working with those means.	Der Wert der in jedem Stück vernutzten Produktionsmittel, Rohmaterial usw. sei 6 d. Unter diesen Umständen kostet die einzelne Ware 1 sh., nämlich 6 d. für den Wert der Produktionsmittel, 6 d. für den in ihrer Verarbeitung neu zugesetzten Wert.	ch12_clean.en-ch12_clean.de
Now let some one capitalist contrive to double the productivity of labour, and to produce twenty-four instead of twelve articles in the course of a working day of 12 hours.	Es gelinge nun einem Kapitalisten, die Produktivkraft der Arbeit zu verdoppeln und daher 24 statt 12 Stück dieser Warenart in dem zwölfstündigen Arbeitstag zu produzieren.	ch12_clean.en-ch12_clean.de
The value of the means of production remaining the same, the value of each article will fall to 9d., made up of 6d. for the value of the means of production and 3d. for the value newly added by the labour.	Bei unverändertem Wert der Produktionsmittel sinkt der Wert der einzelnen Ware jetzt auf 9 d., nämlich 6 d. für den Wert der Produktionsmittel, 3 d. für den durch die letzte Arbeit neu zugesetzten Wert.	ch12_clean.en-ch12_clean.de
Even though the productivity of labour has been doubled, the day’s labour creates, as before, a new value of 6s. and no more, which is now however spread over twice as many articles.	Trotz der verdoppelten Produktivkraft schafft der Arbeitstag nach wie vor nur einen Neuwert von 6 sh., welcher sich jedoch jetzt auf doppelt soviel Produkte verteilt.	ch12_clean.en-ch12_clean.de
Each article now has embodied in it 1/24th of this value instead of 1/12th, 3d. instead of 6d. ; or, what amounts to the same thing, only half an hour of labour-time, instead of a whole hour, is now added to the means of production while they are being transformed into each article.	Auf jedes einzelne Produkt fällt daher nur noch 1/24 statt 1/12 dieses Gesamtwerts, 3 d. statt 6 d. oder, was dasselbe ist, den Produktionsmitteln wird bei ihrer Verwandlung in Produkt, jedes Stück berechnet, jetzt nur noch eine halbe statt wie früher eine ganze Arbeitsstunde zugesetzt.	ch12_clean.en-ch12_clean.de
The individual value of these articles is now below their social value; in other words, they have cost less labour-time than the great bulk of the same article produced under the average social conditions.	Der individuelle Wert dieser Ware steht nun unter ihrem gesellschaftlichen Wert, d.h., sie kostet weniger Arbeitszeit als der große Haufen derselben Artikel, produziert unter den gesellschaftlichen Durchschnittsbedingungen.	ch12_clean.en-ch12_clean.de
Each article costs, on an average, Is., and represents 2 hours of social labour; but under the altered mode of production it costs only 9d., or contains only 1 1/ hours’ labour.	Das Stück kostet im Durchschnitt 1 sh. oder stellt 2 Stunden gesellschaftlicher Arbeit dar; mit der veränderten Produktionsweise kostet es nur 9 d. oder enthält nur 11/2 Arbeitsstunden.	ch12_clean.en-ch12_clean.de
The real value of a commodity, however, is not its individual, but its social value; that is to say, its value is not measured by the labour-time that the article costs the producer in each individual case, but by the labour-time socially required for its production.	Der wirkliche Wert einer Ware ist aber nicht ihr individueller, sondern ihr gesellschaftlicher Wert, d.h., er wird nicht durch die Arbeitszeit gemessen, die sie im einzelnen Fall dem Produzenten tatsächlich kostet, sondern durch die gesellschaftlich zu ihrer Produktion erheischte Arbeitszeit.	ch12_clean.en-ch12_clean.de
If, therefore, the capitalist who applies the new method sells his commodity at its social value of one shilling, he sells it for 3d. above its individual value, and thus he realizes an extra surplus-value of 3d. On the other hand, the working day of 12 hours is now represented, for him, by twenty-four articles instead of twelve. Hence, in order to get rid of the product of one working day, the demand must be double what it was, i.e. the market must become twice as extensive.	Verkauft also der Kapitalist, der die neue Methode anwendet, seine Ware zu ihrem gesellschaftlichen Wert von 1 sh., so verkauft er sie 3 d. über ihrem individuellen Wert und realisiert so einen Extramehrwert von 3 d. Andrerseits stellt sich aber der zwölfstündige Arbeitstag jetzt für ihn in 24 Stück Ware dar statt früher in 12. Um also das Produkt eines Arbeitstags zu verkaufen, bedarf er doppelten Absatzes oder eines zweifach größern Markts.	ch12_clean.en-ch12_clean.de
Other things being equal, the capitalist’s commodities can only command a more extensive market if their prices are reduced.	Unter sonst gleichbleibenden Umständen erobern seine Waren nur größern Marktraum durch Kontraktion ihrer Preise.	ch12_clean.en-ch12_clean.de
He will therefore sell them above their individual but below their social value, say at 10d. each.	Er wird sie daher über ihrem individuellen, aber unter ihrem gesellschaftliche Wert verkaufen, sage zu 10 d. das Stück.	ch12_clean.en-ch12_clean.de
By this means he still squeezes an extra surplus-value of one penny out of each.	So schlägt er an jedem einzelnen Stück immer noch einen Extramehrwert von 1 d. heraus.	ch12_clean.en-ch12_clean.de
This augmentation of surplus-value is pocketed by the capitalist himself, whether or not his commodities belong to the class of necessary means of subsistence, and therefore participate in determining the general value of labour-power.	Diese Steigerung des Mehrwerts findet für ihn statt, ob oder ob nicht seine Ware dem Umkreis der notwendigen Lebensmittel angehört und daher bestimmend in den allgemeinen Wert der Arbeitskraft eingeht.	ch12_clean.en-ch12_clean.de
Hence, quite independently of this, there is a motive for each individual capitalist to cheapen his commodities by increasing the productivity of labour.	Vom letztren Umstand abgesehn, existiert also für jeden einzelnen Kapitalisten das Motiv, die Ware durch erhöhte Produktivkraft der Arbeit zu verwohlfeilern.	ch12_clean.en-ch12_clean.de
Nevertheless, even in this case, the increased production of surplus-value arises from the curtailment of the necessary labour-time, and the corresponding prolongation of the surplus labour.	Indes entspringt selbst in diesem Fall die gesteigerte Produktion von Mehrwert aus der Verkürzung der notwendigen Arbeitszeit und entsprechender Verlängrung der Mehrarbeit.	ch12_clean.en-ch12_clean.de
Let the necessary labour-time amount to 10 hours, the value of a day’s labour-power to 5s., the surplus labour-time to 2 hours, and the daily surplus-value to Is.	(3a) Die notwendige Arbeitszeit betrage 10 Stunden oder der Tageswert der Arbeitskraft 5 sh., die Mehrarbeit 2 Stunden, der täglich produzierte Mehrwert daher 1 sh.	ch12_clean.en-ch12_clean.de
But the capitalist now produces 24 articles, which he sells at 10d. each, making 20s. in all.	Unser Kapitalist produziert aber jetzt 24 Stück, die er zu 10 d. per Stück oder zusammen zu 20 sh. verkauft.	ch12_clean.en-ch12_clean.de
Since the value of the means of production is 12s., 14 2/ of these articles merely replace the constant capital advanced.	Da der Wert der Produktionsmittel gleich 12 Schilling, ersetzen 142/5 Stück Ware nur das vorgeschoßne konstante Kapital.	ch12_clean.en-ch12_clean.de
The labour of the 12-hour working day is represented by the remaining 9 3/ articles.	Der zwölfstündige Arbeitstag stellt sich in den übrigbleibenden 93/5 Stück dar.	ch12_clean.en-ch12_clean.de
Since the price of the labour-power is 5s., 6 articles represent the necessary labour-time, and 3 3/ articles the surplus labour.	Da der Preis der Arbeitskraft = 5 sh., stellt sich im Produkt von 6 Stück die notwendige Arbeitszeit dar und in 33/5 Stück die Mehrarbeit.	ch12_clean.en-ch12_clean.de
The ratio of necessary labour to surplus labour, which under average social conditions was 5:1, is now only 5:3. We may arrive at the same result in the following way.	Das Verhältnis der notwendigen Arbeit zur Mehrarbeit, welches unter den gesellschaftlichen Durchschnittsbedingungen 5 : 1 betrug, beträgt jetzt nur noch 5 : 3. Dasselbe Resultat erhält man so: Der Produktenwert des zwölfstündigen Arbeitstags ist 20 sh.	ch12_clean.en-ch12_clean.de
The value of the product of the working day of 12 hours is 20s.	Davon gehören 12 sh. dem nur wieder erscheinenden Wert der Produktionsmittel.	ch12_clean.en-ch12_clean.de
Of this sum, 12s. represent the value of the means of production, a value that merely re-appears in the finished product.		ch12_clean.en-ch12_clean.de
There remain 8s., which are the expression in money of the value newly created during the working day.	Bleiben also 8 sh. als Geldausdruck des Werts, worin sich der Arbeitstag darstellt.	ch12_clean.en-ch12_clean.de
This sum is greater than the sum in which average social labour of the same kind is expressed: 12 hours of the latter labour are expressed by only 6s.	Dieser Geldausdruck ist höher als der Geldausdruck der gesellschaftlichen Durchschnittsarbeit von derselben Sorte, wovon sich 12 Stunden nur in 6 sh. ausdrücken.	ch12_clean.en-ch12_clean.de
The exceptionally productive labour acts as intensified labour; it creates in equal periods of time greater values than average social labour of the same kind. * But our capitalist still continues to pay as before only 5s. as the daily value of labour-power.	Die Arbeit von ausnahmsweiser Produktivkraft wirkt als potenzierte Arbeit oder schafft in gleichen Zeiträumen höhere Werte als die gesellschaftliche Durchschnittsarbeit derselben Art. Aber unser Kapitalist zahlt nach wie vor nur 5 sh. für den Tageswert der Arbeitskraft.	ch12_clean.en-ch12_clean.de
Hence, instead of 10 hours, the worker now needs to work for only 7 1/ hours in order to reproduce this value.	Der Arbeiter bedarf daher, statt früher 10, jetzt nur noch 71/2 Stunden zur Reproduktion dieses Werts.	ch12_clean.en-ch12_clean.de
His surplus labour is therefore increased by 2 4/ hours, and the surplus-value he produces grows from one into 3s.	Seine Mehrarbeit wächst daher um 21/2 Stunden, der von ihm produzierte Mehrwert von 1 auf 3 sh.	ch12_clean.en-ch12_clean.de
Hence the capitalist who applies the improved method of production appropriates and devotes to surplus labour a greater portion of the working day than the other capitalists in the same business.	Der Kapitalist, der die verbesserte Produktionsweise anwendet, eignet sich daher einen größern Teil des Arbeitstags für die Mehrarbeit an als die übrigen Kapitalisten in demselben Geschäft.	ch12_clean.en-ch12_clean.de
He does as an individual what capital itself taken as a whole does when engaged in producing relative surplus-value.	Er tut im einzelnen, was das Kapital bei der Produktion des relativen Mehrwerts im großen und ganzen tut.	ch12_clean.en-ch12_clean.de
On the other hand, however, this extra surplus-value vanishes as soon as the new method of production is generalized, for then the difference between the individual value of the cheapened commodity and its social value vanishes.	Andrerseits aber verschwindet jener Extramehrwert, sobald die neue Produktionsweise sich verallgemeinert und damit die Differenz zwischen dem individuellen Wert der wohlfeiler produzierten Waren und ihrem gesellschaftliche Wert verschwindet.	ch12_clean.en-ch12_clean.de
The law of the determination of value by labour-time makes itself felt to the individual capitalist who applies the new method of production by compelling him to sell his goods under their social value; this same law, acting as a coercive law of competition, forces his competitors to adopt the new method.	Dasselbe Gesetz der Wertbestimmung durch die Arbeitszeit, das dem Kapitalisten mit der neuen Methode in der Form fühlbar wird, daß er seine Ware unter ihrem gesellschaftlichen Wert verkaufen muß, treibt seine Mitbewerber als Zwangsgesetz der Konkurrenz zur Einführung der neuen Produktionsweise.	ch12_clean.en-ch12_clean.de
The general rate of surplus-value is therefore ultimately affected by the whole process only when the increase in the productivity of labour has seized upon those branches of production and cheapened those commodities that contribute towards the necessary means of subsistence, and are therefore elements of the value of labour-power.	Die allgemeine Rate des Mehrwerts wird also durch den ganzen Prozeß schließlich nur berührt, wenn die Erhöhung der Produktivkraft der Arbeit Produktionszweige ergriffen, also Waren verwohlfeilert hat, die in den Kreis der notwendigen Lebensmittel eingehn, daher Elemente des Werts der Arbeitskraft bilden.	ch12_clean.en-ch12_clean.de
The value of commodities stands in inverse ratio to the productivity of labour.	Der Wert der Waren steht in umgekehrtem Verhältnis zur Produktivkraft der Arbeit.	ch12_clean.en-ch12_clean.de
So, too, does the value of labour-power, since it depends on the values of commodities.	Ebenso, weil durch Warenwerte bestimmt, der Wert der Arbeitskraft.	ch12_clean.en-ch12_clean.de
Relative surplus-value, however, is directly proportional to the productivity of labour.	Dagegen steht der relative Mehrwert in direktem Verhältnis zur Produktivkraft der Arbeit.	ch12_clean.en-ch12_clean.de
It rises and falls together with productivity.	Er steigt mit steigender und fällt mit fallender Produktivkraft.	ch12_clean.en-ch12_clean.de
The value of money being assumed to be constant, an average social working day of 12 hours always produces the same new value, 6s., no matter how this sum may be apportioned between surplus-value and wages.	Ein gesellschaftlicher Durchschnittsarbeitstag von 12 Stunden, Geldwert als gleichbleibend vorausgesetzt, produziert stets dasselbe Wertprodukt von 6 sh., wie diese Wertsumme sich immer verteile zwischen Äquivalent für den Wert der Arbeitskraft und Mehrwert.	ch12_clean.en-ch12_clean.de
But if, as a result of an increase in productivity, there is a fall in the value of the means of subsistence, and the daily value of labour-power is thereby reduced from 5s. to 3, the surplus-value will increase from Is. to 3. hours were necessary for the reproduction of the value of the labour-power; now only 6 are required. hours have been set free, and can be annexed to the domain of surplus labour.	Fällt aber infolge gesteigerter Produktivkraft der Wert der täglichen Lebensmittel und daher der Tageswert der Arbeitskraft von 5 sh. auf 3 sh., so wächst der Mehrwert von 1 sh. auf 3 sh. Um den Wert der Arbeitskraft zu reproduzieren, waren 10 und sind jetzt nur noch 6 Arbeitsstunden nötig. Vier Arbeitsstunden sind frei geworden und können der Domäne der Mehrarbeit annexiert werden.	ch12_clean.en-ch12_clean.de
Capital therefore has an immanent drive, and a constant tendency, towards increasing the productivity of labour, in order to cheapen commodities and, by cheapening commodities, to cheapen the worker himself.	Es ist daher der immanente Trieb und die beständige Tendenz des Kapitals, die Produktivkraft der Arbeit zu steigern, um die Ware und durch die Verwohlfeilerung der Ware den Arbeiter selbst zu verwohlfeilern.	ch12_clean.en-ch12_clean.de
The absolute value of a commodity is, in itself, of no interest to the capitalist who produces it.	Der absolute Wert der Ware ist dem Kapitalisten, der sie produziert, an und für sich gleichgültig.	ch12_clean.en-ch12_clean.de
All that interests him is the surplus-value present in it, which can be realized by sale.	Ihn interessiert nur der in ihr steckende und im Verkauf realisierbare Mehrwert.	ch12_clean.en-ch12_clean.de
Realization [Realisierung] of the surplus-value necessarily carries with it the replacement of the value advanced.	Realisierung von Mehrwert schließt von selbst Ersatz des vorgeschoßnen Werts ein.	ch12_clean.en-ch12_clean.de
Now, since relative surplus-value increases in direct proportion to the development of the productivity of labour, while the value of commodities stands in precisely the opposite relation to the growth of productivity; since the same process both cheapens commodities and augments the surplus-value contained in them, we have here the solution of the following riddle: Why does the capitalist, whose sole concern is to produce exchange-value, continually strive to bring down the exchange-value of commodities? One of the founders of political economy, Quesnay, used to torment his opponents with this question, and they could find no answer to it.	Da nun der relative Mehrwert in direktem Verhältnis zur Entwicklung der Produktivkraft der Arbeit wächst, während der Wert der Waren in umgekehrtem Verhältnis zur selben Entwicklung fällt, da also derselbe identische Prozeß die Waren verwohlfeilert und den in ihnen enthaltnen Mehrwert steigert, löst sich das Rätsel, daß der Kapitalist, dem es nur um die Produktion von Tauschwert zu tun ist, den Tauschwert der Waren beständig zu senken strebt, ein Widerspruch, womit einer der Gründer der politischen Ökonomie, Quesnay, seine Gegner quälte und worauf sie ihm die Antwort schuldig blieben.	ch12_clean.en-ch12_clean.de
‘You acknowledge,’ he says, ‘that the more one can reduce the expenses and costs of labour in the manufacture of industrial products, without injury to production, the more advantageous is that reduction, because it diminishes the price of the finished article.	"Ihr gebt zu", sagt Qeusnay, "daß, je mehr man, ohne Nachteil für die Produktion, Kosten oder kostspielige Arbeiten in der Fabrikation industrieller Produkte ersparen kann, desto vorteilhafter diese Ersparung, weil sie den Preis des Machwerks vermindert.	ch12_clean.en-ch12_clean.de
And yet you believe that the production of wealth, which arises from the labour of the craftsmen, consists in the augmentation of the exchange-value of their products.’	Und trotzdem glaubt ihr, daß die Produktion des Reichtums, der aus den Arbeiten der Industriellen herkommt, in der Vermehrung des Tauschwerts ihres Machwerks besteht."	ch12_clean.en-ch12_clean.de
The shortening of the working day, therefore, is by no means what is aimed at in capitalist production, when labour is economized by increasing its productivity.	Ökonomie der Arbeit durch Entwicklung der Produktivkraft der Arbeit bezweckt in der kapitalistischen Produktion also durchaus nicht Verkürzung des Arbeitstags.	ch12_clean.en-ch12_clean.de
It is only the shortening of the labour-time necessary for the production of a definite quantity of commodities that is aimed at.	Sie bezweckt nur Verkürzung der für Produktion eines bestimmten Warenquantums notwendigen Arbeitszeit.	ch12_clean.en-ch12_clean.de
The fact that the worker, when the productivity of his labour has been increased, produces say ten times as many commodities as before, and thus spends one-tenth as much labour-time on each, by no means prevents him from continuing to work 12 hours as before, nor from producing in those 12 hours 1, articles instead of 120.	Daß der Arbeiter bei gesteigerter Produktivkraft seiner Arbeit in einer Stunde z.B. 10mal mehr Ware früher produziert, also für jedes Stück Ware 10mal weniger Arbeitszeit braucht, verhindert durchaus nicht, ihn nach wie vor 12 Stunden arbeiten und in den 12 Stunden 1.200 statt früher 120 Stück produzieren zu lassen.	ch12_clean.en-ch12_clean.de
Indeed, his working day may simultaneously be prolonged, so as to make him produce say 1, articles in 14 hours. Therefore in the treatises of economists of the stamp of MacCulloch, Ure, Senior and the like, we may read on one page that the worker owes a debt of gratitude to capital for developing his productivity, because the necessary labour-time is thereby shortened, and on the next page that he must prove his gratitude by working in future for 15 hours instead of 10.	Ja, sein Arbeitstag mag gleichzeitig verlängert werden, so daß er jetzt in 14 Stunden 1.400 Stück produziert usw. Man kann daher bei Ökonomen vom Schlag eines MacCulloch, Ure, Senior und tutti quanti auf einer Seite lesen, daß der Arbeiter dem Kapital für die Entwicklung der Produktivkräfte Dank schuldet, weil sie die notwendige Arbeitszeit verkürzt, und auf der nächsten Seite, daß er diesen Dank beweisen muß, indem er statt 10 künftig 15 Stunden arbeitet.	ch12_clean.en-ch12_clean.de
The objective of the development of the productivity of labour within the context of capitalist production is the shortening of that part of the working day in which the worker must work for himself, and the lengthening, thereby, of the other part of the day, in which he is free to work for nothing for the capitalist.	Die Entwicklung der Produktivkraft der Arbeit, innerhalb der kapitalistischen Produktion, bezweckt, den Teil des Arbeitstags, den der Arbeiter für sich selbst arbeiten muß, zu verkürzen, um grade dadurch den andren Teil des Arbeitstags, den er für den Kapitalisten umsonst arbeiten kann, zu verlängern.	ch12_clean.en-ch12_clean.de
How far this result can also be attained without cheapening commodities will appear from the following chapters, where we examine the particular methods of producing relative surplus-value.	Wieweit dies Resultat auch ohne Verwohlfeilerung der Waren erreichbar, wird sich zeigen in den besondren Produktionsmethoden des relativen Mehrwerts, zu deren Betrachtung wir jetzt übergehn.	ch12_clean.en-ch12_clean.de

