Chapter 13: Co-operation Capitalist production only really begins, as we have already seen, when each individual capital simultaneously employs a comparatively large number of workers, and when, as a result, the labour-process is carried on on an extensive scale, and yields relatively large quantities of products.	ELFTES KAPITEL Kooperation Die kapitalistische Produktion beginnt, wie wir sahen, in der Tat erst, wo dasselbe individuelle Kapital eine größere Anzahl Arbeiter gleichzeitig beschäftigt, der Arbeitsprozeß also seinen Umfang erweitert und Produkt auf größrer quantitativer Stufenleiter liefert.	ch13_clean.en-ch13_clean.de
A large number of workers working together, at the same time, in one place (or, if you like, in the same field of labour), in order to produce the same sort of commodity under the command of the same capitalist, constitutes the starting-point of capitalist production. This is true both historically and conceptually.	Das Wirken einer größern Arbeiteranzahl zur selben Zeit, in demselben Raum (oder, wenn man will, auf demselben Arbeitsfeld), zur Produktion derselben Warensorte, unter dem Kommando desselben Kapitalisten, bildet historisch und begrifflich den Ausgangspunkt der kapitalistischen Produktion.	ch13_clean.en-ch13_clean.de
With regard to the mode of production itself, manufacture [Manufaktur] can hardly be distinguished, in its earliest stages, from the handicraft trades [Handwerksindustrie] of the guilds, except by the greater number of workers simultaneously employed by the same individual capital.	Mit Bezug auf die Produktionsweise selbst unterscheidet sich z.B. die Manufaktur in ihren Anfängen kaum anders von der zünftigen Handwerksindustrie als durch die größere Zahl der gleichzeitig von demselben Kapital beschäftigten Arbeiter.	ch13_clean.en-ch13_clean.de
It is merely an enlargement of the workshop of the master craftsman of the guilds.	Die Werkstatt des Zunftmeisters ist nur erweitert.	ch13_clean.en-ch13_clean.de
At first, then, the difference is purely quantitative.	Der Unterschied ist also zunächst bloß quantitativ.	ch13_clean.en-ch13_clean.de
We have shown that the surplus-value produced by a given capital is equal to the surplus-value produced by each worker multiplied by the number of workers simultaneously employed.	Man sah, daß die Masse des Mehrwerts, welche ein gegebnes Kapital produziert, gleich dem Mehrwert, den der einzelne Arbeiter liefert, multipliziert mit der Anzahl der gleichzeitig beschäftigten Arbeiter.	ch13_clean.en-ch13_clean.de
The number of workers does not in itself affect either the rate of surplus-value or the degree of exploitation of labour-power, and, with regard to the production of commodity-values in general, every qualitative alteration in the labour process appears to be irrelevant.	Diese Anzahl ändert an und für sich nichts an der Rate des Mehrwerts oder dem Exploitationsgrad der Arbeitskraft, und mit Bezug auf die Produktion von Warenwert überhaupt scheint jede qualitative Verändrung des Arbeitsprozesses gleichgültig. Es folgt dies aus der Natur des Werts.	ch13_clean.en-ch13_clean.de
If a working day of 12 hours is objectified in 6 shillings, 1, working days of 12 hours will be objectified in 1, times 6 shillings.	Vergegenständlicht sich ein zwölfstündiger Arbeitstag in 6 sh., so 1.200 solcher Arbeitstage in 6 sh. × 1.200.	ch13_clean.en-ch13_clean.de
In one case 12 × 1, working-hours are incorporated in the products, and in the other case 12 working-hours.	In dem einen Fall haben sich 12 × 1.200, in dem andren 12 Arbeitsstunden den Produkten einverleibt.	ch13_clean.en-ch13_clean.de
In the production of value a number of workers merely rank as so many individual workers, and it therefore makes no difference in the value produced whether the 1, men work separately or united under the command of one capitalist.	In der Wertproduktion zählen viele immer nur als viele einzelne. Für die Wertproduktion macht es also keinen Unterschied, ob 1.200 Arbeiter vereinzelt produzieren oder vereint unter dem Kommando desselben Kapitals.	ch13_clean.en-ch13_clean.de
Nevertheless, within certain limits, a modification does take place.	Indes findet doch innerhalb gewisser Grenzen eine Modifikation statt.	ch13_clean.en-ch13_clean.de
The labour objectified in value is labour of an average social quality, it is an expression of average labour-power.	In Wert vergegenständlichte Arbeit ist Arbeit von gesellschaftlicher Durch- schnittsqualität, also die Äußerung einer durchschnittlichen Arbeitskraft.	ch13_clean.en-ch13_clean.de
Any average magnitude, however, is merely the average of a number of separate magnitudes all of one kind, but differing in quantity. In every industry, each individual worker differs from the average worker.	Eine Durchschnittsgröße existiert aber immer nur als Durchschnitt vieler verschiedner Größenindividuen derselben Art. In jedem Industriezweig weicht der individuelle Arbeiter, Peter oder Paul, mehr oder minder vom Durchschnittsarbeiter ab.	ch13_clean.en-ch13_clean.de
These individual differences, or ‘errors’ as they are called in mathematics, compensate each other and vanish whenever a certain minimum number of workers are employed together.	Diese individuellen Abweichungen, welche mathematisch "Fehler" heißen, kompensieren sich und verschwinden, sobald man eine größere Anzahl Arbeiter zusammennimmt.	ch13_clean.en-ch13_clean.de
Edmund Burke, that famous sophist and sycophant, goes so far as to make the following assertion, based on his practical observations as a farmer: that ‘in so small a platoon’ as that of five farm labourers, all individual differences in the labour vanish, and that consequently any given five adult farm labourers taken together will do as much work in the same time as any other five.	Der berühmte Sophist und Sykophant Edmund Burke will aus seinen praktischen Erfahrungen als Pächter sogar wissen, daß schon "für ein so geringes Peloton" wie 5 Ackerknechte aller individuelle Unterschied der Arbeit verschwindet, also die ersten besten im Mannesalter befindlichen fünf englischen Ackerknechte zusammengenommen in derselben Zeit grad soviel Arbeit verrichten als beliebige andre fünf englische Ackerknechte.	ch13_clean.en-ch13_clean.de
But however that may be, it is clear that the collective working day of a large number of workers employed simultaneously, divided by the number of these workers, gives one day of average social labour.	Wie dem auch sei, es ist klar, daß der Gesamtarbeitstag einer größren Anzahl gleichzeitig beschäftigter Arbeiter, dividiert durch die Anzahl der Arbeiter, an und für sich ein Tag gesellschaftlicher Durchschnittsarbeit ist.	ch13_clean.en-ch13_clean.de
For example, let the working day of each individual be 12 hours.	Der Arbeitstag des einzelnen sei z.B. zwölfstündig.	ch13_clean.en-ch13_clean.de
Then the collective working day of twelve men simultaneously employed consists of 144 hours; and although the labour of each of the dozen men may diverge more or less from average social labour, each of them requiring a different amount of time for the same operation, the working day of every one possesses the qualities of an average social working day, because it forms one-twelfth of the collective working day of 144 hours.	So bildet der Arbeitstag von 12 gleichzeitig beschäftigten Arbeitern einen Gesamtarbeitstag von 144 Stunden, und obgleich die Arbeit eines jeden des Dutzend mehr oder minder von der gesellschaftlichen Durchschnittsarbeit abweichen, der einzelne daher etwas mehr oder weniger Zeit zu derselben Verrichtung brauchen mag, besitzt der Arbeitstag jedes einzelnen als ein Zwölftel des Gesamtarbeitstags von 144 Stunden die gesellschaftliche Durchschnittsqualität.	ch13_clean.en-ch13_clean.de
From the point of view of the capitalist who employs these twelve men, the working day is that of the whole dozen.	Für den Kapitalisten aber, der ein Dutzend beschäftigt, existiert der Arbeitstag als Gesamtarbeitstag des Dutzend.	ch13_clean.en-ch13_clean.de
Each individual man’s day is an aliquot part of the collective working day, no matter whether the twelve men help each other in their work, or whether the connection between their operations consists merely in the fact that the men are all working for the same capitalist.	Der Arbeitstag jedes einzelnen existiert als aliquoter Teil des Gesamtarbeitstags, ganz unabhängig davon, ob die zwölf einander in die Hand arbeiten oder ob der ganze Zusammenhang ihrer Arbeiten nur darin besteht, daß sie für denselben Kapitalisten arbeiten.	ch13_clean.en-ch13_clean.de
But if the twelve men are employed in six pairs, by six different ‘small masters’, it will be entirely a matter of chance whether each of these masters produces the same value, and consequently whether he secures the general rate of surplus-value.	Werden dagegen von den 12 Arbeitern je zwei von einem kleinen Meister beschäftigt, so wird es zufällig, ob jeder einzelne Meister dieselbe Wertmasse produziert und daher die allgemeine Rate des Mehrwerts realisiert.	ch13_clean.en-ch13_clean.de
Divergences would occur in individual cases.	Es fänden individuelle Abweichungen statt.	ch13_clean.en-ch13_clean.de
If one worker required considerably more time for the production of a commodity than was socially necessary, the duration of the necessary labour-time would, in his case, diverge significantly from the labour-time socially necessary, the average labour-time. His labour would therefore not count as average labour, and his labour-power would not count as average labour-power.	Verbrauchte ein Arbeiter bedeutend mehr Zeit in der Produktion einer Ware, als gesellschaftlich erheischt ist, wiche die für ihn individuell notwendige Arbeitszeit bedeutend ab von der gesellschaftlich notwendigen oder der Durchschnittsarbeitszeit, so gälte seine Arbeit nicht als Durchschnittsarbeit, seine Arbeitskraft nicht als durchschnittliche Arbeitskraft.	ch13_clean.en-ch13_clean.de
It would either be unsaleable, or saleable only at less than the average value of labour-power.	Sie verkaufte sich gar nicht oder nur unter dem Durchschnittswert der Arbeitskraft.	ch13_clean.en-ch13_clean.de
A fixed minimum of efficiency in all labour is therefore assumed, and we shall see later on that capitalist production provides the means of fixing this minimum.	Ein bestimmtes Minimum der Arbeitsfertigkeit ist also vorausgesetzt, und wir werden später sehn, daß die kapitalistische Produktion Mittel findet, dies Minimum zu messen.	ch13_clean.en-ch13_clean.de
Nevertheless, this minimum diverges from the average, although on the other hand the capitalist has to pay the average value of labour-power.	Nichtsdestoweniger weicht das Minimum vom Durchschnitt ab, obgleich auf der andren Seite der Durchschnittswert der Arbeitskraft gezahlt werden muß.	ch13_clean.en-ch13_clean.de
Of the six small masters, then, one would squeeze out more than the average rate of surplus-value, another less.	Von den sechs Kleinmeistern würde der eine daher mehr, der andre weniger als die allgemeine Rate des Mehrwerts herausschlagen.	ch13_clean.en-ch13_clean.de
The inequalities would cancel out for the society as a whole, but not for the individual masters.	Die Ungleichheiten würden sich für die Gesellschaft kompensieren, aber nicht für den einzelnen Meister.	ch13_clean.en-ch13_clean.de
The law of valorization therefore comes fully into its own for the individual producer only when he produces as a capitalist and employs a number of workers simultaneously, i.e. when from the outset he sets in motion labour of a socially average character.	Das Gesetz der Verwertung überhaupt realisiert sich also für den einzelnen Produzenten erst vollständig, sobald er als Kapitalist produziert, viele Arbeiter gleichzeitig anwendet, also von vornherein gesellschaftliche Durchschnittsarbeit in Bewegung setzt.	ch13_clean.en-ch13_clean.de
Even without an alteration in the method of work, the simultaneous employment of a large number of workers produces a revolution in the objective conditions of the labour process.	Auch bei gleichbleibender Arbeitsweise bewirkt die gleichzeitige Anwendung einer größren Arbeiteranzahl eine Revolution in den gegenständlichen Bedingungen des Arbeitsprozesses.	ch13_clean.en-ch13_clean.de
The buildings where the workers actually work, the store-houses for the raw material, the implements and utensils they use simultaneously or in turns; in short, a portion of the means of production, are now consumed jointly in the labour process.	Baulichkeiten, worin viele arbeiten, Lager für Rohmaterial usw., Gefäße, Instrumente, Apparate usw., die vielen gleichzeitig oder abwechselnd dienen, kurz, ein Teil der Produktionsmittel wird jetzt gemeinsam im Arbeitsprozeß konsumiert.	ch13_clean.en-ch13_clean.de
On the one hand, the exchange-value of these means of production is not increased; for the exchange-value of a commodity is not raised by any increase in the exploitation of its use-value.	Einerseits wird der Tauschwert von Waren, also auch von Produktionsmitteln, durchaus nicht erhöht durch irgendwelche erhöhte Ausbeutung ihres Gebrauchswerts.	ch13_clean.en-ch13_clean.de
On the other hand, they are used in common, and therefore on a larger scale than before.	Andrerseits wächst der Maßstab der gemeinsam gebrauchten Produktionsmittel.	ch13_clean.en-ch13_clean.de
A room where twenty weavers work at twenty looms must be larger than the room of a single weaver with two assistants.	Ein Zimmer, worin 20 Weber mit ihren 20 Webstühlen arbeiten, muß weiter gestreckt sein als das Zimmer eines unabhängigen Webers mit zwei Gesellen.	ch13_clean.en-ch13_clean.de
But it costs less labour to build one workshop for twenty persons than to build ten to accommodate two weavers each; thus the value of the means of production concentrated for use in common on a large scale does not increase in direct proportion to their extent and useful effect.	Aber die Produktion einer Werkstatt für 20 Personen kostet weniger Arbeit als die von 10 Werkstätten für je zwei Personen, und so wächst überhaupt der Wert massenweise konzentrierter und gemeinsamer Produktionsmittel nicht verhältnismäßig mit ihrem Umfang und ihrem Nutzeffekt.	ch13_clean.en-ch13_clean.de
When consumed in common, they give up a smaller part of their value to each single product; partly because the total value they part with is spread over a greater number of products, and partly because their value, although it is greater in absolute terms, is relatively less, looked at from the point of view of their sphere of action, than the value of separate means of production.	Gemeinsam vernutzte Produktionsmittel geben geringren Wertbestandteil an das einzelne Produkt ab, teils weil der Gesamtwert, den sie abgeben, sich gleichzeitig auf eine größre Produktenmasse verteilt, teils weil sie, im Vergleich zu vereinzelten Produktionsmitteln, zwar mit absolut größrem, aber, ihren Wirkungskreis betrachtet, mit relativ kleinrem Wert in den Produktionsprozeß eintreten.	ch13_clean.en-ch13_clean.de
Owing to this, the value of a part of the constant capital falls, and, in proportion to the size of this fall, the total value of the commodity also falls.	Damit sinkt ein Wertbestandteil des konstanten Kapitals, also proportionell zu seiner Größe auch der Gesamtwert der Ware.	ch13_clean.en-ch13_clean.de
The effect is the same as if the means of production had cost less.	Die Wirkung ist dieselbe, als ob die Produktionsmittel der Ware wohlfeiler produziert würden.	ch13_clean.en-ch13_clean.de
This economy in the application of the means of production arises entirely out of their joint consumption in the labour process by many workers.	Diese Ökonomie in der Anwendung der Produktionsmittel entspringt nur aus ihrem gemeinsamen Konsum im Arbeitsprozeß vieler.	ch13_clean.en-ch13_clean.de
Moreover, this character of being necessary conditions of social labour, a character that distinguishes them from the dispersed and relatively more costly means of production of isolated, independent workers or small masters, is maintained even when the numerous workers assembled together do not assist each other but merely work side by side.	Und sie erhalten diesen Charakter als Bedingungen gesellschaftlicher Arbeit oder gesellschaftliche Bedingungen der Arbeit im Unterschied von den zersplitterten und relativ kostspieligen Produktionsmitteln vereinzelter selbständiger Arbeiter oder Kleinmeister, selbst wenn die vielen nur räumlich zusammen, nicht miteinander arbeiten.	ch13_clean.en-ch13_clean.de
A portion of the instruments of labour acquires this social character before the labour process itself does so.	Ein Teil der Arbeitsmittel erwirbt diesen gesellschaftlichen Charakter, bevor ihn der Arbeitsprozeß selbst erwirbt.	ch13_clean.en-ch13_clean.de
Economy in the use of the means of production has to be considered from two points of view.	Die Ökonomie der Produktionsmittel ist überhaupt von doppeltem Gesichtspunkt zu betrachten.	ch13_clean.en-ch13_clean.de
Firstly, in so far as it cheapens commodities, and thereby brings about a fall in the value of labour-power.	Das eine Mal, soweit sie Waren verwohlfeilert und dadurch den Wert der Arbeitskraft senkt.	ch13_clean.en-ch13_clean.de
Secondly, in so far as it alters the ratio of surplus-value to the total capital advanced, i.e. to the sum of the values of its constant and variable components.	Das andre Mal, soweit sie das Verhältnis des Mehrwerts zum vorgeschoßnen Gesamtkapital, d.h. zur Wertsumme seiner konstanten und variablen Bestandteile, verändert.	ch13_clean.en-ch13_clean.de
The latter aspect will not be considered until the first section of Volume 3 of this work. * In order that we may treat them in their proper context, many other points relevant here have also been relegated to the third volume.	Der letztre Punkt wird erst im ersten Abschnitt des Dritten Buchs dieses Werks erörtert, wohin wir des Zusammenhangs wegen auch manches schon hierher Gehörige verweisen.	ch13_clean.en-ch13_clean.de
The particular course taken by our analysis forces this tearing apart of the object under investigation; this corresponds also to the spirit of capitalist production.	Der Gang der Analyse gebietet diese Zerreißung des Gegenstands, die zugleich dem Geist der kapitalistischen Produktion entspricht.	ch13_clean.en-ch13_clean.de
Here the worker finds the instruments of labour existing independently of him as another man’s property, hence economy in their use appears, from his standpoint, to be a separate operation, one that does not concern him, and therefore has no connection with the methods by which his own personal productivity is increased.	Da hier nämlich die Arbeitsbedingungen dem Arbeiter selbständig gegenübertreten, erscheint auch ihre Ökonomie als eine besondre Operation, die ihn nichts angeht und daher getrennt ist von den Methoden, welche seine persönliche Produktivität erhöhen.	ch13_clean.en-ch13_clean.de
When numerous workers work together side by side in accordance with a plan, whether in the same process, or in different but connected processes, this form of labour is called co-operation.	Die Form der Arbeit vieler, die in demselben Produktionsprozeß oder in verschiednen, aber zusammenhängenden Produktionsprozessen planmäßig neben- und miteinander arbeiten, heißt Kooperation.	ch13_clean.en-ch13_clean.de
Just as the offensive power of a squadron of cavalry, or the defensive power of an infantry regiment, is essentially different from the sum of the offensive or defensive powers of the individual soldiers taken separately, so the sum total of the mechanical forces exerted by isolated workers differs from the social force that is developed when many hands co-operate in the same undivided operation, such as raising a heavy weight, turning a winch or getting an obstacle out of the way.	Wie die Angriffskraft einer Kavallerieschwadron oder die Widerstandskraft eines Infanterieregiments wesentlich verschieden ist von der Summe der von jedem Kavalleristen und Infanteristen vereinzelt entwickelten Angriffs- und Widerstandskräfte, so die mechanische Kraftsumme vereinzelter Arbeiter von der gesellschaftlichen Kraftpotenz, die sich entwickelt, wenn viele Hände gleichzeitig in derselben ungeteilten Operation zusammenwirken, z.B. wenn es gilt, eine Last zu heben, eine Kurbel zu drehn oder einen Widerstand aus dem Weg zu räumen.	ch13_clean.en-ch13_clean.de
In such cases the effect of the combined labour could either not be produced at all by isolated individual labour, or it could be produced only by a great expenditure of time, or on a very dwarf-like scale.	Die Wirkung der kombinierten Arbeit könnte hier von der vereinzelten gar nicht oder nur in viel längren Zeiträumen oder nur auf einem Zwergmaßstab hervorgebracht werden.	ch13_clean.en-ch13_clean.de
Not only do we have here an increase in the productive power of the individual, by means of co-operation, but the creation of a new productive power, which is intrinsically a collective one.	Es handelt sich hier nicht nur um Erhöhung der individuellen Produktivkraft durch die Kooperation, sondern um die Schöpfung einer Produktivkraft, die an und für sich Massenkraft sein muß.	ch13_clean.en-ch13_clean.de
Apart from the new power that arises from the fusion of many forces into a single force, mere social contact begets in most industries a rivalry and a stimulation of the ‘animal spirits’, which heightens the efficiency of each individual worker. This is why a dozen people working together will produce far more, in their collective working day of 144 hours than twelve isolated men each working for 12 hours, and far more than one man who works 12 days in succession.	(11a) Abgesehn von der neuen Kraftpotenz, die aus der Verschmelzung vieler Kräfte in eine Gesamtkraft entspringt, erzeugt bei den meisten produktiven Arbeiten der bloße gesellschaftliche Kontakt einen Wetteifer und eine eigne Erregung der Lebensgeister (animal spirits), welche die individuelle Leistungsfähigkeit der einzelnen erhöhen, so daß ein Dutzend Personen zusammen in einem gleichzeitigen Arbeitstag von 144 Stunden ein viel größres Gesamtprodukt liefern als zwölf vereinzelte Arbeiter, von denen jeder 12 Stunden, oder als ein Arbeiter, der 12 Tage nacheinander arbeitet.	ch13_clean.en-ch13_clean.de
This originates from the fact that man, if not as Aristotle thought a political animal, is at all events a social animal.	Dies rührt daher, daß der Mensch von Natur, wenn nicht, wie Aristoteles meint, ein politisches , jedenfalls ein gesellschaftliches Tier ist.	ch13_clean.en-ch13_clean.de
Although a number of men may be simultaneously occupied together on the same work, or the same kind of work, the labour of each, as a part of the labour of all, may correspond to a distinct phase of the labour process; and as a result of the system of co-operation, the object of labour passes through the phases of the process more quickly than before.	Obgleich viele dasselbe oder Gleichartiges gleichzeitig miteinander verrichten, kann die individuelle Arbeit eines jeden dennoch als Teil der Gesamtarbeit verschiedne Phasen des Arbeitsprozesses selbst darstellen, die der Arbeitsgegenstand, infolge der Kooperation, rascher durchläuft.	ch13_clean.en-ch13_clean.de
For instance, if a dozen masons place themselves in a row, so as to pass stones from the foot of a ladder to its summit, each of them does the same thing; and yet their separate acts form connected parts of one total operation; these acts are particular phases which each stone must go through, and the stones are thus carried up more quickly by the twenty-four hands of the row of men than they could be if each man went separately up and down the ladder with his load.	Z.B. wenn Maurer eine Reihe von Händen bilden, um Bausteine vom Fuß eines Gestells bis zu seiner Spitze zu befördern, tut jeder von ihnen dasselbe, aber dennoch bilden die einzelnen Verrichtungen kontinuierliche Teile einer Gesamtverrichtung, besondre Phasen, die jeder Baustein im Arbeitsprozeß durchlaufen muß und wodurch ihn etwa die 24 Hände des Gesamtarbeiters rascher fördern als die zwei Hände jedes einzelnen Arbeiters, der das Gerüst auf- und abstiege.	ch13_clean.en-ch13_clean.de
The object of labour is carried over the same distance in a shorter time.	Der Arbeitsgegenstand durchläuft denselben Raum in kürzerer Zeit.	ch13_clean.en-ch13_clean.de
Again, a combination of labour occurs whenever a building, for instance, is taken in hand on different sides simultaneously; although here too the co-operating masons are doing the same work, or the same kind of work.	Andrerseits findet Kombination der Arbeit statt, wenn ein Bau z.B. von verschiednen Seiten gleichzeitig angegriffen wird, obgleich die Kooperierenden dasselbe oder Gleichartiges tun.	ch13_clean.en-ch13_clean.de
The twelve masons, in their collective working day of 144 hours, make much more progress with the building than one mason could make working for 12 days, or 144 hours. The reason for this is that a body of men working together have hands and eyes both in front and behind, and can be said to be to a certain extent omnipresent.	Der kombinierte Arbeitstag von 144 Stunden, der den Arbeitsgegenstand vielseitig im Raum angreift, weil der kombinierte Arbeiter oder Gesamtarbeiter vorn und hinten Augen und Hände hat und in gewissem Grad Allgegenwart besitzt, fördert das Gesamtprodukt rascher als 12 zwölfstündige Arbeitstage mehr oder minder vereinzelter Arbeiter, die ihr Werk einseitiger angreifen müssen.	ch13_clean.en-ch13_clean.de
The various parts of the product come to fruition simultaneously.	In derselben Zeit reifen verschiedne Raumteile des Produkts.	ch13_clean.en-ch13_clean.de
In the above instances we stressed the point that the men do the same work, or the same kind of work, because this, the most simple form of common labour, plays a great part in co-operation, even at its most fully developed stage.	Wir betonten, daß die vielen, die einander ergänzen, dasselbe oder Gleichartiges tun, weil diese einfachste Form gemeinsamer Arbeit auch in der aus- gebildetsten Gestalt der Kooperation eine große Rolle spielt.	ch13_clean.en-ch13_clean.de
If the labour process is complicated, then the sheer number of the co-operators permits the apportionment of various operations to different hands, and consequently their simultaneous performance. The time necessary for the completion of the whole work is thereby shortened.	Ist der Arbeitsprozeß kompliziert, so erlaubt die bloße Masse der Zusammenarbeitenden, die verschiednen Operationen unter verschiedne Hände zu verteilen, daher gleichzeitig zu verrichten und dadurch die zur Herstellung des Gesamtprodukts nötig Arbeitszeit zu verkürzen.	ch13_clean.en-ch13_clean.de
In many industries there are critical moments, that is to say periods of time determined by the nature of the labour process itself, during which certain definite results must be obtained.	In vielen Produktionszweigen gibt es kritische Momente, d.h. durch die Natur des Arbeitsprozesses selbst bestimmte Zeitepochen, während deren bestimmte Arbeitsresultate erzielt werden müssen.	ch13_clean.en-ch13_clean.de
For instance, if a flock of sheep has to be shorn or a field of wheat has to be cut and harvested, the quantity and quality of the product depends on the initiation and the completion of the work at certain definite points in time.	Soll z.B. eine Herde Schafe geschoren oder eine Morgenanzahl Kornland gemäht und geherbstet werden, so hängt Quantität und Qualität des Produkts davon ab, daß die Operation zu einer gewissen Zeit begonnen und zu einer gewissen Zeit beendet wird.	ch13_clean.en-ch13_clean.de
In these cases, the time the labour process may take is laid down in advance, just as it is in fishing for herrings.	Der Zeitraum, den der Arbeitsprozeß einnehmen darf, ist hier vorgeschrieben, wie etwa beim Heringsfang.	ch13_clean.en-ch13_clean.de
A single person cannot carve a working day of more than say, 12 hours, out of the natural day, but 100 men co-operating can extend the working day to 1, hours.	Der einzelne kann aus einem Tag nur einen Arbeitstag herausschneiden, sage von 12 Stunden, aber die Kooperation von 100 z.B. erweitert einen zwölfstündigen Tag zu einem Arbeitstag von 1.200 Stunden.	ch13_clean.en-ch13_clean.de
The shortness of the time allowed for the work is compensated for by the large mass of labour thrown into the field of production at the decisive moment.	Die Kürze der Arbeitsfrist wird kompensiert durch die Größe der Arbeitsmasse, die im entscheidenden Augenblick auf das Produktionsfeld geworfen wird.	ch13_clean.en-ch13_clean.de
The completion of the task within the proper time depends on the simultaneous application of numerous combined working days; the amount of useful effect depends on the number of workers; this number, however, is always smaller than the number of isolated workers that would be required to do the same amount of work in the same period.	Die rechtzeitige Wirkung hängt hier ab von der gleichzeitigen Anwendung vieler kombinierten Arbeitstage, der Umfang des Nutzeffekts von der Arbeiteranzahl, die jedoch stets kleiner bleibt als die Anzahl der Arbeiter, die vereinzelt in demselben Zeitraum denselben Wirkungsraum ausfüllen würden.	ch13_clean.en-ch13_clean.de
It is owing to the absence of this kind of co-operation that a great quantity of corn is wasted every year in the western part of the United States, and the same thing happens to cotton in those eastern parts of India where English rule has destroyed the old communities.	Es ist der Mangel dieser Kooperation, wodurch im Westen der Vereinigten Staaten eine Masse Korn und in den Teilen Ostindiens, wo englische Herrschaft das alte Gemeinwesen zerstört hat, eine Masse Baumwolle jährlich verwüstet wird.	ch13_clean.en-ch13_clean.de
On the one hand, co-operation allows work to be carried on over a large area; for certain labour processes, therefore, it is required simply by the physical constitution of the object of labour. Examples of this are the draining of marshes, the construction of dykes, irrigation, and the building of canals, roads and railways. On the other hand, while extending the scale of production it renders possible a relative contraction of its arena.	Auf der einen Seite erlaubt die Kooperation, die Raumsphäre der Arbeit auszurecken, und wird daher für gewisse Arbeitsprozesse schon durch den räumlichen Zusammenhang des Arbeitsgegenstandes erheischt, wie bei Trockenlegung von Land, Eindämmung, Bewäßrung, Kanal-, Straßen-, Eisenbahnbauten usw. Andrerseits ermöglicht sie, verhältnismäßig zur Stufenleiter der Produktion, räumliche Verengung des Produktionsgebiets.	ch13_clean.en-ch13_clean.de
This simultaneous restriction of space and extension of effectiveness, which allows a large number of incidental expenses (faux frais*) to be spared, results from the massing together of workers and of various labour processes, and from the concentration of the means of production.	Diese Beschränkung der Raumsphäre der Arbeit bei gleichzeitiger Ausdehnung ihrer Wirkungssphäre, wodurch eine Masse falscher Kosten (faux frais) erspart werden, entspringt aus der Konglomeration der Arbeiter, dem Zusammenrücken verschiedner Arbeitsprozesse und der Konzentration der Produktionsmittel.	ch13_clean.en-ch13_clean.de
The combined working day produces a greater quantity of use-values than an equal sum of isolated working days, and consequently diminishes the labour-time necessary for the production of a given useful effect.	Verglichen mit einer gleich großen Summe vereinzelter individueller Arbeitstage, produziert der kombinierte Arbeitstag größre Massen von Gebrauchswert und vermindert daher die zur Produktion eines bestimmten Nutzeffekts nötig Arbeitszeit.	ch13_clean.en-ch13_clean.de
Whether the combined working day, in a given case, acquires this increased productivity because it heightens the mechanical force of labour, or extends its sphere of action over a greater space, or contracts the field of production relatively to the scale of production, or at the critical moment sets large masses of labour to work, or excites rivalry between individuals and raises their animal spirits, or impresses on the similar operations carried on by a number of men the stamp of continuity and many-sidedness, or performs different operations simultaneously, or economizes the means of production by use in common, or lends to individual labour the character of average social labour – whichever of these is the cause of the increase, the special productive power of the combined working day is, under all circumstances, the social productive power of labour, or the productive power of social labour.	Ob er im gegebnen Fall diese gesteigerte Produktivkraft erhält, weil er die mechanische Kraftpotenz der Arbeit erhöht oder ihre räumliche Wirkungssphäre ausdehnt oder das räumliche Produktionsfeld im Verhältnis zur Stufenleiter der Produktion verengt oder im kritischen Moment viel Arbeit in wenig Zeit flüssig macht oder den Wetteifer der einzelnen erregt und ihre Lebensgeister spannt oder den gleichartigen Verrichtungen vieler den Stempel der Kontinuität und Vielseitigkeit aufdrückt, oder verschiedne Operationen gleichzeitig verrichtet oder die Produktionsmittel durch ihren gemeinschaftlichen Gebrauch öko- nomisiert oder der individuellen Arbeit den Charakter gesellschaftlicher Durchschnittsarbeit verleiht, unter allen Umständen ist die spezifische Produktivkraft des kombinierten Arbeitstags gesellschaftliche Produktivkraft der Arbeit oder Produktivkraft gesellschaftlicher Arbeit.	ch13_clean.en-ch13_clean.de
This power arises from co-operation itself.	Sie entspringt aus der Kooperation selbst.	ch13_clean.en-ch13_clean.de
When the worker co-operates in a planned way with others, he strips off the fetters of his individuality, and develops the capabilities of his species.	Im planmäßigen Zusammenwirken mit andern streift der Arbeiter seine individuellen Schranken ab und entwickelt sein Gattungsvermögen.	ch13_clean.en-ch13_clean.de
As a general rule, workers cannot co-operate without being brought together: their assembly in one place is a necessary condition for their co-operation. Hence wage-labourers cannot co-operate unless they are employed simultaneously by the same capital, the same capitalist, and therefore unless their labour-powers are bought simultaneously by him.	Wenn Arbeiter überhaupt nicht unmittelbar zusammenwirken können, ohne zusammen zu sein, ihre Konglomeration auf bestimmtem Raum daher Bedingung ihrer Kooperation ist, können Lohnarbeiter nicht kooperieren, ohne daß dasselbe Kapital, derselbe Kapitalist sie gleichzeitig anwendet, also ihre Arbeitskräfte gleichzeitig kauft.	ch13_clean.en-ch13_clean.de
The total value of these labour-powers, or the amount of the wages of these workers for a day or a week, as the case may be, must be ready in the pocket of the capitalist before the workers themselves are ready to start the process of production.	Der Gesamtwert dieser Arbeitskräfte oder die Lohnsumme der Arbeiter für den Tag, die Woche usw., muß daher in der Tasche des Kapitalisten vereint sein, bevor die Arbeitskräfte selbst im Produktionsprozeß vereint werden.	ch13_clean.en-ch13_clean.de
The payment of 300 workers at once, even though only for one day, requires a greater outlay of capital than the payment of a smaller number of men, week by week, during a whole year.	Zahlung von 300 Arbeitern auf einmal, auch nur für einen Tag, bedingt mehr Kapitalauslage als Zahlung weniger Arbeiter Woche für Woche, während des ganzen Jahrs.	ch13_clean.en-ch13_clean.de
Hence the number of the workers that co-operate, or the scale of co-operation, depends in the first instance on the amount of capital that the individual capitalist can spare for the purchase of labour-power; in other words, on the extent to which a single capitalist has command over the means of subsistence of a number of workers.	Die Anzahl der kooperierenden Arbeiter, oder die Stufenleiter der Kooperation, hängt also zunächst ab von der Größe des Kapitals, das der einzelne Kapitalist im Ankauf von Arbeitskraft auslegen kann, d.h. von dem Umfang, worin je ein Kapitalist über die Lebensmittel vieler Arbeiter verfügt.	ch13_clean.en-ch13_clean.de
And as with variable capital, so also with constant capital.	Und wie mit dem variablen, verhält es sich mit dem konstanten Kapital.	ch13_clean.en-ch13_clean.de
For example, the outlay on raw material is thirty times as great for the capitalist who employs 300 men as it is for each of the thirty capitalists who employ ten men.	Die Auslage für Rohmaterial z.B. ist 30mal größer für den einen Kapitalisten, der 300, als für jeden der 30 Kapitalisten, der je 10 Arbeiter beschäftigt.	ch13_clean.en-ch13_clean.de
The value and quantity of the instruments of labour used in common does not, it is true, increase at the same rate as the number of workers, but it does increase very considerably.	Wertumfang und Stoffmasse der gemeinsam benutzten Arbeitsmittel wachsen zwar nicht in demselben Grad wie die beschäftigte Arbeiteranzahl, aber sie wachsen beträchtlich.	ch13_clean.en-ch13_clean.de
Hence, concentration of large masses of the means of production in the hands of individual capitalists is a material condition for the co-operation of wage-labourers, and the extent of co-operation, or the scale of production, depends on the extent of this concentration.	Konzentration größrer Massen von Produktionsmitteln in der Hand einzelner Kapitalisten ist also materielle Bedingung für die Kooperation von Lohnarbeitern, und der Umfang der Kooperation, oder die Stufenleiter der Produktion, hängt ab vom Umfang dieser Konzentration.	ch13_clean.en-ch13_clean.de
We saw in a former chapter that a certain minimum amount of capital was necessary in order that the number of workers simultaneously employed, and consequently the amount of surplus-value produced, might suffice to liberate the employer himself from manual labour, to convert him from a small master into a capitalist, and thus formally to establish the capital-relation.	Ursprünglich erschien eine gewisse Minimalgröße des individuellen Kapitals notwendig, damit die Anzahl der gleichzeitig ausgebeuteten Arbeiter, daher die Masse des produzierten Mehrwerts hinreiche, den Arbeitsanwender selbst von der Handarbeit zu entbinden, aus einem Kleinmeister einen Kapitalisten zu machen und so das Kapitalverhältnis formell herzustellen.	ch13_clean.en-ch13_clean.de
We now see that a certain minimum amount is a material condition for the conversion of numerous isolated and independent processes into one combined social process.	Sie erscheint jetzt als materielle Bedingung für die Verwandlung vieler zersplitterter und voneinander unabhängiger individueller Arbeitsprozesse in einen kombinierten gesellschaftlichen Arbeitsprozeß.	ch13_clean.en-ch13_clean.de
We also saw that, at first, the subjection of labour to capital was only a formal result of the fact that the worker, instead of working for himself, works for, and consequently under, the capitalist.	Ebenso erschien ursprünglich das Kommando des Kapitals über die Arbeit nur als formelle Folge davon, daß der Arbeiter statt für sich, für den Kapitalisten und daher unter dem Kapitalisten arbeitet.	ch13_clean.en-ch13_clean.de
Through the co-operation of numerous wage-labourers, the command of capital develops into a requirement for carrying on the labour process itself, into a real condition of production.	Mit der Kooperation vieler Lohnarbeiter entwickelt sich das Kommando des Kapitals zum Erheischnis für Ausführung des Arbeitsprozesses selbst, zu einer wirklichen Produktionsbedingung.	ch13_clean.en-ch13_clean.de
That a capitalist should command in the field of production is now as indispensable as that a general should command on the field of battle.	Der Befehl des Kapitalisten auf dem Produktionsfeld wird jetzt so unentbehrlich wie der Befehl des Generals auf dem Schlachtfeld.	ch13_clean.en-ch13_clean.de
All directly social or communal labour on a large scale requires, to a greater or lesser degree, a directing authority, in order to secure the harmonious co-operation of the activities of individuals, and to perform the general functions that have their origin in the motion of the total productive organism, as distinguished from the motion of its separate organs.	Alle unmittelbar gesellschaftliche oder gemeinschaftliche Arbeit auf größrem Maßstab bedarf mehr oder minder einer Direktion, welche die Harmonie der individuellen Tätigkeiten vermittelt und die allgemeinen Funktionen vollzieht, die aus der Bewegung des produktiven Gesamtkörpers im Unterschied von der Bewegung seiner selbständigen Organe entspringen.	ch13_clean.en-ch13_clean.de
A single violin player is his own conductor: an orchestra requires a separate one.	Ein einzelner Violinspieler dirigiert sich selbst, ein Orchester bedarf des Musikdirektors.	ch13_clean.en-ch13_clean.de
The work of directing, superintending and adjusting becomes one of the functions of capital, from the moment that the labour under capital’s control becomes co-operative.	Diese Funktion der Leitung, Überwachung und Vermittlung, wird zur Funktion des Kapitals, sobald die ihm untergeordnete Arbeit kooperativ wird.	ch13_clean.en-ch13_clean.de
As a specific function of capital, the directing function acquires its own special characteristics.	Als spezifische Funktion des Kapitals erhält die Funktion der Leitung spezifische Charaktermale.	ch13_clean.en-ch13_clean.de
The driving motive and determining purpose of capitalist production is the self-valorization of capital to the greatest possible extent, i.e. the greatest possible production of surplus-value, hence the greatest possible exploitation of labour-power by the capitalist.	Zunächst ist das treibende Motiv und der bestimmende Zweck des kapitalistischen Produktionsprozesses möglichst große Selbstverwertung des Kapitals , d.h. möglichst große Produktion von Mehrwert, also möglichst große Ausbeutung der Arbeitskraft durch den Kapitalisten.	ch13_clean.en-ch13_clean.de
As the number of the co-operating workers increases, so too does their resistance to the domination of capital, and, necessarily, the pressure put on by capital to overcome this resistance.	Mit der Masse der gleichzeitig beschäftigten Arbeiter wächst ihr Widerstand und damit notwendig der Druck des Kapitals zur Bewältigung dieses Widerstands.	ch13_clean.en-ch13_clean.de
The control exercised by the capitalist is not only a special function arising from the nature of the social labour process, and peculiar to that process, but it is at the same time a function of the exploitation of a social labour process, and is consequently conditioned by the unavoidable antagonism between the exploiter and the raw material of his exploitation.	Die Leitung des Kapitalisten ist nicht nur eine aus der Natur des gesellschaftlichen Arbeitsprozesses entspringende und ihm angehörige besondre Funktion, sie ist zugleich Funktion der Ausbeutung eines gesellschaftlichen Arbeitsprozesses und daher bedingt durch den unvermeidlichen Antagonismus zwischen dem Ausbeuter und dem Rohmaterial seiner Ausbeutung.	ch13_clean.en-ch13_clean.de
Similarly, as the means of production extend, the necessity increases for some effective control over the proper application of them, because they confront the wage-labourer as the property of another [fremdes Eigentum].	Ebenso wächst mit dem Umfang der Produktionsmittel, die dem Lohnarbeiter als fremdes Eigentum gegenüberstehn, die Notwendigkeit der Kontrolle über deren sachgemäße Verwendung.	ch13_clean.en-ch13_clean.de
Moreover, the co-operation of wage-labourers is entirely brought about by the capital that employs them.	Die Kooperation der Lohnarbeiter ist ferner bloße Wirkung des Kapitals, das sie gleichzeitig anwendet.	ch13_clean.en-ch13_clean.de
Their unification into one single productive body, and the establishment of a connection between their individual functions, lies outside their competence.		ch13_clean.en-ch13_clean.de
These things are not their own act, but the act of the capital that brings them together and maintains them in that situation.	Der Zusammenhang ihrer Funktionen und ihre Einheit als produktiver Gesamtkörper liegen außer ihnen, im Kapital, das sie zusammenbringt und zusammenhält.	ch13_clean.en-ch13_clean.de
Hence the interconnection between their various labours confronts them, in the realm of ideas, as a plan drawn up by the capitalist, and, in practice, as his authority, as the powerful will of a being outside them, who subjects their activity to his purpose.	Der Zusammenhang ihrer Arbeiten tritt ihnen daher ideel als Plan, praktisch als Autorität des Kapitalisten gegenüber, als Macht eines fremden Willens, der ihr Tun seinem Zweck unterwirft.	ch13_clean.en-ch13_clean.de
If capitalist direction is thus twofold in content, owing to the twofold nature of the process of production which has to be directed – on the one hand a social labour process for the creation of a product, and on the other hand capital’s process of valorization – in form it is purely despotic.	Wenn daher die kapitalistische Leitung dem Inhalt nach zwieschlächtig ist, wegen der Zwieschlächtigkeit des zu leitenden Produktionsprozesses selbst, welcher einerseits gesellschaftlicher Arbeitsprozeß zur Herstellung eines Produkts, andrerseits Verwertungsprozeß des Kapitals, so ist sie der Form nach despotisch.	ch13_clean.en-ch13_clean.de
As co-operation extends its scale, this despotism develops the forms that are peculiar to it.	Mit der Entwicklung der Kooperation auf größrem Maßstab entwickelt dieser Despotismus seine eigentümlichen Formen.	ch13_clean.en-ch13_clean.de
Just as at first the capitalist is relieved from actual labour as soon as his capital has reached that minimum amount with which capitalist production, properly speaking, first begins, so now he hands over the work of direct and constant supervision of the individual workers and groups of workers to a special kind of wage-labourer.	Wie der Kapitalist zunächst entbunden wird von der Handarbeit, sobald sein Kapital jene Minimalgröße erreicht hat, womit die eigentlich kapitalistische Produktion erst beginnt, so tritt er jetzt die Funktion unmittelbarer und fortwährender Beaufsichtigung der einzelnen Arbeiter und Arbeitergruppen selbst wieder ab an eine besondre Sorte von Lohnarbeitern.	ch13_clean.en-ch13_clean.de
An industrial army of workers under the command of a capitalist requires, like a real army, officers (managers) and N.C.O.s (foremen, overseers), who command during the labour process in the name of capital.	Wie eine Armee militärischer, bedarf eine unter dem Kommando desselben Kapitals zusammenwirkende Arbeitermasse industrieller Oberofiziere (Dirigenten, managers) und Unteroffiziere (Arbeitsaufseher, foremen, overlookers, contre-maîtres), die während des Arbeitsprozesses im Namen des Kapitals kommandieren.	ch13_clean.en-ch13_clean.de
The work of supervision becomes their established and exclusive function.	Die Arbeit der Oberaufsicht befestigt sich zu ihrer ausschließlichen Funktion.	ch13_clean.en-ch13_clean.de
When comparing the mode of production of isolated peasants or independent artisans with the plantation economy which rests on slavery, political economists count this labour of superintendence as part of the faux frais de production.	Bei Vergleichung der Produktionsweise unabhängi- ger Bauern oder selbständiger Handwerker mit der auf Sklaverei beruhenden Plantagenwirtschaft zählt der politische Ökonom diese Arbeit der Oberaufsicht zu den faux frais de production.	ch13_clean.en-ch13_clean.de
But when considering the capitalist mode of production they on the contrary identify the function of direction which arises out of the nature of the communal labour process with the function of direction which is made necessary by the capitalist and therefore antagonistic character of that process.	(21a) Bei Betrachtung der kapitalistischen Produktionsweise identifiziert er dagegen die Funktion der Leitung, soweit sie aus der Natur des gemeinschaftlichen Arbeitsprozesses entspringt, mit derselben Funktion, soweit sie durch den kapitalistischen und daher antagonistischen Charakter dieses Prozesses bedingt wird.	ch13_clean.en-ch13_clean.de
It is not because he is a leader of industry that a man is a capitalist; on the contrary, he is a leader of industry because he is a capitalist.	Der Kapitalist ist nicht Kapitalist, weil er industrieller Leiter ist, sondern er wird industrieller Befehlshaber, weil er Kapitalist ist.	ch13_clean.en-ch13_clean.de
The leadership of industry is an attribute of capital, just as in feudal times the functions of general and judge were attributes of landed property.	Der Oberbefehl in der Industrie wird Attribut des Kapitals, wie zur Feudalzeit der Oberbefehl in Krieg und Gericht Attribut des Grundeigentums war.	ch13_clean.en-ch13_clean.de
The worker is the owner of his labour-power until he has finished bargaining for its sale with the capitalist, and he can sell no more than what he has – i.e. his individual, isolated labour-power.	(22a) Eigentümer seiner Arbeitskraft ist der Arbeiter, solange er als Verkäufer derselben mit dem Kapitalist marktet, und er kann nur verkaufen, was er besitzt, seine individuelle, vereinzelte Arbeitskraft.	ch13_clean.en-ch13_clean.de
This relation between capital and labour is in no way altered by the fact that the capitalist, instead of buying the labour-power of one man, buys that of 100, and enters into separate contracts with 100 unconnected men instead of with one.	Dies Verhältnis wird in keiner Weise dadurch verändert, daß der Kapitalist 100 Arbeitskräfte statt einer kauft oder mit 100 voneinander unabhängigen Arbeitern Kontrakte schließt statt mit einem einzelnen.	ch13_clean.en-ch13_clean.de
He can set the 100 men to work, without letting them co-operate.	Er kann die 100 Arbeiter anwenden, ohne sie kooperieren zu lassen.	ch13_clean.en-ch13_clean.de
He pays them the value of 100 independent labour-powers, but he does not pay for the combined labour-power of the 100.	Der Kapitalist zahlt daher den Wert der 100 selbständigen Arbeitskräfte, aber er zahlt nicht die kombinierte Arbeitskraft der Hundert.	ch13_clean.en-ch13_clean.de
Being independent of each other, the workers are isolated. They enter into relations with the capitalist, but not with each other.	Als unabhängige Personen sind die Arbeiter Vereinzelte, die in ein Verhältnis zu demselben Kapital, aber nicht zueinander treten.	ch13_clean.en-ch13_clean.de
Their co-operation only begins with the labour process, but by then they have ceased to belong to themselves.	Ihre Kooperation beginnt erst im Arbeitsprozeß, aber im Arbeitsprozeß haben sie bereits aufgehört, sich selbst zu gehören.	ch13_clean.en-ch13_clean.de
On entering the labour process they are incorporated into capital.	Mit dem Eintritt in denselben sind sie dem Kapital einverleibt.	ch13_clean.en-ch13_clean.de
As co-operators, as members of a working organism, they merely form a particular mode of existence of capital.	Als Kooperierende, als Glieder eines werktätigen Organismus, sind sie selbst nur eine besondre Existenzweise des Kapitals.	ch13_clean.en-ch13_clean.de
Hence the productive power developed by the worker socially is the productive power of capital.	Die Produktivkraft, die der Arbeiter als gesellschaftlicher Arbeiter entwickelt, ist daher Produktivkraft des Kapitals.	ch13_clean.en-ch13_clean.de
The socially productive power of labour develops as a free gift to capital whenever the workers are placed under certain conditions, and it is capital which places them under these conditions.	Die gesellschaftliche Produktivkraft der Arbeit entwickelt sich unentgeltlich, sobald die Arbeiter unter bestimmte Bedingungen gestellt sind, und das Kapital stellt sie unter diese Bedingungen.	ch13_clean.en-ch13_clean.de
Because this power costs capital nothing, while on the other hand it is not developed by the worker until his labour itself belongs to capital, it appears as a power which capital possesses by its nature – a productive power inherent in capital.	Weil die gesellschaftliche Produktivkraft der Arbeit dem Kapital nichts kostet, weil sie andrerseits nicht von dem Arbeiter entwickelt wird, bevor seine Arbeit selbst dem Kapital gehört, erscheint sie als Produktivkraft, die das Kapital von Natur besitzt, als seine immanente Produktivkraft.	ch13_clean.en-ch13_clean.de
The colossal effects of simple co-operation are to be seen in the gigantic structures erected by the ancient Asiatics, Egyptians, Etruscans, etc.	Kolossal zeigt sich die Wirkung der einfachen Kooperation in den Riesenwerken der alten Asiaten, Ägypter, Etrusker usw.	ch13_clean.en-ch13_clean.de
‘It has happened in times past that these Oriental States, after supplying the expenses of their civil and military establishments, have found themselves in possession of a surplus which they could apply to works of magnificence or utility and in the construction of these their command over the hands and arms of almost the entire non-agricultural population has produced stupendous monuments which still indicate their power.	"Es geschah in vergangnen Zeiten, daß diese asiatischen Staaten nach Bestreitung ihrer Zivil- und Militärausgaben sich im Besitz eines Überschusses von Lebensmitteln befanden, die sie für Werke der Pracht und des Nutzens verausgaben konnten.	ch13_clean.en-ch13_clean.de
The teeming valley of the Nile… produced food for a swarming non-agricultural population, and this food, belonging to the monarch and the priesthood, afforded the means of erecting the mighty monuments which filled the land… In moving the colossal statues and vast masses of which the transport creates wonder, human labour almost alone was prodigally used… The number of the labourers and the concentration of their efforts sufficed.	Ihr Kommando über die Hände und Arme fast der ganzen nicht ackerbauenden Bevölkrung und die ausschließliche Verfügung des Monarchen und der Priesterschaft über jenen Überschuß boten ihnen die Mittel zur Errichtung jener mächtigen Monumente, womit sie das Land erfüllten ...	ch13_clean.en-ch13_clean.de
We see mighty coral reefs rising from the depths of the ocean into islands and firm land, yet each individual depositor is puny, weak, and contemptible.	In der Bewegung der kolossalen Statuen und der enormen Massen, deren Transport Staunen erregt, wurde fast nur menschliche Arbeit verschwenderisch angewandt.	ch13_clean.en-ch13_clean.de
	Die Zahl der Arbeiter und die Konzentration ihrer Mühen genügte.	ch13_clean.en-ch13_clean.de
The non-agricultural labourers of an Asiatic monarchy have little but their individual bodily exertions to bring to the task, but their number is their strength, and the power of directing these masses gave rise to the palaces and temples, the pyramids, and the armies of gigantic statues of which the remains astonish and perplex us.	So sehn wir mächtige Korallenriffe aus den Tiefen des Ozeans zu Inseln anschwellen und festes Land bilden, obgleich jeder individuelle Ablagerer (depositary) winzig, schwach und verächtlich ist. Die nicht ackerbauenden Arbeiter einer asiatischen Monarchie haben außer ihren individuellen körperlichen Bemühungen wenig zum Werk zu bringen, aber ihre Zahl ist ihre Kraft, und die Macht der Direktion über diese Massen gab jenen Riesenwerken den Ursprung.	ch13_clean.en-ch13_clean.de
It is that confinement of the revenues which feed them, to one or a few hands, which makes such undertakings possible.’	Es war die Konzentration der Revenuen, wovon die Arbeiter leben, in einer Hand oder wenigen Händen, welcher solche Unternehmungen möglich machte."	ch13_clean.en-ch13_clean.de
This power of Asiatic and Egyptian kings, of Etruscan theocrats, etc. has in modern society been transferred to the capitalist, whether he appears as an isolated individual or, as in the case of joint-stock companies, in combination with others.	Diese Macht asiatischer und ägyptischer Könige oder etruskischer Theokraten usw. ist in der modernen Gesellschaft auf den Kapitalisten übergegangen, ob er nun als vereinzelter Kapitalist auftritt, oder, wie bei Aktiengesellschaften, als kombinierter Kapitalist.	ch13_clean.en-ch13_clean.de
Co-operation in the labour process, such as we find it at the beginning of human civilization, among hunting peoples or, say, as a predominant feature of the agriculture of Indian communities, is based on the one hand on the common ownership of the conditions of production, and on the other hand on the fact that in those cases the individual has as little torn himself free from the umbilical cord of his tribe or community as a bee has from his hive.	Die Kooperation im Arbeitsprozeß, wie wir sie in den Kulturanfängen der Menschheit, bei Jägervölkern (23a) oder etwa in der Agrikultur indischer Gemeinwesen vorherrschend finden, beruht einerseits auf dem Gemeineigentum an den Produktionsbedingungen, andrerseits darauf, daß das einzelne Individuum sich von der Nabelschnur des Stammes oder des Gemeinwesens noch ebensowenig losgerissen hat wie das Bienenindividuum vom Bienenstock.	ch13_clean.en-ch13_clean.de
Both of these characteristics distinguish this form of co-operation from capitalist co-operation.	Beides unterscheidet sie von der kapitalistischen Kooperation.	ch13_clean.en-ch13_clean.de
The sporadic application of co-operation on a large scale in ancient times, in the Middle Ages, and in modern colonies, rests on direct relations of domination and servitude, in most cases on slavery.	Die sporadische Anwendung der Kooperation auf großem Maßstab in der antiken Welt, dem Mittelalter und den modernen Kolonien beruht auf unmittelbaren Herrschafts- und Knechtschaftsverhältnissen, zumeist auf der Sklaverei.	ch13_clean.en-ch13_clean.de
As against this, the capitalist form presupposes from the outset the free wage-labourer who sells his labour-power to capital.	Die kapitalistische Form setzt dagegen von vornherein den freien Lohnarbeiter voraus, der seine Arbeitskraft dem Kapital verkauft.	ch13_clean.en-ch13_clean.de
Historically, however, this form is developed in opposition to peasant agriculture and independent handicrafts, whether in guilds or not.21From the standpoint of the peasant and the artisan, capitalist co-operation does not appear as a particular historical form of co-operation; instead, co-operation itself appears as a historical form peculiar to, and specifically distinguishing, the capitalist process of production.	Historisch jedoch entwickelt sie sich im Gegensatz zur Bauernwirtschaft und zum unabhängigen Handwerksbetrieb, ob dieser zünftige Form besitze oder nicht. Ihnen gegenüber erscheint die kapitalistische Kooperation nicht als eine besondre historische Form der Kooperation, sondern die Kooperation selbst als eine dem kapitalistischen Produktionsprozeß eigentümliche und ihn spezifisch unterscheidende historische Form.	ch13_clean.en-ch13_clean.de
Just as the social productive power of labour that is developed by co-operation appears to be the productive power of capital, so co-operation itself, contrasted with the process of production carried on by isolated independent workers, or even by small masters, appears to be a specific form of the capitalist process of production.	Wie die durch die Kooperation entwickelte gesellschaftliche Produktivkraft der Arbeit als Produktivkraft des Kapitals erscheint, so die Kooperation selbst als eine spezifische Form des kapitalistischen Produktionsprozesses im Gegensatz zum Produktionsprozeß vereinzelter unabhängiger Arbeiter oder auch Kleinmeister.	ch13_clean.en-ch13_clean.de
It is the first change experienced by the actual labour process when subjected to capital.	Es ist die erste Änderung, welche der wirkliche Arbeitsprozeß durch seine Subsumtion unter das Kapital erfährt.	ch13_clean.en-ch13_clean.de
It takes place spontaneously and naturally.	Diese Änderung geht naturwüchsig vor sich.	ch13_clean.en-ch13_clean.de
The simultaneous employment of a large number of wage-labourers in the same labour process, which is a necessary condition for this change, also forms the starting-point of capitalist production.	Ihre Voraussetzung, gleichzeitige Beschäftigung einer größren Anzahl von Lohnarbeitern in demselben Arbeitsprozeß, bildet den Ausgangspunkt der kapitalistischen Produktion.	ch13_clean.en-ch13_clean.de
This starting-point coincides with the birth of capital itself.	Dieser fällt mit dem Dasein des Kapitals selbst zusammen.	ch13_clean.en-ch13_clean.de
If then, on the one hand, the capitalist mode of production is a historically necessary condition for the transformation of the labour process into a social process, so, on the other hand, this social form of the labour process is a method employed by capital for the more profitable exploitation of labour, by increasing its productive power.	Wenn sich die kapitalistische Produktionsweise daher einerseits als historische Notwendigkeit für die Verwandlung des Arbeitsprozesses in einen gesellschaftlichen Prozeß darstellt, so andrerseits diese gesellschaftliche Form des Arbeitsprozesses als eine vom Kapital angewandte Methode, um ihn durch Steigerung seiner Produktivkraft profitlicher auszubeuten.	ch13_clean.en-ch13_clean.de
In its simple shape, as investigated so far, co-operation is a necessary concomitant of all production on a large scale, but it does not in itself represent a fixed form characteristic of a particular epoch in the development of the capitalist mode of production.	In ihrer bisher betrachteten einfachen Gestalt fällt die Kooperation zusammen mit der Produktion auf größrer Stufenleiter, bildet aber keine feste charakteristische Form einer besondren Entwicklungsepoche der kapitalistischen Produktionsweise.	ch13_clean.en-ch13_clean.de
At the most it appears to do so, and then only approximately, in the handicraft-like beginnings of manufacture and in that kind of large-scale agriculture which corresponds to the period of manufacture, and is distinguished from peasant agriculture mainly by the number of workers simultaneously employed and the mass of means of production concentrated for their use.	Höchstens erscheint sie annähernd so in den noch handwerksmäßigen Anfängen der Manufaktur und in jeder Art großer Agrikultur, welche der Manufakturperiode entspricht und sich wesentlich nur durch die Masse der gleichzeitig angewandten Arbeiter und den Umfang der konzentrierten Produktionsmittel von der Bauernwirtschaft unterscheidet.	ch13_clean.en-ch13_clean.de
Simple co-operation has always been, and continues to be, the predominant form in those branches of production in which capital operates on a large scale, but the division of labour and machinery play only an insignificant part.	Die einfache Kooperation ist stets noch vorherrschende Form solcher Produktionszweige, worin das Kapital auf großer Stufeneiter operiert, ohne daß Teilung der Arbeit oder Maschinerie eine bedeutende Rolle spielte.	ch13_clean.en-ch13_clean.de
Co-operation remains the fundamental form of the capitalist mode of production, although in its simple shape it continues to appear as one particular form alongside the more developed ones.	Die Kooperation bleibt die Grundform der kapitalistischen Produktionsweise, obgleich ihre einfache Gestalt selbst als besondre Form neben ihren weiterentwickelten Formen erscheint.	ch13_clean.en-ch13_clean.de

