Chapter 17: Changes of Magnitude in the Price of Labour-Power and in Surplus-Value The value of labour-power is determined by the value of the means of subsistence habitually required by the average worker.	FÜFNZEHNTES KAPITEL Größenwechsel von Preis der Arbeitskraft und Mehrwert Der Wert der Arbeitskraft ist bestimmt durch den Wert der gewohnheitsmäßig notwendigen Lebensmittel des Durchschnittsarbeiters.	ch17_clean.en-ch17_clean.de
The quantity of the means of subsistence required is given at any particular epoch in any particular society, and can therefore be treated as a constant magnitude.	Die Masse dieser Lebensmittel, obgleich ihre Form wechseln mag, ist in einer bestimmten Epoche einer bestimmten Gesellschaft gegeben und daher als konstante Größe zu behandeln.	ch17_clean.en-ch17_clean.de
What changes is the value of this quantity.	Was wechselt, ist der Wert dieser Masse.	ch17_clean.en-ch17_clean.de
There are, besides, two other factors that enter into the determination of the value of labour-power.		ch17_clean.en-ch17_clean.de
One is the cost of developing that power, which varies with the mode of production.	Zwei andre Faktoren gehn in die Wertbestimmung der Arbeitskraft ein.	ch17_clean.en-ch17_clean.de
The other is the natural diversity of labour-power, the difference between the labour-power of men and women, children and adults.	Einerseits ihre Entwicklungskosten, die sich mit der Produktionsweise ändern, andrerseits ihre Naturdifferenz, ob sie männlich oder weiblich, reif oder unreif.	ch17_clean.en-ch17_clean.de
The utilization of these different sorts of labour-power, which is in turn conditioned by the mode of production, makes for great variations in the cost of reproducing the worker’s family, and in the value of the labour-power of the adult male.	Der Verbrauch dieser differenten Arbeitskräfte, wieder bedingt durch die Produktionsweise, macht großen Unterschied in den Reproduktionskosten der Arbeiterfamilie und dem Wert des erwachsnen männlichen Arbeiters.	ch17_clean.en-ch17_clean.de
Both these factors, however, are excluded in the following investigation.	Beide Faktoren bleiben jedoch bei der folgenden Untersuchung ausgeschlossen.	ch17_clean.en-ch17_clean.de
I assume (1) that commodities are sold at their value, (2) that the price of labour-power occasionally rises above its value, but never sinks below it.	(9b) Wir unterstellen, 1. daß die Waren zu ihrem Wert verkauft werden, 2. daß der Preis der Arbeitskraft wohl gelegentlich über ihren Wert steigt, aber nie unter ihn sinkt.	ch17_clean.en-ch17_clean.de
On these assumptions, we have already found that the relative magnitudes of surplus-value and of price of labour-power are determined by three circumstances: (1) the length of the working day, or the extensive magnitude of labour, (2) the normal intensity of labour, or its intensive magnitude, whereby a given quantity of labour is expended in a given time and (3) the productivity of labour, whereby the same quantity of labour yields, in a given time, a greater or a smaller quantity of the product, depending on the degree of development attained by the conditions of production.	Dies einmal unterstellt, fand sich, daß die relativen Größen von Preis der Arbeitskraft und von Mehrwert durch drei Umstände bedingt sind: 1. die Lände des Arbeitstags oder die extensive Größe der Arbeit; 2. die normale Intensität der Arbeit oder ihre intensive Größe, so daß ein bestimmtes Arbeitsquantum in bestimmter Zeit verausgabt wird; 3. endlich die Produktivkraft der Arbeit, so daß je nach dem Entwicklungsgrad der Produktionsbedingungen dasselbe Quantum Arbeit in derselben Zeit ein größeres Quantum Produkt liefert.	ch17_clean.en-ch17_clean.de
Very different combinations are clearly pos-sible, since one of the three factors can be constant while the other two vary, two factors can be constant while one varies, and, finally, all three may vary.	Sehr verschiedne Kom- binationen sind offenbar möglich, je nachdem einer der drei Faktoren konstant und zwei variabel, oder zwei Faktoren konstant und einer variabel, oder endlich alle gleichzeitig variabel sind.	ch17_clean.en-ch17_clean.de
In addition, the number of possible combinations is augmented by the fact that, when all these factors vary simultaneously, the amount and direction of their respective variations may differ.	Diese Kombinationen werden noch dadurch vermannigfacht, daß bei gleichzeitiger Variation verschiedner Faktoren die Größe und Richtung der Variation verschieden sein können.	ch17_clean.en-ch17_clean.de
In what follows the chief combinations alone are considered.	Im folgenden sind nur die Hauptkombinationen dargestellt.	ch17_clean.en-ch17_clean.de
1. THE LENGTH OF THE WORKING DAY AND THE INTENSITY OF LABOUR CONSTANT; THE PRODUCTIVITY OF LABOUR VARIABLE On these assumptions the value of labour-power and the magnitude of surplus-value are determined by three laws.	I. Größe des Arbeitstags und Intensität der Arbeit konstant (gegeben), Produktivkraft der Arbeit variabel Unter dieser Voraussetzung sind Wert der Arbeitskraft und Mehrwert durch drei Gesetze bestimmt.	ch17_clean.en-ch17_clean.de
Firstly, a working day of a given length always creates the same amount of value, no matter how the productivity of labour, and, with it, the mass of the product and the price of each single commodity produced may vary.	Erstens: Der Arbeitstag von gegebner Größe stellt sich stets in demselben Wertprodukt dar, wie auch die Produktivität der Arbeit, mit ihr die Produktenmasse und daher der Preis der einzelnen Ware wechsle.	ch17_clean.en-ch17_clean.de
If the value created by a working day of 12 hours is, say, 6 shillings, then, although the mass of the use-values produced varies with the productivity of labour, the value represented by 6 shillings will simply be spread over a greater or a less number of commodities.	Das Wertprodukt eines zwölfstündigen Arbeitstags ist 6 sh. z.B., obgleich die Masse der produzierten Gebrauchswerte mit der Produktivkraft der Arbeit wechselt, der Wert von 6 sh. sich also über mehr oder weniger Waren verteilt.	ch17_clean.en-ch17_clean.de
Secondly, the value of labour-power and surplus-value vary in opposite directions.	Zweitens: Wert der Arbeitskraft und Mehrwert wechseln in umgekehrter Richtung zueinander.	ch17_clean.en-ch17_clean.de
A variation in the productivity of labour, its increase or diminution, causes the value of labour-power to move in the opposite direction, while surplus-value moves in the same direction.	Wechsel in der Produktivkraft der Arbeit, ihre Zunahme oder Abnahme, wirkt in umgekehrter Richtung auf den Wert der Arbeitskraft und Arbeitskraft und in direkter auf den Mehrwert.	ch17_clean.en-ch17_clean.de
The value created by a working day of 12 hours is a constant quantity, say 6 shillings.	Das Wertprodukt des zwölfstündigen Arbeitstags ist eine konstante Größe, z.B. 6 sh.	ch17_clean.en-ch17_clean.de
This constant quantity is the sum of the surplus-value plus the value of the labour-power, the value of the labour-power being replaced with an equivalent by the worker himself.	Diese konstante Größe ist gleich der Summe des Mehrwerts plus dem Wert der Arbeitskraft, den der Arbeiter durch ein Äquivalent ersetzt.	ch17_clean.en-ch17_clean.de
It is self-evident that if a constant quantity consists of two parts, neither of them can increase without the other diminishing.	Es ist selbstverständlich, daß von zwei Teilen einer konstanten Größe keiner zunehmen kann, ohne daß der andre abnimmt.	ch17_clean.en-ch17_clean.de
Let the two parts be equal at the beginning, and let 3 shillings be the value of the labour-power, and the same for the surplus-value.		ch17_clean.en-ch17_clean.de
Then the value of the labour-power cannot rise from 3 shillings to 4 without the surplus-value falling from 3 shillings to 2; and the surplus-value cannot rise from 3 shillings to 4 without the value of the labour-power falling from 3 shillings to 2.	Der Wert der Arbeitskraft kann nicht von 3 sh. auf 4 steigen, ohne daß der Mehrwert von 3 sh. auf 2 fällt, und der Mehrwert kann nicht von 3 auf 4 sh. steigen, ohne daß der Wert der Arbeitskraft von 3 sh. auf 2 fällt.	ch17_clean.en-ch17_clean.de
Under these circumstances, then, no change can take place in the absolute magnitude either of the surplus-value or of the value of the labour-power without a simultaneous change in their relative magnitudes.	Unter diesen Umständen also ist kein Wechsel in der absoluten Größe, sei es des Werts der Arbeitskraft, sei es des Mehrwerts, möglich ohne gleichzeitigen Wechsel ihrer relativen oder verhältnismäßigen Größen.	ch17_clean.en-ch17_clean.de
It is impossible for them to rise or fall simultaneously.	Es ist unmöglich, daß sie gleichzeitig fallen oder steigen.	ch17_clean.en-ch17_clean.de
Further, the value of the labour-power cannot fall, and consequently surplus-value cannot rise, without a rise in the productivity of labour. For instance, in the above case, the value of the labour-power cannot sink from 3 shillings to 2 unless an increase in the productivity of labour makes it possible to produce in 4 hours the same quantity of means of subsistence as could only be produced previously in 6 hours.	Der Wert der Arbeitskraft kann ferner nicht fallen, also der Mehrwert nicht steigen, ohne daß die Produktivkraft der Arbeit steigt, z.B. im obigen Fall kann der Wert der Arbeitskraft nicht von 3 auf 2 sh. sinken, ohne daß erhöhte Produktivkraft der Arbeit erlaubt, in 4 Stunden dieselbe Masse Lebensmittel zu produzieren, die vorher 6 Stunden zu ihrer Produktion erheischten.	ch17_clean.en-ch17_clean.de
On the other hand, the value of the labour-power cannot rise from 3 shillings to 4 without a decrease in the productivity of labour, so that 8 hours are required to produce the same quantity of means of subsistence as were previously produced in 6 hours.	Umgekehrt kann der Wert der Arbeitskraft nicht von 3 auf 4 sh. steigen, ohne die Produktivkraft der Arbeit fällt, also 8 Stunden zur Produktion derselben Masse von Lebensmitteln erheischt sind, wozu früher 6 Stunden genügten.	ch17_clean.en-ch17_clean.de
It follows from this that an increase in the productivity of labour causes a fall in the value of labour-power and a consequent rise in surplus-value, while, on the other hand, a decrease in the productivity of labour causes a rise in the value of labour-power and a fall in surplus-value.	Es folgt hieraus, daß die Zunahme in der Produktivität der Arbeit den Wert der Arbeitskraft senkt und damit den Mehrwert steigert, während umgekehrt die Abnahme der Produktivität den Wert der Arbeitskraft steigert und den Mehrwert senkt.	ch17_clean.en-ch17_clean.de
In formulating this law,* Ricardo overlooked one thing: although a change in the magnitude of the surplus-value or surplus labour causes a change in the opposite direction in the magnitude of the value of labour-power, or in the quantity of necessary labour, it by no means follows that they vary in the same proportion.	Bei Formulierung dieses Gesetzes übersah Ricardo einen Umstand: Obgleich der Wechsel in der Größe des Mehrwerts oder der Mehrarbeit einen umgekehrten Wechsel in der Größe des Werts der Arbeitskraft oder der notwendigen Arbeit bedingt, folgt keineswegs, daß sie in derselben Proportion wechseln.	ch17_clean.en-ch17_clean.de
It is true that they increase or diminish by the same quantity.	Sie nehmen zu oder ab um dieselbe Größe.	ch17_clean.en-ch17_clean.de
But their proportional increase or diminution depends on their original magnitude, before the change in the productivity of labour took place.	Das Verhältnis aber, worin jeder Teil des Wertprodukts oder des Arbeitstags zu- oder abnimmt, hängt von der ursprünglichen Teilung ab, die vor dem Wechsel in der Produktivkraft der Arbeit stattfand.	ch17_clean.en-ch17_clean.de
If the value of the labour-power is 4 shillings, or the necessary labour-time is 8 hours, and the surplus-value is 2 shillings, or the surplus labour 4 hours, and if, owing to an increase in the productivity of labour, the value of the labour-power falls to 3 shillings, or the necessary labour-time to 6 hours, the surplus-value will rise to 3 shillings, or the surplus labour to 6 hours.	War der Wert der Arbeitskraft 4 sh. oder die notwendige Arbeitszeit 8 Stunden, der Mehrwert 2 sh. oder die Mehrarbeit 4 Stunden und fällt, infolge erhöhter Produktivkraft der Arbeit, der Wert der Arbeitskraft auf 3 sh. oder die notwendige Arbeit auf 6 Stunden, so steigt der Mehrwert auf 3 sh. oder die Mehrarbeit auf 6 Stunden.	ch17_clean.en-ch17_clean.de
The same quantity, 1 shilling or 2 hours, is added in one case, and subtracted in the other.	Es ist dieselbe Größe von 2 Stunden oder 1 sh., die dort zugefügt, hier weggenommen wird.	ch17_clean.en-ch17_clean.de
But the proportional change of magnitude is different in the two cases.	Aber der proportionelle Größenwechsel ist auf beiden Seiten verschieden.	ch17_clean.en-ch17_clean.de
The value of the labour-power falls from 4 shillings to 3, i.e. it falls by 1/4, or 25 per cent, but the surplus-value rises from 2 shillings to 3, i.e. it rises by 1/2, or 50 per cent.	Während der Wert der Arbeitskraft von 4 sh. auf 3, also um 1/4 oder 25% sinkt, steigt der Mehrwert von 2 sh. auf 3, also um 1/2 oder 50%.	ch17_clean.en-ch17_clean.de
It therefore follows that the proportional increase or diminution in surplus-value resulting from a given change in the productivity of labour depends on the original magnitude of that portion of the working day which is embodied in surplus-value; the smaller that portion, the greater the proportional change; the greater that portion, the less the proportional change.	Es folgt daher, daß die proportionelle Zu- oder Abnahme des Mehrwerts, infolge eines gegebnen Wechsels in der Produktivkraft der Arbeit, um so größer, je kleiner, und um so kleiner, je größer ursprünglich der Teil des Arbeitstags war, der sich in Mehrwert darstellt.	ch17_clean.en-ch17_clean.de
(3) Increase or diminution in surplus-value is always the consequence, and never the cause, of the corresponding diminution or increase in the value of labour-power.	Drittens: Zu- oder Abnahme des Mehrwerts ist stets Folge und nie Grund der entsprechenden Ab- und Zunahme des Werts der Arbeitskraft.	ch17_clean.en-ch17_clean.de
Since the working day is constant in magnitude, and is represented by a value of constant magnitude, since there corresponds to every variation in the magnitude of surplus-value an inverse variation in the value of labour-power, and since the value of labour-power cannot change except as a result of a change in the productivity of labour, it clearly follows under these conditions that every change of magnitude in surplus-value arises from an inverse change of magnitude in the value of labour-power.	Da der Arbeitstag von konstanter Größe ist, sich in einer konstanten Wertgröße darstellt, jedem Größenwechsel des Mehrwerts ein umgekehrter Größenwechsel im Wert der Arbeitskraft entspricht und der Wert der Arbeitskraft nur wechseln kann mit einem Wechsel in der Produktivkraft der Arbeit, folgt unter diesen Bedingungen offenbar, daß jeder Größenwechsel des Mehrwerts aus einem umgekehrten Größenwechsel im Wert der Arbeitskraft entspringt.	ch17_clean.en-ch17_clean.de
If, then, as we have already seen, there can be no change of absolute magnitude in the value of labour-power, and in surplus-value, unaccompanied by a change in their relative magnitudes, it now follows that no change in their relative magnitudes is possible without a change in the absolute magnitude of the value of labour-power.	Wenn man daher gesehn, daß kein absoluter Größenwechsel im Wert der Arbeitskraft und des Mehrwerts möglich ist ohne einen Wechsel ihrer relativen Größen, so folgt jetzt, daß kein Wechsel ihrer relativen Wertgrößen möglich ist ohne einen Wechsel in der absoluten Wertgröße der Arbeitskraft.	ch17_clean.en-ch17_clean.de
According to the third law, a change in the magnitude of surplus-value presupposes a movement in the value of labour-power, brought about by a change in the productivity of labour.	Nach dem dritten Gesetz unterstellt der Größenwechsel des Mehrwerts eine durch Wechsel in der Produktivkraft der Arbeit verursachte Wertbewegung der Arbeitskraft.	ch17_clean.en-ch17_clean.de
The limit of this change is given by the altered value of labour-power.	Die Grenze jenes Wechsels ist durch die neue Wertgrenze der Arbeitskraft gegebnen.	ch17_clean.en-ch17_clean.de
Nevertheless, even when circumstances allow the law to operate, subsidiary movements may occur.	Es können aber, auch wenn die Umstände dem Gesetz zu wirken erlauben, Zwischenbewegungen stattfinden.	ch17_clean.en-ch17_clean.de
For example, if, as a result of an increase in the productivity of labour, the value of labour-power falls from 4 shillings to 3, or the necessary labour-time from 8 hours to 6, the price of labour-power might well fall only to 3s.	Fällt z.B. infolge erhöhter Produktivkraft der Arbeit der Wert der Arbeitskraft von 4 sh. auf 3 oder die notwendige Arbeitszeit von 8 Stunden auf 6, so könnte der Preis der Arbeitskraft nur auf 3 sh.	ch17_clean.en-ch17_clean.de
8d., 3s.	8 d., 3 sh.	ch17_clean.en-ch17_clean.de
6d. or 3s.	6 d., 3 sh.	ch17_clean.en-ch17_clean.de
2d., thus allowing the amount of surplus-value to rise only to 3s.	2 d. usw. fallen, der Mehrwert daher nur auf 3 sh.	ch17_clean.en-ch17_clean.de
4d., 3s.	4 d., 3 sh.	ch17_clean.en-ch17_clean.de
6d. or 3s.	6 d., 3 sh.	ch17_clean.en-ch17_clean.de
10d.	10 d usw. steigen.	ch17_clean.en-ch17_clean.de
The amount of this fall, the lowest limit of which is 3 shillings (the new value of labour-power), depends on the relative weight thrown into the scale by the pressure of capital on the one side, and the resistance of the worker on the other.	Der Grad des Falls, dessen Minimalgrenze 3 sh., hängt von dem relativen Gewicht ab, das der Druck des Kapitals von der einen Seite, der Widerstand der Arbeiter von der andern Seite in die Waagschale wirft.	ch17_clean.en-ch17_clean.de
The value of labour-power is determined by the value of a certain quantity of means of subsistence.	Der Wert der Arbeitskraft ist bestimmt durch den Wert eines bestimmten Quantums von Lebensmitteln.	ch17_clean.en-ch17_clean.de
It is the value and not the mass of these means of subsistence that varies with the productivity of labour.	Was mit der Produktivkraft der Arbeit wechselt, ist der Wert dieser Lebensmittel, nicht ihre Masse.	ch17_clean.en-ch17_clean.de
It is however possible that owing to an increase in the productivity of labour both the worker and the capitalist may simultaneously be able to appropriate a greater quantity of means of subsistence, without any change in the price of labour-power or in surplus-value.	Die Masse selbst kann, bei steigender Produktivkraft der Arbeit, für Arbeiter und Kapitalist gleichzeitig und in demselben Verhältnis wachsen ohne irgendeinen Größenwechsel zwischen Preis der Arbeitskraft und Mehrwert.	ch17_clean.en-ch17_clean.de
Let the value of labour-power be 3 shillings, and let the necessary labour-time amount to 6 hours. Let the surplus-value be, similarly, 3 shillings, and the surplus labour 6 hours. Now, if the productivity of labour were to be doubled without any alteration in the ratio between necessary labour and surplus labour, there would be no change in the magnitude either of the surplus-value or of the price of labour-power.	Ist der ursprüngliche Wert der Arbeitskraft 3 sh. und beträgt die notwendige Arbeitszeit 6 Stunden, ist der Mehrwert ebenfalls 3 sh. oder beträgt die Mehrarbeit auch 6 Stunden, so würde eine Verdopplung in der Produktivkraft der Arbeit, bei gleichbleibender Teilung des Arbeitstags, Preis der Arbeitskraft und Mehrwert unverändert lassen.	ch17_clean.en-ch17_clean.de
The only result would be that each of these would represent twice as many use-values as before, and that each use-value would be twice as cheap as it was before.	Nur stellte sich jeder derselben in doppelt so vielen, aber verhältnismäßig verwohlfeilerten Ge- brauchswerten dar.	ch17_clean.en-ch17_clean.de
Although labour-power would be unchanged in price, it would have risen above its value.		ch17_clean.en-ch17_clean.de
However, now assume a fall in the price of labour-power, not as far as Is.	Obgleich der Preis der Arbeitskraft unverändert, wäre er über ihren Wert gestiegen.	ch17_clean.en-ch17_clean.de
6d., the lowest possible point consistent with its new value, but to 2s.	Fiele der Preis der Arbeitskraft, aber nicht bis zu der durch ihren neuen Wert gegebnen Minimalgrenze von 11/2 sh., sondern auf 2 sh.	ch17_clean.en-ch17_clean.de
10d. or 2s.	10 d., 2 sh.	ch17_clean.en-ch17_clean.de
6d. This lower price would still represent an increased quantity of means of subsistence.	6 d. usw., so repräsentierte dieser fallende Preis immer noch eine wachsende Masse von Lebensmitteln.	ch17_clean.en-ch17_clean.de
In this way it is possible, given increasing productivity of labour, for the price of labour-power to fall constantly and for this fall to be accompanied by a constant growth in the mass of the worker’s means of subsistence.	Der Preis der Arbeitskraft könnte so bei steigender Produktivkraft der Arbeit beständig fallen mit gleichzeitigem, fortwährendem Wachstum der Lebensmittelmasse des Arbeiters.	ch17_clean.en-ch17_clean.de
But in relative terms, i.e. in comparison with surplus-value, the value of labour-power would keep falling, and thus the abyss between the life-situation of the worker and that of the capitalist would keep widening.	Relativ aber, d.h. verglichen mit dem Mehrwert, sänke der Wert der Arbeitskraft beständig und erweiterte sich also die Kluft zwischen den Lebenslagen von Arbeiter und Kapitalist.	ch17_clean.en-ch17_clean.de
Ricardo was the first to give an accurate formulation of the three laws we have just stated.	Ricardo hat die oben aufgestellten drei Gesetze zuerst streng formuliert.	ch17_clean.en-ch17_clean.de
But his presentation of them suffers from the following defects: (1) he views the special conditions under which these laws hold good as the self-evident, universal, and exclusive conditions of capitalist production.	Die Mängel seiner Darstellung sind, 1. daß er die besondern Bedingungen, innerhalb deren jene Gesetze gelten, für die sich von selbst verstehenden, allgemeinen und ausschließlichen Bedingungen der kapitalistischen Produktion ansieht.	ch17_clean.en-ch17_clean.de
He recognizes no change either in the length of the working day or in the intensity of labour, so that with him the productivity of labour becomes the only variable factor; (2), and this error vitiates his analysis much more than (1), he has not, any more than the other economists, investigated surplus-value as such, i.e. independently of its particular forms, such as profit, ground rent, etc. He therefore fails to differentiate between the laws governing the rate of surplus-value and those governing the rate of profit.	Er kennt keinen Wechsel, weder in der Länge des Arbeitstags noch in der Intensität der Arbeit, so daß bei ihm die Produktivität der Arbeit von selbst zum einzigen variablen Faktor wird; - 2. aber, und dies verfälscht seine Analyse in viel höherem Grad, hat er ebensowenig wie die andern Ökonomen jemals den Mehrwert als solchen untersucht, d.h. unabhängig von seinen besondern Formen, wie Profit, Grundrente usw. Er wirft daher die Gesetze über die Rate des Mehrwerts unmittelbar zusammen mit den Gesetzen der Profitrate.	ch17_clean.en-ch17_clean.de
The rate of profit is, as we have already said, the ratio of the surplus-value to the total capital advanced; the rate of surplus-value is the ratio of the surplus-value to the variable part of that capital.	Wie schon gesagt, ist die Profitrate das Verhältnis des Mehrwerts zum vorgeschossenen Gesamtkapital, während die Mehrwertsrate das Verhältnis ist des Mehrwerts zum bloß variablen Teil dieses Kapitals.	ch17_clean.en-ch17_clean.de
Assume that a capital C of £ is made up of raw material, instruments of labour, etc. which, taken together, we shall call c, to the amount of £400, and of wages v, to the amount of £100; and assume, further, that the surplus value s= £100.	Nimm an, ein Kapital von 500 Pfd.St. (C) teile sich in Rohstoffe, Arbeitsmittel etc. für zusammen 400 Pfd.St. (c) und in 100 Pfd.St.	ch17_clean.en-ch17_clean.de
Then the rate of surplus-value will be s/ν = £100/£ = 100 per cent.	Arbeitslöhne (v); daß ferner der Mehrwert = 100 Pfd.St. (m).	ch17_clean.en-ch17_clean.de
	Dann ist die Mehrwertsrate m/v = 100 Pfd.St/100 Pfd.St = 100%.	ch17_clean.en-ch17_clean.de
But the rate of profit will be s/C = £100/£ = 20 per cent.	Aber die Profitrate m/C = 100 Pfd.St./500 Pfd.St. = 20%.	ch17_clean.en-ch17_clean.de
It is obvious, moreover, that the rate of profit may depend on circumstances which in no way affect the rate of surplus-value.	Es leuchtet außerdem ein, daß die Profitrate abhängen kann von Umständen, die keineswegs auf die Mehrwertsrate einwirken.	ch17_clean.en-ch17_clean.de
I shall show in Volume 3 that the same rate of surplus-value may be expressed in the most diverse rates of profit, and that different rates of surplus-value may, under certain circumstances, be expressed in the same rate of profit. * 2.	Ich werde später im Dritten Buch dieser Schrift beweisen, daß dieselbe Rate des Mehrwerts sich in den verschiedensten Profitraten und verschiednen Raten des Mehrwerts, unter bestimmten Umständen, sich in derselben Profitrate ausdrücken können.	ch17_clean.en-ch17_clean.de
THE LENGTH OF THE WORKING DAY AND THE PRODUCTIVITY OF LABOUR CONSTANT; THE INTENSITY OF LABOUR VARIABLE Increased intensity of labour means increased expenditure of labour in a given time.	II. Konstanter Arbeitstag, konstante Produktivkraft der Arbeit, Intensität der Arbeit variabel Wachsende Intensität der Arbeit unterstellt vermehrte Ausgabe von Arbeit in demselben Zeitraum.	ch17_clean.en-ch17_clean.de
Hence a working day of more intense labour is embodied in more products than is one of less intense labour, the length of each working day being the same.	Der intensivere Arbeitstag verkörpert sich daher in mehr Produkten als der minder intensive von gleicher Stundenzahl.	ch17_clean.en-ch17_clean.de
Admit-tedly, an increase in the productivity of labour will also supply more products in a given working day.	Mit erhöhter Produktivkraft liefert zwar auch derselbe Arbeitstag mehr Produkte.	ch17_clean.en-ch17_clean.de
But in that case the value of each single product falls, for it costs less labour than before, whereas in the case mentioned here that value remains unchanged, because each article costs the same amount of labour as before.	Aber im letztern Fall sinkt der Wert des einzelnen Produkts, weil es weniger Arbeit als vorher kostet, im erstern Fall bleibt er unverändert, weil das Produkt nach wie vor gleich viel Arbeit kostet.	ch17_clean.en-ch17_clean.de
Here we have an increase in the number of products unaccompanied by a fall in their individual prices: as their number increases, so does the sum of their prices, whereas in the case of an increase in productivity, a given value is spread over a greater mass of products.	Die Anzahl der Produkte steigt hier ohne Fall ihres Preises. Mit ihrer Anzahl wächst ihre Preissumme, während dort dieselbe Wertsumme sich nur in vergrößerter Produktenmasse darstellt.	ch17_clean.en-ch17_clean.de
Hence, if the length of the working day remains constant, a day’s labour of increased intensity will be incorporated in an increased amount of value, and, assuming no change in the value of money, in an increased amount of money.	Bei gleichbleibender Stundenzahl verkörpert sich also der intensivere Arbeitstag in höherem Wertprodukt, also, bei gleichbleibendem Wert des Geldes, in mehr Geld.	ch17_clean.en-ch17_clean.de
The value created varies with the extent to which the intensity of labour diverges from its normal social level of intensity.	Sein Wertprodukt variiert mit den Abweichungen seiner Intensität von dem gesellschaftlichen Normalgrad.	ch17_clean.en-ch17_clean.de
A given working day, therefore, no longer creates a constant value, but a variable one; in a day of 12 hours of ordinary intensity, the value created is, say, 6 shillings, but, with increased intensity, the value created may be 7, or more shillings.	Derselbe Arbeitstag stellt sich also nicht wie vorher in einem konstanten, sondern in einem variablen Wertprodukt dar, der intensivere, zwölfstündige Arbeitstag z.B. in 7 sh., 8 sh. usw. statt in 6 sh. wie der zwölfstündige Arbeitstag von gewöhnlicher Intensität.	ch17_clean.en-ch17_clean.de
It is clear that if the value created by a day’s labour increases from, say, 6 to 8 shillings, then the two parts into which this value is divided, namely the price of labour-power and surplus-value, may both increase simultaneously, and either equally or unequally.	Es ist klar: Variiert das Wertprodukt des Arbeitstags, etwa von 6 auf 8 sh., so können beide Teile dieses Wertprodukts, Preis der Arbeitskraft und Mehrwert, gleichzeitig wachsen, sei es in gleichem oder ungleichem Grad.	ch17_clean.en-ch17_clean.de
They may both simultaneously increase from 3 shillings to 4.	Preis der Arbeitskraft und Mehrwert können beide zur selben Zeit von 3 sh. auf 4 wachsen, wenn das Wertprodukt von 6 auf 8 steigt.	ch17_clean.en-ch17_clean.de
Here, the rise in the price of labour-power does not necessarily imply that it has risen above the value of labour-power.	Preiserhöhung der Arbeitskraft schließt hier nicht notwendig Steigerung ihres Preises über ihren Wert ein.	ch17_clean.en-ch17_clean.de
On the contrary, this rise in price may be accompanied by a fall below its value.	Sie kann umgekehrt von einem Fall unter ihren Wert <4. Auflage: Fall ihres Werts> begleitet sein.	ch17_clean.en-ch17_clean.de
This always occurs when the rise in the price of labour-power does not compensate for its more rapid deterioration.	Dies findet stets statt, wenn die Preiserhöhung der Arbeitskraft ihren beschleunigten Verschleiß nicht kompensiert.	ch17_clean.en-ch17_clean.de
We know that, with exceptions which are purely temporary, a change in the productivity of labour does not cause any change in the value of labour-power, nor, consequently, in the magnitude of surplus-value, unless the products of the industries affected are articles habitually consumed by the workers.	Man weiß, daß mit vorübergehenden Ausnahmen ein Wechsel in der Produktivität der Arbeit nur dann einen Wechsel in der Wertgröße der Arbeitskraft und daher in der Größe des Mehrwerts bewirkt, wenn die Produkte der betroffenen Industriezweige in den gewohnheitsmäßigen Konsum des Arbeiters eingehn.	ch17_clean.en-ch17_clean.de
But here this limitation falls to the ground.	Diese Schranke fällt hier fort.	ch17_clean.en-ch17_clean.de
Whether the magnitude of the labour changes in extent or in intensity, there is always a corresponding change in the magnitude of the value created, independently of the nature of the article in which that value is embodied.	Ob die Größe der Arbeit extensiv oder intensiv wechsle, ihrem Größenwechsel entspricht ein Wechsel in der Größe ihres Wertprodukts, unabhängig von der Natur des Artikels, worin sich dieser Wert darstellt.	ch17_clean.en-ch17_clean.de
If the intensity of labour were to increase simultaneously and equally in every branch of industry, then the new and higher degree of intensity would become the normal social degree of intensity, and would therefore cease to count as an extensive magni-tude.	Steigerte sich die Intensität in allen Industriezweigen gleichzeitig und gleichmäßig, so würde der neue höhere Intensitätsgrad zum gewöhnlichen gesellschaftlichen Normalgrad und hörte damit auf, als extensive Größe zu zählen.	ch17_clean.en-ch17_clean.de
But even so, the intensity of labour would still be different in different countries, and would modify the application of the law of value to the working days of different nations.	Indes blieben selbst dann die durchschnittlichen Intensitätsgrade der Arbeit bei verschiednen Nationen verschieden und modifizierten daher die Anwendung des Wertgesetzes auf unterschiedne Nationalarbeitstage.	ch17_clean.en-ch17_clean.de
The more intensive working day of one nation would be represented by a greater sum of money than the less intensive day of another nation.	Der intensivere Arbeitstag der einen Nation stellt sich in höherem Geldausdruck dar als der minder intensive der andren.	ch17_clean.en-ch17_clean.de
3. THE PRODUCTIVITY AND INTENSITY OF LABOUR CONSTANT; THE LENGTH OF THE WORKING DAY VARIABLE The working day may vary in two directions.	III. Produktivkraft und Intensität der Arbeit konstant, Arbeitstag variabel Der Arbeitstag kann nach zwei Richtungen variieren.	ch17_clean.en-ch17_clean.de
It may be either shortened or lengthened.	Er kann verkürzt oder verlängert werden.	ch17_clean.en-ch17_clean.de
(From our present data, and within the limits of the assumptions made on p.		ch17_clean.en-ch17_clean.de
655, we obtain the following laws: (1) The working day creates a greater or lesser amount of value in proportion to its length — thus, a variable and not a constant quantity of value.		ch17_clean.en-ch17_clean.de
(2) Every change in the relation between the magnitude of surplus-value and the value of labour-power arises from a change in the absolute magnitude of the surplus labour, and consequently of the surplus-value.		ch17_clean.en-ch17_clean.de
(3) The absolute value of labour-power can change only in consequence of the reaction exercised by the prolongation of surplus labour upon the wear and tear of labour-power.		ch17_clean.en-ch17_clean.de
Every change in this absolute value is therefore the effect, but never the cause, of a change in the magnitude of surplus-value.		ch17_clean.en-ch17_clean.de
We begin with the case in which the working day is shortened. )* (1) A shortening of the working day under the conditions given, i.e. with the productivity and the intensity of labour constant, leaves the value of labour-power, and therefore the necessary labour-time, as it was before.	1. Verkürzung des Arbeitstags unter den gegebenen Bedingungen, d.h. gleichbleibender Produktivkraft und Intensität der Arbeit, läßt den Wert der Arbeitskraft und daher die notwendige Arbeitszeit unverändert.	ch17_clean.en-ch17_clean.de
It reduces the surplus labour and the surplus-value.	Sie verkürzt die Mehrarbeit und den Mehrwert.	ch17_clean.en-ch17_clean.de
Along with the absolute magnitude of the latter, its relative magnitude also falls, i.e. its magnitude in relation to the magnitude of the value of labour-power, which remains constant.	Mit der absoluten Größe des letztren fällt auch seine relative Größe, d.h. seine Größe im Verhältnis zur gleichbleibenden Wertgröße der Arbeitskraft.	ch17_clean.en-ch17_clean.de
Only by reducing the price of labour-power below its value could the capitalist compensate himself for this fall.	Nur durch Herabdrückung ihres Preises unter ihren Wert könnte der Kapitalist sich schadlos halten.	ch17_clean.en-ch17_clean.de
All the usual arguments against the shortening of the working day depend on the assumption that the phenomenon occurs under the conditions presupposed here. But in reality the very opposite is the case: a shortening of the working day either follows upon, or immediately precedes, a change in the productivity and the intensity of labour. (2) Lengthening of the working day.	Alle hergebrachten Redensarten wider die Verkürzung des Arbeitstags unterstellen, daß das Phänomen sich unter den hier vorausgesetzten Umständen ereignet, während in der Wirklichkeit umgekehrt Wechsel in der Produktivität und Intensität der Arbeit entweder der Verkürzung des Arbeitstags vorhergehn oder ihr unmittelbar nachfolgen.	ch17_clean.en-ch17_clean.de
Let the necessary labour-time be 6 hours, or the value of labour-power 3 shillings; also let the surplus labour be 6 hours, or the surplus-value 3 shillings.	2. Verlängerung des Arbeitstags: Die notwendige Arbeitszeit sei 6 Stunden oder der Wert der Arbeitskraft 3 sh., ebenso Mehrarbeit 6 Stunden und Mehrwert 3 sh.	ch17_clean.en-ch17_clean.de
The whole working day then amounts to 12 hours and is embodied in a value of 6 shillings.	Der Gesamtarbeitstag beträgt dann 12 Stunden und stellt sich in einem Wertprodukt von 6 sh. dar.	ch17_clean.en-ch17_clean.de
If the working day is lengthened by 2 hours and the price of labour-power remains the same, the surplus-value increases both absolutely and relatively.	Wird der Arbeitstag um 2 Stunden verlängert und bleibt der Preis der Arbeitskraft unverändert, so wächst mit der absoluten die relative Größe des Mehrwerts.	ch17_clean.en-ch17_clean.de
Although there is no absolute change in the value of labour-power, it suffers a relative fall.	Obgleich die Wertgröße der Arbeitskraft absolut unverändert bleibt, fällt sie relativ.	ch17_clean.en-ch17_clean.de
Under the conditions assumed in I,* there could not be a change of relative magnitude in the value of labour-power without a change in its absolute magnitude.	Unter den Bedingungen von I. konnte die relative Wertgröße der Arbeitskraft nicht wechseln ohne einen Wechsel ihrer absoluten Größe.	ch17_clean.en-ch17_clean.de
Here, on the contrary, the change of relative magnitude in the value of labour-power is the result of the change of absolute magnitude in surplus-value.	Hier, im Gegenteil, ist der relative Größenwechsel im Wert der Arbeitskraft das Resultat eines absoluten Größenwechsels des Mehrwerts.	ch17_clean.en-ch17_clean.de
Since the value-product in which a day of labour is embodied increases with the length of that day, it is evident that the surplus-value and the price of labour-power may simultaneously increase, either by equal or unequal quantities.	Da das Wertprodukt, worin sich der Arbeitstag darstellt, mit seiner eignen Verlängerung wächst, können Preis der Arbeitskraft und Mehrwert gleichzeitig wachsen, sei es um gleiches oder ungleiches Inkrement.	ch17_clean.en-ch17_clean.de
This simultaneous increase is therefore possible in two cases. The first case is an absolute increase in the length of the working day, and the second case is an increase in the intensity of labour unaccompanied by an increase in length.	Dies gleichzeitige Wachstum ist also in zwei Fällen möglich, bei absoluter Verlängerung des Arbeitstags und bei wachsender Intensität der Arbeit ohne solche Verlängerung.	ch17_clean.en-ch17_clean.de
When the working day is prolonged, the price of labour-power may fall below its value, although that price nominally remains unchanged, or even rises.	Mit verlängertem Arbeitstag kann der Preis der Arbeitskraft unter ihren Wert fallen, obgleich er nominell unverändert bleibt oder selbst steigt.	ch17_clean.en-ch17_clean.de
The value of a day’s labour-power is estimated, as will be remembered, on the basis of its normal average duration, or the normal duration of the life of a worker, and on the basis of the appropriate normal standard of conversion of living substances into motion as it applies to the nature of man.	Der Tageswert der Arbeitskraft ist nämlich, wie man sich erinnern wird, geschätzt auf ihre normale Durchschnittsdauer oder die normale Lebensperiode des Arbeiters und auf entsprechenden, normalen, der Menschennatur angemessnen Umsatz von Lebenssubstanz in Bewegung.	ch17_clean.en-ch17_clean.de
Up to a certain point, the increased deterioration of labour-power inseparable from a lengthening of the working day may be compensated for by making amends in the form of higher wages.	Bis zu einem gewissen Punkt kann der von Verlängerung des Arbeitstags untrennbare größere Verschleiß der Arbeitskraft durch größeren Ersatz kompensiert werden.	ch17_clean.en-ch17_clean.de
But beyond this point deterioration increases in geometrical progression, and all the requirements for the normal reproduction and functioning of labour-power cease to be fulfilled.	Über diesen Punkt hinaus wächst der Verschleiß in geometrischer Progression und werden zugleich alle normalen Reproduktions- und Betätigungsbedingungen der Arbeitskraft zerstört.	ch17_clean.en-ch17_clean.de
The price of labour-power and the degree of its exploitation cease to be commensurable quantities.	Der Preis der Arbeitskraft und ihr Exploitationsgrad hören auf, miteinander kommensurable Größen zu sein.	ch17_clean.en-ch17_clean.de
4. SIMULTANEOUS VARIATIONS IN THE DURATION, PRODUCTIVITY AND INTENSITY OF LABOUR It is obvious that a large number of combinations are possible here.	IV. Gleichzeitige Variationen in Dauer, Produktivkraft und Intensität der Arbeit Es ist hier offenbar eine große Anzahl Kombinationen möglich.	ch17_clean.en-ch17_clean.de
Any two of the factors may vary and the third remain constant, or all three may vary at once.	Je zwei Faktoren können variieren und einer konstant bleiben, oder alle drei können gleichzeitig variieren.	ch17_clean.en-ch17_clean.de
They may vary equally or unequally, in the same direction or in opposed directions, with the result that the variations cancel each other out, either wholly or in part.	Sie können in gleichem oder ungleichem Grad variieren, in derselben oder entgegengesetzter Richtung, ihre Variationen sich daher teilweis oder ganz aufheben.	ch17_clean.en-ch17_clean.de
Nevertheless, every possible case can easily be analysed by using the results obtained in cases I, II and III.	Indes ist die Analyse aller möglichen Fälle nach den unter I, II und III gegebenen Aufschlüssen leicht.	ch17_clean.en-ch17_clean.de
The effect of every possible combination may be found by treating each factor in turn as variable, and the other two as constant for the time being.	Man findet das Resultat jeder möglichen Kombination, indem man der Reihe nach je einen Faktor als variabel und die andren zunächst als konstant behandelt.	ch17_clean.en-ch17_clean.de
We shall therefore restrict ourselves here to a brief discussion of two important cases.	Wir nehmen hier daher nur noch kurze Notiz von zwei wichtigen Fällen.	ch17_clean.en-ch17_clean.de
(1) Diminishing productivity of labour with simultaneous lengthening of the working day In speaking here of diminishing productivity of labour, we are particularly concerned with those industries whose products determine the value of labour-power; we have in mind, for example, diminishing productivity resulting from the decreasing fertility of the soil, and from the corresponding increase in the prices of its products.	1. Abnehmende Produktivkraft der Arbeit mit gleichzeitiger Verlängerung des Arbeitstags: Wenn wir hier von abnehmender Produktivkraft der Arbeit sprechen, so handelt es sich von Arbeitszweigen, deren Produkte den Wert der Arbeitskraft bestimmen, also z.B. von abnehmender Produktivkraft der Arbeit infolge zunehmender Unfruchtbarkeit des Bodens und entsprechender Verteurung der Bodenprodukte.	ch17_clean.en-ch17_clean.de
Assume a working day of 12 hours and a value-product of 6 shillings, half of which replaces the value of the labour-power, the other half forming the surplus-value.	Der Arbeitstag sei zwölfstündig, sein Wertprodukt 6 sh., wovon die Hälfte den Wert der Arbeitskraft ersetze, die andre Hälfte Mehrwert bilde.	ch17_clean.en-ch17_clean.de
Then let a rise in the prices of the products of the soil occur, so that the value of labour-power goes up from 3 shillings to 4, and the necessary labour-time therefore rises from 6 hours to 8.	Der Arbeitstag zerfällt also in 6 Stunden notwendiger Arbeit und 6 Stunden Mehrarbeit. Infolge der Verteurung der Bodenprodukte steige der Wert der Arbeitskraft von 3 auf 4 sh., also die notwendige Arbeitszeit von 6 auf 8 Stunden.	ch17_clean.en-ch17_clean.de
If the length of the working day remains unaltered, the surplus labour will fall from 6 hours to 4, and the surplus-value from 3 shillings to 2.	Bleibt der Arbeitstag unverändert, so fällt die Mehrarbeit von 6 auf 4 Stunden, der Mehrwert von 3 auf 2 sh.	ch17_clean.en-ch17_clean.de
If the day is lengthened by 2 hours, i.e. from 12 hours to 14 hours, the surplus labour will remain at 6 hours, the surplus-value will remain at 6 shillings, but the relative magnitude of the surplus value will decrease in comparison with the magnitude of the value of labour-power, as measured by the necessary labour-time.	Wird der Arbeitstag um 2 Stunden verlängert, also von 12 auf 14 Stunden, so bleibt die Mehrarbeit 6 Stunden, der Mehrwert 3 sh., aber seine Größe fällt im Vergleich zum Wert der Arbeitskraft, gemessen durch die notwendige Arbeit.	ch17_clean.en-ch17_clean.de
If the day is lengthened by 4 hours, i.e. from 12 hours to 16, the proportional magnitudes of surplus-value and value of labour-power, of surplus labour and necessary labour, will continue unchanged, but the absolute magnitude of surplus-value will rise from 3 shillings to 4, and that of the surplus labour from 6 hours to 8, an increment 1/ of 33 1/ per cent.	Wird der Arbeitstag um 4 Stunden verlängert, von 12 auf 16 Stunden, so bleiben die proportionellen Größen von Mehrwert und Wert der Arbeitskraft, Mehrarbeit und notwendiger Arbeit unverändert, aber die absolute Größe des Mehrwerts wächst von 3 auf 4 sh., die der Mehrarbeit von 6 auf 8 Arbeitsstunden, also um 1/3 oder 331/3%.	ch17_clean.en-ch17_clean.de
Therefore, with diminishing productivity of labour and a simultaneous lengthening of the working day, the absolute magnitude of surplus-value may continue unaltered, at the same time as its relative magnitude diminishes; its relative magnitude may continue unaltered at the same time as its absolute magnitude increases; and, finally, if the working day is lengthened to a sufficient extent, both may increase.	Bei abnehmender Produktivkraft der Arbeit und gleichzeitiger Verlängerung des Arbeitstags kann also die absolute Größe des Mehrwerts unverändert bleiben, während seine proportionelle Größe fällt; seine proportionelle Größe kann unverändert bleiben, während seine absolute Größe wächst, und, je nach dem Grad der Verlängerung, können beide wachsen.	ch17_clean.en-ch17_clean.de
In the period between 1799 and 1815 an increase in the prices of the means of subsistence led in England to a nominal rise in wages, although there was a fall in real wages, as expressed in the quantity of the means of subsistence they would purchase.	Im Zeitraume von 1799 bis 1815 führten die steigenden Preise der Lebensmittel in England eine nominelle Lohnsteigerung herbei, obwohl die wirklichen, in Lebensmitteln ausgedrückten Arbeitslöhne fielen.	ch17_clean.en-ch17_clean.de
From this fact, West and Ricardo drew the conclusion that the diminution in the productivity of agricultural labour had brought about a fall in the rate of surplus-value, and they made this assumption (which was purely a product of their own imagination) the starting-point of important investigations into the relative magnitudes of wages, profits and ground rent. * But as a matter of fact surplus-value had at that time increased both in absolute and in relative magnitude, thanks to the increased intensity of labour, and to the prolongation of the working day which had been forced upon the workers.	Hieraus schlossen West und Ricardo, daß die Verminderung der Produktivität der Ackerbauarbeit ein Fallen der Mehrwertsrate verursacht hätte, und machten diese nur in ihrer Phantasie gültige Annahme zum Ausgangspunkt wichtiger Analysen über das relative Größenverhältnis von Arbeitslohn, Profit und Grundrente.	ch17_clean.en-ch17_clean.de
This was the period in which the right to prolong the working day without any restriction at all became accepted as one of the basic rights of the citizen7; it was also a period especially characterized, on the one hand, by a rapid growth of capital, and, on the other hand, by a rapid growth of pauperism.	Dank der gesteigerten Intensität der Arbeit und der erzwungenen Verlängerung der Arbeitszeit war aber der Mehrwert damals absolut und relativ gewachsen. Es war dies die Periode, worin die maßlose Verlängerung des Arbeitstags sich das Bürgerrecht erwarb , die Periode, speziell charakterisiert durch beschleunigte Zunahme hier des Kapitals, dort des Pauperismus.	ch17_clean.en-ch17_clean.de
(2) Increasing intensity and productivity of labour with simultaneous shortening of the working day Increased productivity and greater intensity of labour both have a similar effect.	2. Zunehmende Intensität und Produktivkraft der Arbeit mit gleichzeitiger Verkürzung des Arbeitstags: Gesteigerte Produktivkraft der Arbeit und ihre wachsende Intensität wirken nach einer Seite hin gleichförmig.	ch17_clean.en-ch17_clean.de
They both augment the mass of articles produced in a given time.	Beide vermehren die in jedem Zeitabschnitt erzielte Produktenmasse.	ch17_clean.en-ch17_clean.de
Both therefore shorten that portion of the working day which the worker needs to produce his means of subsistence or their equivalent.	Beide verkürzen also den Teil des Arbeitstags, den der Arbeiter zur Produktion seiner Lebensmittel oder ihres Äquivalents braucht.	ch17_clean.en-ch17_clean.de
	Die absolute Minimalgrenze des Arbeitstags wird überhaupt gebildet durch diesen seinen notwendigen, aber kontraktiblen Bestandteil.	ch17_clean.en-ch17_clean.de
The minimum length of the working day is fixed by this necessary component, which is however itself capable of further contraction.	Schrumpfte darauf der ganze Arbeitstag zusammen, so verschwände die Mehrarbeit, was unter dem Regime des Kapitals unmöglich.	ch17_clean.en-ch17_clean.de
If the whole working day were to shrink to the length of its necessary component, surplus labour would vanish, something which is impossible under the regime of capital.	Die Beseitigung der kapitalistischen Produktionsform erlaubt, den Arbeitstag auf die notwendige Arbeit zu beschränken.	ch17_clean.en-ch17_clean.de
Only the abolition of the capitalist form of production would permit the reduction of the working day to the necessary labour-time.	Jedoch würde die letztre, unter sonst gleichbleibenden Umständen, ihren Raum ausdehnen.	ch17_clean.en-ch17_clean.de
But even in that case the latter would expand to take up more of the day, and for two reasons: first, because the worker’s conditions of life would improve, and his aspirations become greater, and second, because a part of what is now surplus labour would then count as necessary labour, namely the labour which is necessary for the formation of a social fund for reserve and accumulation.	Einerseits weil die Lebensbedingungen des Arbeiters reicher und seine Lebensansprüche größer. Andrerseits würde ein Teil der jetzigen Mehrarbeit zur notwendigen Arbeit zählen, nämlich die zur Erzielung eines gesellschaftlichen Reserve- und Akkumulationsfonds nötig Arbeit.	ch17_clean.en-ch17_clean.de
The more the productivity of labour increases, the more the working day can be shortened, and the more the working day is shortened, the more the intensity of labour can increase.	Je mehr die Produktivkraft der Arbeit wächst, um so mehr kann der Arbeitstag verkürzt werden, und je mehr der Arbeitstag verkürzt wird, desto mehr kann die Intensität der Arbeit wachsen.	ch17_clean.en-ch17_clean.de
From the point of view of society the productivity of labour also grows when economies are made in its use.	Gesellschaftlich betrachtet, wächst die Produktivität der Arbeit auch mit ihrer Ökonomie.	ch17_clean.en-ch17_clean.de
This implies not only economizing on the means of production, but also avoiding all useless labour.	Diese schließt nicht nur die Ökonomisierung der Produktionsmittel ein, sondern die Vermeidung aller nutzlosen Arbeit.	ch17_clean.en-ch17_clean.de
The capitalist mode of production, while it enforces economy in each individual business, also begets, by its anarchic system of competition, the most outrageous squandering of labour-power and of the social means of production, not to mention the creation of a vast number of functions at present indispensable, but in themselves superfluous.	Während die kapitalistische Produktionsweise in jedem individuellen Geschäft Ökonomie erzwingt, erzeugt ihr anarchisches System der Konkurrenz die maßloseste Verschwendung der gesellschaftlichen Produktionsmittel und Arbeitskräfte, neben einer Unzahl jetzt unentbehrlicher, aber an und für sich überflüssiger Funktionen.	ch17_clean.en-ch17_clean.de
The intensity and productivity of labour being given, the part of the social working day necessarily taken up with material production is shorter and, as a consequence, the time at society’s disposal for the free intellectual and social activity of the individual is greater, in proportion as work is more and more evenly divided among all the able-bodied members of society, and a particular social stratum is more and more deprived of the ability to shift the burden of labour (which is a necessity imposed by nature) from its own shoulders to those of another social stratum.	Intensität und Produktivkraft der Arbeit gegeben, ist der zur materiellen Produktion notwendige Teil des gesellschaftlichen Arbeitstags um so kürzer, der für freie, geistige und gesellschaftliche Betätigung der Individuen eroberte Zeitteil also um so größer, je gleichmäßiger die Arbeit unter alle werkfähigen Glieder der Gesellschaft verteilt, je weniger eine Gesellschaftsschichte die Naturnotwendigkeit der Arbeit von sich selbst ab- und einer andren Schichte zuwälzen kann.	ch17_clean.en-ch17_clean.de
The absolute minimum limit to the shortening of the working day is, from this point of view, the universality [Allgemeinheit] of labour.	Die absolute Grenze für die Verkürzung des Arbeitstags ist nach dieser Seite hin die Allgemeinheit der Arbeit.	ch17_clean.en-ch17_clean.de
In capitalist society, free time is produced for one class by the conversion of the whole lifetime of the masses into labour-time.	In der kapitalistischen Gesellschaft wird freie Zeit für eine Klasse produziert durch Verwandlung aller Lebenszeit der Massen in Arbeitszeit.	ch17_clean.en-ch17_clean.de

