	SECHZEHNTES KAPITEL Verschiedne Formeln für die Rate des Mehrwerts Man hat gesehn, daß die Rate des Mehrwerts sich darstellt in den Formeln: I. Mehrwert/Variables Kapital (m/v) = Mehrwert/Wert der Arbeitskraft = Mehrarbeit/Notwendige Arbeit.	ch18_clean.en-ch18_clean.de
Chapter 18: Different Formulae for the Rate of Surplus-Value We have seen that the rate of surplus-value is represented by the following formulae: The first two formulae represent, as a ratio of values, what is represented in the third formula as a ratio of the times during which those values are produced.	Die zwei ersten Formen stellen als Verhältnis von Werten dar, was die dritte als Verhältnis der Zeiten, worin diese Werte produziert werden.	ch18_clean.en-ch18_clean.de
These mutually replaceable formulae are rigorously definite and correct.	Diese einander ersetzenden Formeln sind begrifflich streng.	ch18_clean.en-ch18_clean.de
We therefore find them worked out in classical political economy in substance, but not in a conscious form.	Man findet sie daher wohl der Sache nach, aber nicht bewußt ausgearbeitet in der klassischen politischen Ökonomie.	ch18_clean.en-ch18_clean.de
	Hier begegnen wir dagegen den folgenden abgleiteten Formeln: II. Mehrarbeit /Arbeitstag <In der autorisierten französischen Ausgabe setzt Marx diese erste Formel in Klammern, "weil sich der Begriff der Mehrarbeit in der bürgerlichen politischen Ökonomie nicht klar ausgedrückt findet".> = Mehrwert/Produktenwert = Mehrprodukt/Gesamtprodukt.	ch18_clean.en-ch18_clean.de
Political economy in fact provides us with derivative formulae, as follows: * One and the same proportion is expressed here alternately in the form of labour-times, of the values in which those labour-times are embodied, and of the products in which those values exist.	Eine und dieselbe Proportion ist hier abwechselnd ausgedrückt in der Form der Arbeitszeiten, der Werte, worin sie sich verkörpern, der Produkte, worin diese Werte existieren.	ch18_clean.en-ch18_clean.de
It is of course understood that by ‘value of the product’ the political economists mean only the value newly created in a working day, the constant part of the value of the product being excluded.	Es wird natürlich unterstellt, daß unter Wert des Produkts nur das Wertprodukt des Arbeitstags zu verstehn, der konstante Teil des Produktenwerts aber ausgeschlossen ist.	ch18_clean.en-ch18_clean.de
In all the formulae included under II the actual degree of exploitation of labour, or the rate of surplus-value, is falsely expressed.	In allen diesen Formeln ist der wirkliche Exploitationsgrad der Arbeit oder die Rate des Mehrwerts falsch ausgedrückt.	ch18_clean.en-ch18_clean.de
Let the working day be 12 hours long.	Der Arbeitstag sei 12 Stunden.	ch18_clean.en-ch18_clean.de
Then, making the same assumptions as we have before, the real degree of exploitation of labour will be represented by the following proportions: From the formulae included under II, we get, on the contrary: 6 hours surplus labour/Working day of 12 hours = Surplus-value of 3s./Value-product of 6s. = 50 per cent These derivative formulae express, in reality, only the proportion in which the working day, or the value produced by it, is divided between the capitalist and the worker.	Mit den andren Annahmen unsres früheren Beispiels stellt sich in diesem Fall der wirkliche Exploitationsgrad der Arbeit dar in den Proportionen: 6 Stunden Mehrarbeit/6 Stunden notwendige Arbeit = Mehrwert von 3 sh./Variables Kapital von 3 sh. = 100%. Nach den Formeln II erhalten wir dagegen: 6 Stunden Mehrarbeit/Arbeitstag von 12 Stunden = Mehrwert von 3 sh./Wertprodukt von 6 sh. = 50%. Diese abgeleiteten Formeln drücken in der Tat die Proportion aus, worin der Arbeitstag oder sein Wertprodukt sich zwischen Kapitalist und Arbeiter teilt.	ch18_clean.en-ch18_clean.de
If they are to be treated as direct expressions of the degree of capital’s self-valorization, the following erroneous law would hold good: surplus labour or surplus-value can never reach 100 per cent.	Gelten sie daher als unmittelbare Ausdrücke des Selbstverwertungsgrades des Kapitals, so gilt das falsche Gesetz: Die Mehrarbeit oder der Mehrwert kann nie 100% erreichen.	ch18_clean.en-ch18_clean.de
Since the surplus labour is only an aliquot part of the working day, or since surplus-value is only an aliquot part of the value-product, surplus labour must always be less than the working day, or the surplus-value always less than the total value-product.	Da die Mehrarbeit stets nur einen aliquoten Teil des Arbeitstags oder der Mehrwert stets nur einen aliquoten Teil des Wertprodukts bilden kann, ist die Mehrarbeit notwendigerweise stets kleiner als der Arbeitstag oder der Mehrwert stets kleiner als das Wertprodukt.	ch18_clean.en-ch18_clean.de
In order, however, to attain the ratio of 100: they must be equal.	Um sich zu verhalten wie 100/100, müßten sie aber gleich sein.	ch18_clean.en-ch18_clean.de
In order for the surplus labour to absorb the whole day (i.e. an average day of any week or year) the necessary labour would have to sink to zero.	Damit die Mehrarbeit den ganzen Arbeitstag absorbiere (es handelt sich hier um den Durchschnittstag der Arbeitswoche, des Arbeitsjahrs usw.), müßte die notwendige Arbeit auf Null sinken.	ch18_clean.en-ch18_clean.de
But if necessary labour vanishes, surplus labour does as well, since it is only a function of the necessary labour.	Verschwindet aber die notwendige Arbeit, so verschwindet auch die Mehrarbeit, da letztre nur eine Funktion der ersten.	ch18_clean.en-ch18_clean.de
The ratio Surplus labour/Working day, or Surplus-value/Value-product can therefore never reach the limit of 100/100, still less rise to 100+x/100.	Die Proportion Mehrarbeit/Arbeitstag = Mehrwert/Wertprodukt kann also niemals die Grenze 100/100 erreichen und noch weniger auf 100+x/100 steigen.	ch18_clean.en-ch18_clean.de
The rate of surplus-value, however, the real degree of exploitation of labour, is able to do this.	Wohl aber die Rate des Mehrwerts oder der wirkliche Exploitationsgrad der Arbeit.	ch18_clean.en-ch18_clean.de
Take, for example, the estimate of L. de Lavergne, according to which the English agricultural labourer gets only 1/ of the product or of its value, while the capitalist farmer gets 3/4, whatever the subsequent division of the booty between the capitalist, the landowner and others.	Nimm z.B. die Schätzung des Herrn L. de Lavergne, wonach der englische Ackerbauarbeiter nur 1/4, der Kapitalist (Pächter) dagegen 3/4 des Produkts oder seines Werts erhält, wie die Beute sich immer zwischen Kapitalist und Grundeigentümer usw. nachträglich weiter verteilt.	ch18_clean.en-ch18_clean.de
On this calculation, the surplus labour of the English agricultural labourer is related to his necessary labour in the ratio of 3:1, which gives a rate of exploitation of 300 per cent.	Die Mehrarbeit des englischen Landarbeiters verhält sich danach zu seiner notwendigen Arbeit = 3 : 1, ein Prozentsatz der Exploitation von 300%.	ch18_clean.en-ch18_clean.de
Through the use of the formulae given under II, the political economists’ favourite method of treating the working day as constant in magnitude became a fixed usage, because in those formulae surplus labour is always compared with a working day of a given length.	Die Schulmethode, den Arbeitstag als konstante Größe zu behandeln, wurde durch Anwendung der Formeln II befestigt, weil man hier die Mehrarbeit stets mit einem Arbeitstag von gegebner Größe vergleicht. Ebenso, wenn die Teilung des Wertprodukts ausschließlich ins Auge gefaßt wird.	ch18_clean.en-ch18_clean.de
When the political economists treat surplus-value and the value of labour-power as fractions of the value-product – a mode of presentation which arises, by the way, out of the capitalist mode of production itself, and whose significance we shall unearth later on – they conceal the specific character of the capital-relation, namely the fact that variable capital is exchanged for living labour-power, and that the worker is accordingly excluded from the product.	Der Arbeitstag, der sich bereits in einem Wertprodukt vergegenständlicht hat, ist stets ein Arbeitstag von gegebenen Grenzen. Die Darstellung von Mehrwert und Wert der Arbeitskraft als Bruchteilen des Wertprodukts - eine Darstellungsweise, die übrigens aus der kapitalistischen Produktionsweise selbst erwächst und deren Bedeutung sich später erschließen wird - versteckt den spezifischen Charakter des Kapitalverhältnisses, nämlich den Austausch des variablen Kapitals mit der lebendigen Arbeitskraft und den entsprechenden Ausschluß des Arbeiters vom Produkt.	ch18_clean.en-ch18_clean.de
Instead of revealing the capital-relation they show us the false semblance of a relation of association, in which worker and capitalist divide the product in proportion to the different elements which they respectively contribute towards its formation.	An die Stelle tritt der falsche Schein eines Assoziationsverhältnisses, worin Arbeiter und Kapitalist das Produkt nach dem Verhältnis seiner verschiednen Bildungsfaktoren teilen.	ch18_clean.en-ch18_clean.de
But in any case, the formulae given under III can always be reconverted into the original formulae.	Übrigens sind die Formeln II stets in die Formeln I rückverwandelbar.	ch18_clean.en-ch18_clean.de
If, for instance, we have Surplus labour of 6 hours/Working day of 12 hours then the necessary labour-time is the 12 hours of the working day minus the surplus labour of 6 hours, and we get the following result: Surplus labour of 6 hours/Necessary labour of 6 hours = 100/ There is a third formula, which I have occasionally anticipated: III.	Haben wir z.B. Mehrarbeit von 6 Stunden/Arbeitstag von 12 Stunden, so ist die notwendige Arbeitszeit = Arbeitstag von zwölf Stunden minus Mehrarbeit von sechs Stunden, und so ergibt sich: Mehrarbeit von 6 Stunden/Notwendige Arbeit von 6 Stunden = 100/100. Eine dritte Formel, die ich gelegentlich schon antizipiert habe, ist: III. Mehrwert/Wert der Arbeitskraft = Mehrarbeit/Notwendige Arbeit = Unbezahlte Arbeit/Bezahlte Arbeit.	ch18_clean.en-ch18_clean.de
Surplus-value/Value of labour-power = Surplus labour/Necessary labour = Unpaid labour/Paid labour After the analysis given above, it is no longer possible to be misled by the formula unpaid labour/paid labour into concluding that the capital list pays for labour and not for labour-power.	Das Mißverständnis, wozu die Formel Unbezahlte Arbeit/Bezahlte Arbeit verleiten könnte, als zahle der Kapitalist die Arbeit und nicht die Arbeitskraft, fällt nach der früher gegebenen Entwicklung fort.	ch18_clean.en-ch18_clean.de
Unpaid labour/Paid labour is only a popular expression for sulplus labour/necessary labour.	Unbezahlte Arbeit/Bezahlte Arbeit ist nur populärer Ausdruck für Mehrarbeit/Notwendige Arbeit.	ch18_clean.en-ch18_clean.de
The capitalist necessary labour pays the value of the labour-power (or, if the price diverges from this, he pays the price) and receives in exchange the right to dispose of the living labour-power itself.	Der Kapitalist zahlt den Wert, resp. davon abweichenden Preis der Arbeitskraft und erhält im Austausch die Verfügung über die lebendige Arbeitskraft selbst.	ch18_clean.en-ch18_clean.de
The length of time during which he utilizes this labour-power is divided into two separate periods.	Seine Nutznießung dieser Arbeitskraft zerfällt in zwei Perioden.	ch18_clean.en-ch18_clean.de
During one period, the worker produces a value that is only equal to the value of his labour-power, i.e. he produces its equivalent.	Während der einen Periode produziert der Arbeiter nur einen Wert = Wert seiner Arbeitskraft, also nur ein Äquivalent.	ch18_clean.en-ch18_clean.de
Thus the capitalist receives, in return for advancing the price of the labour-power, a product of the same price.	Für den vorgeschoßnen Preis der Arbeitskraft erhält so der Kapitalist ein Produkt vom selben Preis.	ch18_clean.en-ch18_clean.de
It is the same as if he had bought the product ready-made in the market.	Es ist, als ob er das Produkt fertig auf dem Markt gekauft hätte.	ch18_clean.en-ch18_clean.de
During the other period, the period of surplus labour, the utilization of the labour-power creates a value for the capitalist without costing him any value in return4.	In der Periode der Mehrarbeit dagegen bildet die Nutznießung der Arbeitskraft Wert für den Kapitalisten, ohne ihm einen Wertersatz zu kosten.	ch18_clean.en-ch18_clean.de
He is thus able to set labour-power in motion without paying for it.	Er hat diese Flüssigmachung der Arbeitskraft umsonst.	ch18_clean.en-ch18_clean.de
It is in this sense that surplus labour can be called unpaid labour.	In diesem Sinn kann die Mehrarbeit unbezahlte Arbeit heißen.	ch18_clean.en-ch18_clean.de
Capital, therefore, is not only the command over labour, as Adam Smith thought.	Das Kapital ist also nicht nur Kommando über Arbeit, wie A. Smith sagt.	ch18_clean.en-ch18_clean.de
It is essentially the command over unpaid labour.	Es ist wesentlich Kommando über unbezahlte Arbeit.	ch18_clean.en-ch18_clean.de
All surplus-value, whatever particular form (profit, interest or rent) it may subsequently crystallize into, is in substance the materialization of unpaid labour-time.	Aller Mehrwert, in welcher besondern Gestalt von Profit, Zins, Rente usw. er sich später kristallisiere, ist seiner Substanz nach Materiatur unbezahlter Arbeitszeit.	ch18_clean.en-ch18_clean.de
The secret of the self-valorization of capital resolves itself into the fact that it has at its disposal a definite quantity of the unpaid labour of other people[fremder Arbeit].	Das Geheimnis von der Selbstverwertung des Kapitals löst sich auf in seine Verfügung über ein bestimmtes Quantum unbezahlter fremder Arbeit.	ch18_clean.en-ch18_clean.de

