Chapter 20: Time-Wages Wages themselves again take many forms.		ch20_clean.en-ch20_clean.de
This fact is not apparent from the ordinary economic treatises, which, in their crude obsession with the material side [Stoff], ignore all differences of form.	ACHTZEHNTES KAPITEL Der Zeitlohn Der Arbeitslohn nimmt selbst wieder sehr mannigfaltige Formen an, ein Umstand, nicht erkennbar aus den ökonomischen Kompendien, die in ihrer brutalen Interessiertheit für den Stoff jeden Formunterschied vernachlässigen.	ch20_clean.en-ch20_clean.de
An exposition of all these forms belongs to the special study of wage-labour, and not, therefore, to this work.	Eine Darstellung aller dieser Formen gehört jedoch in die spezielle Lehre von der Lohnarbeit, also nicht in dieses Werk.	ch20_clean.en-ch20_clean.de
Nevertheless, we shall have to give a brief description of the two fundamental forms here.	Dagegen sind die zwei herrschenden Grundformen hier kurz zu entwickeln.	ch20_clean.en-ch20_clean.de
The sale of labour-power, as will be remembered, always takes place for definite periods of time.	Der Verkauf der Arbeitskraft findet, wie man sich erinnert, stets für bestimmte Zeitperioden statt.	ch20_clean.en-ch20_clean.de
The converted form in which the daily value, weekly value, etc. of labour-power is directly presented is hence that of time-wages, therefore day-wages, etc. Next it is to be noted that the laws set forth in Chapter 17, on the changes in the relative magnitudes of price of labour-power and surplus-value, can be transformed, by a simple alteration in their form, into laws of wages.	Die verwandelte Form, worin der Tageswert, Wochenwert usw. der Arbeitskraft sich unmittelbar darstellt, ist daher die des "Zeitlohns", also Tageslohn usw. Es ist nun zunächst zu bemerken, daß die im fünfzehnten Kapitel dargestellten Gesetze über den Größenwechsel von Preis der Arbeitskraft und Mehrwert sich durch einfache Formveränderung in Gesetze des Arbeitslohns verwandeln.	ch20_clean.en-ch20_clean.de
Similarly, the distinction between the exchange-value of labour-power and the sum of means of subsistence into which this value is converted now appears as the distinction between nominal and real wages.	Ebenso erscheint der Unterschied zwischen dem Tauschwert der Arbeitskraft und der Masse der Lebensmittel, worin sich dieser Wert umsetzt, jetzt als Unterschied von nominellem und reellem Arbeitslohn.	ch20_clean.en-ch20_clean.de
It would be useless to repeat here, when dealing with the form of appearance, what we have already worked out in relation to the essential form.	Es wäre nutzlos, in der Erscheinungsform zu wiederholen, was in der wesentlichen Form bereits entwickelt.	ch20_clean.en-ch20_clean.de
We shall therefore limit ourselves to a few points which characterize time-wages.	Wir beschränken uns daher auf wenige, den Zeitlohn charakterisierende Punkte.	ch20_clean.en-ch20_clean.de
The sum of money which the worker receives for his daily or weekly labour forms the amount of his nominal wages, or of his wages estimated in value.	Die Geldsumme , die der Arbeiter für seine Tagesarbeit, Wochenarbeit usw. erhält, bildet den Betrag seines nominellen oder dem Wert nach geschätzten Arbeitslohns.	ch20_clean.en-ch20_clean.de
But it is clear that according to the length of the working day, that is, according to the amount of actual labour supplied every day, the same daily or weekly wage may represent very different prices of labour, i.e. very different sums of money for the same quantity of labour.	Es ist aber klar, daß je nach der Länge des Arbeitstags, also je nach der täglich von ihm gelieferten Quantität Arbeit, derselbe Tageslohn, Wochenlohn usw. einen sehr verschiednen Preis der Arbeit, d.h. sehr verschiedne Geldsummen für dasselbe Quantum Arbeit darstellen kann.	ch20_clean.en-ch20_clean.de
We must, therefore, in considering time-wages, again distinguish between the sum total of the daily or weekly wages, etc., and the price of labour.	Man muß also bei dem Zeitlohn wieder unterscheiden zwischen Gesamtbetrag des Arbeitslohns, Taglohns, Wochenlohns usw. und Preis der Arbeit.	ch20_clean.en-ch20_clean.de
How then can we find this price, i.e. the money-value of a given quantity of labour?	Wie nun diesen Preis finden, d.h. den Geldwert eines gegebnen Quantums Arbeit?	ch20_clean.en-ch20_clean.de
The average price of labour is the average daily value of labour-power divided by the average number of hours in the working day.	Der durchschnittliche Preis der Arbeit ergibt sich, indem man den durchschnittlichen Tageswert der Arbeitskraft durch die Stundenzahl des durchschnittlichen Arbeitstags dividiert.	ch20_clean.en-ch20_clean.de
If, for instance, the daily value of labour-power is 3 shillings, which is the value-product of 6 working hours, and if the working day is 12 hours, the price of 1 working hour is 3 8/ shillings, i.e. 3d. The price of the working hour thus found serves as the unit measure for the price of labour.	Ist z.B. der Tageswert der Arbeitskraft 3 sh., das Wertprodukt von 6 Arbeitsstunden, und ist der Arbeitstag zwölfstündig, so ist der Preis einer Arbeitsstunde = 3 sh./12 = 3 d. Der so gefundene Preis der Arbeitsstunde dient als Einheitsmaß für den Preis der Arbeit.	ch20_clean.en-ch20_clean.de
It follows therefore that daily and weekly wages may remain the same, although the price of labour falls constantly.	Es folgt daher, daß der Taglohn, Wochenlohn usw. derselbe bleiben kann, obgleich der Preis der Arbeit fortwährend sinkt.	ch20_clean.en-ch20_clean.de
If, for example, the usual working day is 10 hours and the daily value of labour-power 3 shillings, the price of the working hour is 3 3/5d. It falls to 3d. as soon as the working day rises to 12 hours, and to 2 2/5d. as soon as it rises to 15 hours.	War z.B. der gewohnheitsmäßige Arbeitstag 10 Stunden und der Tageswert der Arbeitskraft 3 sh., so betrug der Preis der Arbeitsstunde 33/5 d.; er sinkt auf 3 d., sobald der Arbeitstag zu 12 Stunden, und 22/5 d., sobald er zu 15 Stunden steigt.	ch20_clean.en-ch20_clean.de
Despite all this, daily or weekly wages remain unchanged.	Tages- oder Wochenlohn bleiben trotzdem unverändert.	ch20_clean.en-ch20_clean.de
Inversely, daily or weekly wages may rise, although the price of labour remains constant or even falls.	Umgekehrt kann der Taglohn oder Wochenlohn steigen, obgleich der Preis der Arbeit konstant bleibt oder selbst sinkt.	ch20_clean.en-ch20_clean.de
If, for instance, the working day is 10 hours and the daily value of labour-power 3 shillings, the price of one working hour is 3 3/5d. If the worker, owing to an increase in the number of orders, works for 12 hours, and the price of labour remains the same, his daily wage now rises to 3s.	War z.B. der Arbeitstag zehnstündig und ist der Tageswert der Arbeitskraft 3 sh., so der Preis einer Arbeitsstunde 33/5 d. Arbeitet der Arbeiter infolge zunehmender Beschäftigung und bei gleichbeibendem Preise der Arbeit 12 Stunden, so steigt sein Tageslohn nun auf 3 sh.	ch20_clean.en-ch20_clean.de
1/5d., without any variation having taken place in the price of labour.	71/5 d. ohne Variation im Preise der Arbeit.	ch20_clean.en-ch20_clean.de
The same result might follow if, instead of the extensive magnitude of labour, its intensive magnitude increased.	Dasselbe Resultat könnte herauskommen, wenn statt der extensiven Größe der Arbeit ihre intensive Größe zunähme.	ch20_clean.en-ch20_clean.de
The rise of nominal daily or weekly wages may therefore be unaccompanied by any change in the price of labour, or may even be accompanied by a fall in the latter.	Steigen des nominellen Tages- oder Wochenlohns mag daher begleitet sein von gleichbleibendem oder sinkendem Preis der Arbeit.	ch20_clean.en-ch20_clean.de
The same thing holds for the income of the worker’s family, when the quantity of labour provided by the head of the family is augmented by the labour of the members of his family.	Dasselbe gilt von der Einnahme der Arbeiterfamilie, sobald das vom Familienhaupt gelieferte Arbeitsquantum durch die Arbeit der Fami- lienglieder vermehrt wird.	ch20_clean.en-ch20_clean.de
There are therefore methods of lowering the price of labour which are independent of any reduction in the nominal daily or weekly wage.	Es gibt also von der Schmälerung des nominellen Tages- oder Wochenlohns unabhängige Methoden zur Herabsetzung des Preises der Arbeit.	ch20_clean.en-ch20_clean.de
However, as a general law it follows that, given the amount of daily, weekly labour, etc., the daily or weekly wage depends on the price of labour, which itself varies either with the value of labour-power, or with the divergencies between its price and its value.	Als allgemeines Gesetz aber folgt: Ist die Quantität der Tages-, Wochenarbeit usw. gegeben, so hängt der Tages- oder Wochenlohn vom Preise der Arbeit ab, der selbst variiert, entweder mit dem Wert der Arbeitskraft oder den Abweichungen ihres Preises von ihrem Werte.	ch20_clean.en-ch20_clean.de
Given the price of labour, on the other hand, the daily or weekly wage depends on the quantity of labour expended daily or weekly.	Ist dagegen der Preis der Arbeit gegeben, so hängt der Tages- oder Wochenlohn von der Quantität der Tages- oder Wochenarbeit ab.	ch20_clean.en-ch20_clean.de
The unit of measurement for time-wages, the price of the working hour, is the value of a day’s labour-power divided by the number of hours in the average working day.	Die Maßeinheit des Zeitlohns, der Preis der Arbeitsstunden, ist der Quotient des Tageswerts der Arbeitskraft, dividiert durch die Stundenzahl des gewohnheitsmäßigen Arbeitstags.	ch20_clean.en-ch20_clean.de
Let the latter be 12 hours, and the daily value of labour-power 3 shillings, the value-product of 6 hours of labour.	Gesetzt, letztrer betrage 12 Stunden, der Tageswert der Arbeitskraft 3 sh., das Wertprodukt von 6 Arbeitsstunden.	ch20_clean.en-ch20_clean.de
Under these circumstances, the price of a working hour is 3d., and the value produced in it is 6d. If the worker is now employed for less than 12 hours a day (or for less than 6 days in the week), for instance only for 6 or 8 hours, he receives, at the price of labour just mentioned, only 2s. or 1s.	Der Preis der Arbeitsstunde ist unter diesen Umständen 3 d., ihr Wertprodukt 6 d. Wird der Arbeiter nun weniger als 12 Stunden täglich (oder weniger als 6 Tage in der Woche) beschäftigt, z.B. nur 6 oder 8 Stunden, so erhält er, bei diesem Preise der Arbeit, nur 2 oder 11/2 sh.	ch20_clean.en-ch20_clean.de
6d. a day.	Taglohn.	ch20_clean.en-ch20_clean.de
As, on our hypothesis, he must work on average 6 hours a day in order to produce a day’s wage which corresponds to nothing more than the value of his labour-power, and as, on the same hypothesis, he works only half of every hour for himself, and half for the capitalist, it is clear that he cannot obtain for himself the value-product of 6 hours if he is employed for less than 12 hours.	Da er nach der Voraussetzung im Durchschnitt 6 Stunden täglich arbeiten muß, um nur einen dem Wert seiner Arbeitskraft entsprechenden Taglohn zu produzieren, da er nach derselben Voraussetzung von jeder Stunde nur 1/2 für sich selbst, 1/2 aber für den Kapitalisten arbeitet, so ist es klar, daß er das Wertprodukt von 6 Stunden nicht herausschlagen kann, wenn er weniger als 12 Stunden beschäftigt wird.	ch20_clean.en-ch20_clean.de
In previous chapters we saw the destructive consequences of overwork; but here we come upon the origin of the sufferings which arise for the worker out of his being insufficiently employed.	Sah man früher die zerstörenden Folgen der Überarbeit, so entdeckt man hier die Quellen der Leiden, die für den Arbeiter aus seiner Unterbeschäftigung entspringen.	ch20_clean.en-ch20_clean.de
If the hour’s wage is fixed in such a way that the capitalist does not bind himself to pay a day’s or a week’s wage, but only to pay wages for the hours during which he chooses to employ the worker, he can employ him for a shorter time than that which is originally the basis of the calculation of the wages for the hour, or the unit of measurement of the price of labour.	Wird der Stundenlohn in der Weise fixiert, daß der Kapitalist sich nicht zur Zahlung eines Tages- oder Wochenlohns verpflichtet, sondern nur zur Zahlung der Arbeitsstunden, während deren es ihm beliebt, den Arbeiter zu beschäftigen, so kann er ihn unter der Zeit beschäftigen, die der Schätzung des Stundenlohns oder der Maßeinheit für den Preis der Arbeit ursprünglich zugrunde liegt.	ch20_clean.en-ch20_clean.de
Since this unit is determined by the ratio of the daily value of labour-power to the working day of a given number of hours, it naturally loses all meaning as soon as the working day ceases to contain a definite number of hours.	Da diese Maßeinheit bestimmt ist durch die Proportion Tageswert der Arbeitskraft)/Arbeitstag von gegebner Stundenzahl, verliert sie natürlich allen Sinn, sobald der Arbeitstag aufhört, eine bestimmte Stundenzahl zu zählen.	ch20_clean.en-ch20_clean.de
The connection between the paid and the unpaid labour is destroyed.	Der Zusammenhang zwischen der bezahlten und unbezahlten Arbeit wird aufgehoben.	ch20_clean.en-ch20_clean.de
The capitalist can now wring from the worker a certain quantity of surplus labour without allowing him the labour-time necessary for his own subsistence.	Der Kapitalist kann jetzt ein bestimmtes Quantum Mehrarbeit aus dem Arbeiter herausschlagen, ohne ihm die zu seiner Selbsterhaltung notwendige Arbeitszeit einzuräumen.	ch20_clean.en-ch20_clean.de
He can annihilate all regularity of employment, and according to his own convenience, caprice, and the interest of the moment, make the most frightful over-work alternate with relative or absolute cessation of work.	Er kann jede Regelmäßigkeit der Beschäftigung vernichten und ganz nach Bequemlichkeit, Willkür und augenblicklichem Interesse die ungeheuerste Überarbeit mit relativer oder gänzlicher Arbeitslosigkeit abwechseln lassen.	ch20_clean.en-ch20_clean.de
He can abnormally lengthen the working day without giving the worker any corresponding compensation, under the pretence of paying ‘the normal price of labour’.	Er kann, unter dem Vorwand, den "normalen Preis der Arbeit" zu zahlen, den Arbeitstag, ohne irgend entsprechende Kompensation für den Arbeiter, anormal verlängern.	ch20_clean.en-ch20_clean.de
Hence the perfectly rational revolt of the London building workers in 1860* against the attempt of the capitalists to impose on them this sort of wage by the hour.	Daher der durchaus rationelle Aufstand der im Baufach beschäftigten Londoner Arbeiter gegen den Versuch der Kapitalisten, diesen Stundenlohn aufzuherrschen.	ch20_clean.en-ch20_clean.de
The legal limitation of the working day puts an end to mischievous acts of this kind, though it does not of course end the diminution of employment caused by the competition of machinery, by changes in the quality of the workers employed, and partial or general crises.	Die gesetzliche Beschränkung des Arbeitstags macht solchem Unfug ein Ende, obgleich natürlich nicht der aus Konkurrenz der Maschinerie, Wechsel in der Qualität der angewandten Arbeiter, partiellen und allgemeinen Krisen entspringenden Unterbeschäftigung.	ch20_clean.en-ch20_clean.de
With an increase in the daily or weekly wage, the price of labour may remain nominally constant, and yet fall below its normal level.	Bei wachsendem Tages- oder Wochenlohn kann der Preis der Arbeit nominell konstant bleiben und dennoch unter sein normales Niveau sinken.	ch20_clean.en-ch20_clean.de
This occurs every time the working day is prolonged beyond its customary length, while the price of labour (reckoned per working hour) remains constant.	Dies findet jedesmal statt, sobald mit konstantem Preis der Arbeit, resp. der Arbeitsstunde, der Arbeitstag über seine gewohnheitsmäßige Dauer verlängert wird.	ch20_clean.en-ch20_clean.de
If, in the fraction daily value of labour-power/working day, the denominator increases, working day the numerator increases still more rapidly.	Wenn in dem Bruch Tageswert der Arbeitskraft/Arbeitstag der Nenner wächst, wächst der Zähler noch rascher.	ch20_clean.en-ch20_clean.de
The amount of deterioration in labour-power, and therefore its value, increases with the duration of its functioning, and to a more rapid degree than the increase of that duration.	Der Wert der Arbeitskraft, weil ihr Verschleiß, wächst mit der Dauer ihrer Funktion und in rascherer Proportion als das Inkrement ihrer Funktionsdauer.	ch20_clean.en-ch20_clean.de
In many branches of industry, where time-wages are the general rule and there are no legal limits to the length of the working day, the habit has therefore spontaneously grown up of regarding the working day as normal only up to a point in time, for instance up to the expiration of the tenth hour (‘normal working day’, ‘the day’s work’, ‘the regular hours of work’).	In vielen Industriezweigen, wo Zeitlohn vorherrscht, ohne gesetzliche Schranken der Arbeitszeit, hat sich daher naturwüchsig die Gewohnheit herausgebildet, daß der Arbeitstag nur bis zu einem gewissen Punkt, z.B. bis zum Ablauf der zehnten Stunde, als normal gilt ("normal working day", "the day's work", "the regular hours of work <"normaler Arbeitstag", "Tagesarbeit", "reguläre Arbeitszeit">).	ch20_clean.en-ch20_clean.de
Beyond this limit the working time is overtime, and is paid at a better hourly rate (‘extra pay)’, although often in a proportion which is ridiculously small.	Jenseits dieser Grenze bildet die Arbeitszeit Überzeit (overtime) und wird, die Stunde als Maßeinheit genommen, besser bezahlt (extra pay), obgleich oft in lächerlich kleiner Proportion.	ch20_clean.en-ch20_clean.de
The normal working day exists here as a fraction of the actual working day, and over the year as a whole the latter is often more common than the former.	Der normale Arbeitstag existiert hier als Bruchteil des wirklichen Arbeitstags, und der letztere währt oft während des ganzen Jahres länger als der erstere.	ch20_clean.en-ch20_clean.de
The increase in the price of labour when the working day is extended beyond a certain normal limit takes place in various British industries in such a way that the low price of labour during the so-called normal time compels the worker to work during the better paid overtime, if he wishes to obtain a sufficient wage at all.8Legal limitation of the working day puts an end to this pastime.	Der Wachstum im Preis der Arbeit mit der Verlängerung des Arbeitstags über eine gewisse Normalgrenze gestaltet sich in verschiednen britischen Industriezweigen so, daß der niedrige Preis der Arbeit während der sog. Normalzeit dem Arbeiter die besser bezahlte Überzeit aufzwingt, will er überhaupt einen genügenden Arbeitslohn herausschlagen. Gesetzliche Beschränkung des Arbeitstags macht diesem Vergnügen ein Ende.	ch20_clean.en-ch20_clean.de
It is a generally known fact that the longer the working day in a branch of industry, the lower the wages are.	Es ist allgemein bekannte Tatsache, daß, je länger der Arbeitstag in einem Industriezweig, um so niedriger der Arbeitslohn.	ch20_clean.en-ch20_clean.de
The factory inspector Alexander Redgrave illustrates this by a comparative review of the twenty years from 1839 to 1859, according to which wages rose in the factories under the Ten Hours’ Act, while they fell in the factories where the work went on for 14 and 15 hours every day.	Fabrikinspektor A. Redgrave illustriert dies durch eine vergleichende Übersicht der zwanzigjährigen Periode von 1839-1859, wonach der Arbeitslohn in den dem Zehnstundengesetz unterworfenen Fabriken stieg, während er fiel in den Fabriken, wo 14 bis 15 Stunden täglich gearbeitet wird.	ch20_clean.en-ch20_clean.de
From the law stated above,* namely that the price of labour being given, the daily or weekly wage depends on the quantity of labour expended, it follows, first of all, that the lower the price of labour, the greater must be the quantity of labour, or the longer must be the working day, for the worker to secure even a miserable average wage.	Zunächst folgt aus dem Gesetz: "Bei gegebnem Preis der Arbeit hängt der Tages- oder Wochenlohn von der Quantität der gelieferten Arbeit ab", daß, je niedriger der Preis der Arbeit, desto größer das Arbeitsquantum sein muß oder desto länger der Arbeitstag, damit der Arbeiter auch nur einen kümmerlichen Durchschnittslohn sichre.	ch20_clean.en-ch20_clean.de
The low level of the price of labour acts here as a stimulus to the extension of the labour-time.	Die Niedrigkeit des Arbeitspreises wirkt hier als Sporn zur Verlängerung der Arbeitszeit.	ch20_clean.en-ch20_clean.de
However, the extension of the period of labour produces in its turn a fall in the price of labour, and with this a fall in the daily or the weekly wage.	Umgekehrt aber produziert ihrerseits die Verlängerung der Arbeitszeit einen Fall im Arbeitspreise und damit im Tages- oder Wochenlohn.	ch20_clean.en-ch20_clean.de
The determination of the price of labour by use of the ratio daily value of labour-power/working day of a given number of hours shows that a mere prolongation of the working day lowers the price of labour, if no compensatory factor enters.	Die Bestimmung des Arbeitspreises durch Tageswert der Arbeitskraft/Arbeitstag von gegebner Stundenzahl ergibt, daß bloße Verlängerung des Arbeitstags den Arbeitspreis senkt, wenn keine Kompensation eintritt.	ch20_clean.en-ch20_clean.de
But the same circumstances which allow the capitalist in the long run to prolong the working day also allow him at first, and compel him finally, to reduce the price of labour nominally as well until the total price of the increased number of hours goes down, and therefore the daily or weekly wage falls.	Aber dieselben Umstände, welche den Kapitalisten befähigen, den Arbeitstag auf die Dauer zu verlängern, befähigen ihn erst und zwingen ihn schließlich, den Arbeitspreis auch nominell zu senken, bis der Gesamtpreis der vermehrten Stundenzahl sinkt, also der Tages- oder Wochenlohn.	ch20_clean.en-ch20_clean.de
Here we need only refer to two kinds of circumstance.	Hinweis auf zwei Umstände genügt hier.	ch20_clean.en-ch20_clean.de
If one man does the work of l 1/ or 2 men, the supply of labour increases, although the supply of labour-power on the market remains constant.	Verrichtet ein Mann das Werk von 11/2 oder 2 Männern, so wächst die Zufuhr der Arbeit, wenn auch die Zufuhr der auf dem Markt befindlichen Arbeitskräfte konstant bleibt.	ch20_clean.en-ch20_clean.de
The competition thus created between the workers allows the capitalist to force down the price of labour, while the fall in the price of labour allows him, on the other hand, to force up the hours of work still further.	Die so unter den Arbeitern erzeugte Konkurrenz befähigt den Kapitalisten, den Preis der Arbeit herabzudrücken, während der fallende Preis der Arbeit ihn umgekehrt befähigt, die Arbeitszeit noch weiter heraufzuschrauben.	ch20_clean.en-ch20_clean.de
Soon, however, this command over abnormal quantities of unpaid labour, i.e. quantities in excess of the average social amount, becomes a source of competition amongst the capitalists themselves.	Bald jedoch wird diese Verfügung über anormale, d.h. das gesellschaftliche Durchschnittsniveau überfließende Quanta unbezahlter Arbeit zum Konkurrenzmittel unter den Kapitalisten selbst.	ch20_clean.en-ch20_clean.de
A part of the price of the commodity consists of the price of labour.	Ein Teil des Warenpreises besteht aus dem Preis der Arbeit.	ch20_clean.en-ch20_clean.de
The unpaid part of the price of labour does not need to be reckoned as part of the price of the commodity.	Der nicht gezahlte Teil des Arbeitspreises braucht nicht im Warenpreis zu rechnen.	ch20_clean.en-ch20_clean.de
It may be given to the buyer as a present.	Er kann dem Warenkäufer geschenkt werden.	ch20_clean.en-ch20_clean.de
This is the first step taken under the impulse of competition.	Dies ist der erste Schritt, wozu die Konkurrenz treibt.	ch20_clean.en-ch20_clean.de
The second step, also compelled by competition, is the exclusion from the selling price of the commodity of at least a part of the abnormal surplus-value created by the extension of the working day.	Der zweite Schritt, wozu sie zwingt, ist, wenigstens einen Teil des durch die Verlängerung des Arbeitstags erzeugten anormalen Mehrwerts ebenfalls aus dem Verkaufspreis der Ware auszuschließen.	ch20_clean.en-ch20_clean.de
In this way, an abnormally low selling price of the commodity arises, at first sporadically, and becomes fixed by degrees; this lower selling price henceforward becomes the constant basis of a miserable wage for excessive hours of work, just as originally it was the product of those very circumstances.	In dieser Weise bildet sich erst sporadisch und fixiert sich nach und nach ein anormal niedriger Verkaufspreis der Ware, der von nun an zur konstanten Grundlage kümmerlichen Arbeitslohns bei übermäßiger Arbeitszeit wird, wie er ursprünglich das Produkt dieser Umstände war.	ch20_clean.en-ch20_clean.de
This movement is simply indicated here, as the analysis of competition does not belong to this part of the investigation.	Wir deuten diese Bewegung bloß an, da die Analyse der Konkurrenz nicht hierhin gehört.	ch20_clean.en-ch20_clean.de
Nevertheless, let the capitalist speak for himself, for a moment.	Doch mag für einen Augenblick der Kapitalist selbst sprechen.	ch20_clean.en-ch20_clean.de
‘In Birmingham there is so much competition of masters one against another, that many are obliged to do things as employers that they would otherwise be ashamed of; and yet no more money is made, but only the public gets the benefit.’	"In Birmingham ist die Konkurrenz unter den Meistern so groß, daß mancher von uns gezwungen ist, als Arbeitsanwender zu tun, was er sich schämen würde, sonst zu tun; und dennoch wird nicht mehr Geld gemacht (and yet no more money is made), sondern das Publikum allein hat den Vorteil davon."	ch20_clean.en-ch20_clean.de
	Man erinnert sich der Zwei Sorten Londoner Bäcker, wovon die eine Brot zum vollen Preise (the "fullpriced" backers), die andre es unter seinem normalen Preise verkauft ("the underpriced", "the undersellers").	ch20_clean.en-ch20_clean.de
The reader will remember the two sorts of London bakers, of whom one sold the bread at its full price (the ‘full-priced’ bakers), the other below its normal price (‘the underpnced’, ‘the undersellers’). * The ‘full-priced’ denounced their rivals before the Parliamentary Committee of Inquiry: ‘They only exist now by first defrauding the public, and next getting 18 hours’ work out of their men for 12 hours’ wages… The unpaid labour of the men was made… the source whereby the competition was carried on, and continues so to this day… The competition among the master-bakers is the cause of the difficulty in getting rid of night-work.	Die "fullpriced" denunzieren ihre Konkurrenten vor der parlamentarischen Untersuchungskommission: "Sie existieren nur, indem sie erstens das Publikum betrügen" (durch Fälschung der Ware) "und zweitens 18 Arbeitsstunden aus ihren Leuten für den Lohn zwölfstündiger Arbeit herausschinden ... Die unbezahlte Arbeit (the unpaid labour) der Arbeiter ist das Mittel, wodurch der Konkurrenzkampf geführt wird ... Die Konkurrenz unter den Bäckermeistern ist die Ursache der Schwierigkeit in Beseitigung der Nachtarbeit.	ch20_clean.en-ch20_clean.de
An underseller, who sells his bread below the cost-price according to the price of flour, must make it up by getting more out of the labour of the men… If I got only 12 hours’ work out of my men, and my neighbour got 18 or 20, he must beat me in the selling price.	Ein Unterverkäufer, der sein Brot unter dem mit dem Mehlpreis wechselnden Kostpreis verkauft, hält sich schadlos, indem er mehr Arbeit aus seinen Leuten herausschlägt. Wenn ich nur 12 Stunden Arbeit aus meinen Leuten herausschlage, mein Nachbar dagegen 18 oder 20, muß er mich im Verkaufspreis schlagen.	ch20_clean.en-ch20_clean.de
If the men could insist on payment for overwork, this would be set right… A large number of those, employed by the undersellers are foreigners and youths, who are obliged to accept almost any wages they can obtain.’	Könnten die Arbeiter auf Zahlung für Überzeit bestehen, so wäre es mit diesem Manöver bald zu Ende ... Eine große Anzahl der von den Unterverkäufern Beschäftigten sind Fremde, Jungen und andre, die fast mit jedem Arbeitslohn, den sie kriegen können, vorlieb zu nehmen gezwungen sind."	ch20_clean.en-ch20_clean.de
This jeremiad is also interesting because it shows how it is only the semblance of the relations of production which is reflected by the brain of the capitalist.	Diese Jeremiade ist auch deswegen interessant, weil sie zeigt, wie nur der Schein der Produktionsverhältnisse sich im Kapitalistenhirn widerspiegelt.	ch20_clean.en-ch20_clean.de
He does not know that the normal price of labour also includes a definite quantity of unpaid labour, and that this very unpaid labour is the normal source of his profits.	Der Kapitalist weiß nicht, daß der normale Preis der Arbeit ein bestimmtes Quantum unbezahlter Arbeit einschließt und eben diese unbezahlte Arbeit die normale Quelle seines Gewinns ist.	ch20_clean.en-ch20_clean.de
The category of surplus labour-time does not exist at all for him, since it is included in the normal working day, which he thinks he has paid for in the day’s wages.	Die Kategorie der Mehrarbeitszeit existiert überhaupt nicht für ihn, denn sie ist eingeschlossen im normalen Arbeitstag, den er im Taglohn zu zahlen glaubt.	ch20_clean.en-ch20_clean.de
But overtime, namely the prolongation of the working day beyond the limits corresponding to the usual price of labour, certainly does exist for him.	Wohl aber existiert für ihn die Überzeit, die Verlängerung des Arbeitstags über die dem gewohnten Preis der Arbeit entsprechende Schranke.	ch20_clean.en-ch20_clean.de
When faced with his underselling competitor, he even insists upon extra pay for this overtime.	Seinem unterverkaufenden Konkurrenten gegenüber besteht er sogar auf Extrazahlung (extra pay) für diese Überzeit.	ch20_clean.en-ch20_clean.de
Again, he does not know that this extra pay also includes unpaid labour, just as much as the price of the customary hour of labour does.	Er weiß wieder nicht, daß diese Extrazahlung ebensowohl unbezahlte Arbeit einschießt, wie der Preis der gewöhnlichen Arbeitsstunde.	ch20_clean.en-ch20_clean.de
For example, the price of one hour of the 12-hour working day is 3d., say the value-product of half a working hour, while the price of an overtime working hour is 4d., or the value-product of 2/ of a working hour.	Z.B. der Preis einer Stunde des zwölfstündigen Arbeitstags ist 3 d., das Wertprodukt von 1/2 Arbeitsstunde, während der Preis der überzeitigen Arbeitsstunde 4 d., das Wertprodukt von 2/3 Arbeitsstunde.	ch20_clean.en-ch20_clean.de
In the first case the capitalist appropriates one-half of the working hour, in the second case one third, without making any payment in return.	Im ersten Fall eignet sich der Kapitalist von einer Arbeitsstunde die Hälfte, im andern 1/3 ohne Zahlung an.	ch20_clean.en-ch20_clean.de

