Chapter 21: Piece-Wages The piece-wage is nothing but a converted form of the time-wage, just as the time-wage is a converted form of the value or price of labour-power.	NEUNZEHNTES KAPITEL Der Stücklohn Der Stücklohn ist nichts als verwandelte Form des Zeitlohns, wie der Zeitlohn die verwandelte Form des Wertes oder Preises der Arbeitskraft.	ch21_clean.en-ch21_clean.de
In piece-wages it seems at first sight as if the use-value bought from the worker is not his labour-power as it actually functions, living labour, but labour already objectified in the product.	Beim Stücklohn sieht es auf den ersten Blick aus, als ob der vom Arbeiter verkaufte Gebrauchswert nicht die Funktion seiner Arbeitskraft sei, lebendige Arbeit, sondern bereits im Produkt vergegenständlichte Arbeit, und als ob der Preis dieser Arbeit nicht wie beim Zeitlohn durch die Bruchzahl Tageswert der Arbeitskraft/Arbeitstag von gegebner Stundenzahl, sondern durch die Leistungsfähigkeit des Produzenten bestimmt werde.	ch21_clean.en-ch21_clean.de
It also seems as if the price of this labour is determined not, as with time-wages, by the fraction daily value of labour-power/working day of a given number of hours but by the producer’s capacity for work.	Zunächst müßte die Zuversicht, die an diesen Schein glaubt, bereits stark erschüttert werden durch die Tatsache, daß beide Formen des Arbeitslohns zur selben Zeit in denselben Geschäftszweigen nebeneinander bestehn.	ch21_clean.en-ch21_clean.de
The confidence that trusts in this, the mere appearance of things, ought to receive an initial severe shock from the fact that both forms of wages exist side by side, at the same time, in the same branches of industry.	Z.B. "Die Setzer von London arbeiten in der Regel nach Stücklohn, während Zeitlohn bei ihnen die Ausnahme bildet.	ch21_clean.en-ch21_clean.de
For example, ‘the compositors of London, as a general rule, work by the piece, time-work being the exception, while those in the country work by the day, the exception being work by the piece.	Umgekehrt bei den Setzern in den Provinzen, wo der Zeitlohn die Regel und der Stücklohn die Ausnahme.	ch21_clean.en-ch21_clean.de
The shipwrights of the port of London work by the job or piece, while those of all other ports work by the day.’	Die Schiffszimmerleute im Hafen von London werden nach Stücklohn bezahlt, in allen andren englischen Häfen nach Zeitlohn."	ch21_clean.en-ch21_clean.de
In the same saddlery shops of London, often for the same work, piece-wages are paid to Frenchmen, and time-wages are paid to Englishmen.	In denselben Londoner Sattlerwerkstätten wird oft für dieselbe Arbeit den Franzosen Stücklohn und den Engländern Zeitlohn gezahlt.	ch21_clean.en-ch21_clean.de
In the actual factories, where piece-wages are the general rule, certain specific operations have to be excepted from this form of evaluation on technical grounds, and they are therefore paid by time-wages.	In den eigentlichen Fabriken, wo Stücklohn allgemein vorherrscht, entziehn sich einzelne Arbeitsfunktionen aus technischen Gründen dieser Messung und werden daher nach Zeitlohn gezahlt.	ch21_clean.en-ch21_clean.de
However, it is in itself obvious that the difference of form in the payment of wages in no way alters their essential nature, although the one form may be more favourable to the development of capitalist production than the other.	An und für sich ist es jedoch klar, daß die Formverschiedenheit in der Auszahlung des Arbeitslohns an seinem Wesen nichts ändert, obgleich die eine Form der Entwicklung der kapitalistischen Produktion günstiger sein mag als die andre.	ch21_clean.en-ch21_clean.de
Let the ordinary working day contain 12 hours, of which 6 are paid, 6 unpaid.	Der gewöhnliche Arbeitstag betrage 12 Stunden, wovon 6 bezahlt, 6 unbezahlt.	ch21_clean.en-ch21_clean.de
Let its value-product be 6 shillings; the value-product of one hour of labour will therefore be 6d. Let us suppose that, as the result of experience, a worker, working with the average amount of intensity and skill, and therefore devoting to the production of an article only the amount of labour-time socially necessary, produces, in the course of 12 hours, twenty-four pieces, either distinct products or measurable parts of some integral construction.	Sein Wertprodukt sei 6 sh., das einer Arbeitsstunde daher 6 d. Es stelle sich erfahrungsmäßig heraus, daß ein Arbeiter, der mit dem Durchschnittsgrad von Intensität und Geschick arbeitet, in der Tat also nur die gesellschaftlich notwendige Arbeitszeit zur Produktion eines Artikels verwendet, 24 Stücke, ob diskret, oder meßbare Teile eines kontinuierlichen Machwerks, in 12 Stunden liefert.	ch21_clean.en-ch21_clean.de
The value of these twenty-four pieces, after we have subtracted the amount of constant capital contained in them, will be 6 shillings, the value of a single piece will be 3d. The worker receives l 1/2d. per piece, and thus earns 3 shillings in 12 hours.	So ist der Wert dieser 24 Stücke, nach Abzug des in ihnen enthaltnen konstanten Kapitalteils, 6 sh. und der Wert des einzelnen Stücks 3 d. Der Arbeiter erhält per Stücke 11/2 d. und verdient so in 12 Stunden 3 sh.	ch21_clean.en-ch21_clean.de
Just as, with time-wages, it does not matter whether we assume that the worker works 6 hours for himself and 6 hours for the capitalist, or half of every hour for himself, and the other half for the capitalist, so here it does not matter whether we say that each individual piece is half paid for, and half unpaid for, or that the price of only twelve of the pieces is the equivalent of the value of the labour-power, while in the other twelve pieces surplus-value is incorporated.	Wie es beim Zeitlohn gleichgültig ist, ob man annimmt, daß der Arbeiter 6 Stunden für sich und 6 für den Kapitalisten, oder von jeder Stunde die eine Hälfte für sich und die andre für den Kapitalisten arbeitet, so auch hier, ob man sagt, jedes einzelne Stück sei halb bezahlt und halb unbezahlt, oder der Preis von 12 Stücken ersetze nur den Wert der Arbeitskraft, während in den 12 andern sich der Mehrwert verkörpere.	ch21_clean.en-ch21_clean.de
The form of piece-wages is just as irrational as that of time-wages.	Die Form des Stücklohns ist ebenso irrationell als die des Zeitlohns.	ch21_clean.en-ch21_clean.de
While, in our example, two pieces of a commodity, after subtraction of the value of the means of production consumed in them, are worth 6d., as the product of one hour of labour, the worker receives for them a price of 3d. Piece-wages are not in fact a direct expression of any relation of value.	Während z.B. zwei Stück Ware, nach Abzug des Werts der in ihnen aufgezehrten Produktionsmittel, als Produkt einer Arbeitsstunde 6 d. wert sind, erhält der Arbeiter für sie einen Preis von 3 d. Der Stücklohn drückt unmittelbar in der Tat kein Wertverhältnis aus.	ch21_clean.en-ch21_clean.de
It is not, therefore, a question of measuring the value of the piece by the labour-time incorporated in it. It is rather the reverse: the labour the worker has expended must be measured by the number of pieces he has produced.	Es handelt sich nicht darum, den Wert des Stücks durch die in ihm verkörperte Arbeitszeit zu messen, sondern umgekehrt die vom Arbeiter verausgabte Arbeit durch die Zahl der von ihm produzierten Stücke.	ch21_clean.en-ch21_clean.de
In time-wages the labour is measured by its immediate duration, in piece-wages by the quantity of products in which the labour has become embodied during a given time.	Beim Zeitlohn mißt sich die Arbeit an ihrer unmittelbaren Zeitdauer, beim Stücklohn am Produktenquantum, worin Arbeit während bestimmter Zeitdauer verdichtet.	ch21_clean.en-ch21_clean.de
The price of labour-time itself is finally determined by this equation: value of a day of labour = daily value of labour-power.	Der Preis der Arbeitszeit selbst ist schließlich bestimmt durch die Gleichung: Wert der Tagesarbeit = Tageswert der Arbeitskraft.	ch21_clean.en-ch21_clean.de
The piece-wage is therefore only a modified form of the time-wage.	Der Stücklohn ist also nur eine modifizierte Form des Zeitlohns.	ch21_clean.en-ch21_clean.de
Let us now look a little more closely at the characteristic peculiarities of piece-wages.	Betrachten wir nun etwas näher die charakteristischen Eigentümlichkeiten des Stücklohns.	ch21_clean.en-ch21_clean.de
The quality of the labour is here controlled by the work itself, which must be of good average quality if the piece-price is to be paid in full.	Die Qualität der Arbeit ist hier durch das Werk selbst kontrolliert, das die durchschnittliche Güte besitzen muß, soll der Stückpreise voll bezahlt werden.	ch21_clean.en-ch21_clean.de
Piece-wages become, from this point of view, the most fruitful source of reductions in wages, and of frauds committed by the capitalists.	Der Stücklohn wird nach dieser Seite hin zu fruchtbarster Quelle von Lohnabzügen und kapitalistischer Prellerei.	ch21_clean.en-ch21_clean.de
This is because they provide an exact measure of the intensity of labour.	Er bietet den Kapitalisten ein ganz bestimmtes Maß für die Intensität der Arbeit.	ch21_clean.en-ch21_clean.de
Only the labour-time which is embodied in a quantity of commodities laid down in advance and fixed by experience counts as socially necessary labour-time and is paid as such.	Nur Arbeitszeit, die sich in einem vorher bestimmten und erfahrungsmäßig festgesetzten Warenquantum verkörpert, gilt als gesellschaftlich notwendige Arbeitszeit und wird als solche bezahlt.	ch21_clean.en-ch21_clean.de
In the larger workshops of the London tailors, therefore, a certain piece of work, a waistcoat for instance, is called an hour, or half an hour, the hour being valued at 6d. Practice determines the size of the average product of one hour.	In den größeren Schneiderwerkstätten Londons heißt daher ein gewisses Stück Arbeit, z.B. eine Weste usw., Stunde, halbe Stunde usw., die Stunde zu 6 d. Aus der Praxis ist bekannt, wieviel das Durchschnittsprodukt einer Stunde.	ch21_clean.en-ch21_clean.de
With new fashions, repairs, etc. a contest arises between the employer and the worker-as to whether a particular piece of work is one hour, and so on, until here also experience decides.	Bei neuen Moden, Reparaturen usw. entsteht Streit zwischen Anwender und Arbeiter, ob ein bestimmtes Arbeitsstück = einer Stunde usw., bis auch hier die Erfahrung entscheidet.	ch21_clean.en-ch21_clean.de
Similarly in the London furniture workshops, etc. If the worker cannot provide labour of an average degree of efficiency, and if he cannot therefore supply a certain minimum of work per day, he is dismissed.	Ähnlich in den Londoner Möbelschreinereien usw. Besitzt der Arbeiter nicht die durchschnittliche Leistungsfähigkeit, kann er daher ein bestimmtes Minimum vom Tagwerk nicht liefern, so entläßt man ihn.	ch21_clean.en-ch21_clean.de
Since the quality and intensity of the work are here controlled by the very form of the wage, superintendence of labour becomes to a great extent superfluous.	Da Qualität und Intensität der Arbeit hier durch die Form des Arbeitslohns selbst kontrolliert werden, macht sie großen Teil der Arbeitsaufsicht überflüssig.	ch21_clean.en-ch21_clean.de
Piece-wages therefore form the basis for the modern ‘domestic labour’ we described earlier,* as well as for a hierarchically organized system of exploitation and oppression.	Sie bildet daher sowohl die Grundlage der früher geschilderten modernen Hausarbeit als eines hierarchisch gegliederten Systems der Exploitation und Unterdrückung.	ch21_clean.en-ch21_clean.de
The latter has two fundamental forms.	Das letztere besitzt zwei Grundformen.	ch21_clean.en-ch21_clean.de
On the one hand piece-wages make it easier for parasites to interpose themselves between the capitalist and the wage-labourer, thus giving rise to the ‘subletting of labour’.	Der Stücklohn erleichtert einerseits das Zwischenschieben von Parasiten zwischen Kapitalist und Lohnarbeiter, Unterverpachtung der Arbeit (subletting of labour).	ch21_clean.en-ch21_clean.de
The profits of these middlemen come entirely from the difference between the price of labour which the capitalist pays, and the part of that price they actually allow the worker to receive.	Der Gewinn der Zwischenpersonen fließt ausschließlich aus der Differenz zwischen dem Arbeitspreis, den der Kapitalist zahlt, und dem Teil dieses Preises, den sie dem Arbeiter wirklich zukommen lassen.	ch21_clean.en-ch21_clean.de
In England, this system is called, characteristically, the ‘sweating system’.	Dies System heißt in England charakteristisch das "Sweating-System" (Ausschweißungssystem).	ch21_clean.en-ch21_clean.de
On the other hand, piece-wages allow the capitalist to make a contract for so much per piece with the most important worker – in manufacture, with the chief of some group, in mines with the extractor of the coal, in the factory with the actual machine-worker – at a price for which this man himself undertakes the enlisting and the payment of his assistants.	Andrerseits erlaubt der Stücklohn dem Kapitalisten, mit dem Hauptarbeiter - in der Manufaktur mit dem Chef einer Gruppe, in den Minen mit dem Ausbrecher der Kohle usw., in der Fabrik mit dem eigentlichen Maschinenarbeiter - einen Kontrakt für soviel per Stück zu schließen, zu einem Preis, wofür der Hauptarbeiter selbst die Anwerbung und Zahlung seiner Hilfsarbeiter übernimmt.	ch21_clean.en-ch21_clean.de
Here the exploitation of the worker by capital takes place through the medium of the exploitation of one worker by another.	Die Exploitation der Arbeiter durch das Kapital verwirklicht sich hier vermittelst der Exploitation des Arbeiters durch den Arbeiter.	ch21_clean.en-ch21_clean.de
Given the system of piece-wages, it is naturally in the personal interest of the worker that he should strain his labour-power as intensely as possible; this in turn enables the capitalist to raise the normal degree of intensity of labour more easily.	Den Stücklohn gegeben, ist es natürlich das persönliche Interesse des Arbeiters, seine Arbeitskraft möglichst intensiv anzuspannen, was dem Kapitalisten eine Erhöhung des Normalgrads der Intensität erleichtert.	ch21_clean.en-ch21_clean.de
Moreover, the lengthening of the working day is now in the personal interest of the worker, since with it his daily or weekly wages rise.	(51a) Es ist ebenso das persönliche Interesse des Arbeiters, den Arbeitstag zu verlängern, weil damit sein Tages- oder Wochenlohn steigt.	ch21_clean.en-ch21_clean.de
This gradually brings on a reaction like that already described in time-wages, quite apart from the fact that the prolongation of the working day, even if the piece-wage remains constant, includes of necessity a fall in the price of the labour.	Es tritt damit die beim Zeitlohn bereits geschilderte Reaktion ein, abgesehn davon, daß die Verlängerung des Arbeitstags, selbst bei konstant bleibendem Stücklohn, an und für sich eine Senkung im Preise der Arbeit einschließt.	ch21_clean.en-ch21_clean.de
In time-wages, with few exceptions, the same wage is paid for the same function, while in piece-wages, although the price of the labour-time is measured by a definite quantity of the product, the daily or weekly wage will vary with the individual differences between the workers, one of whom will supply, within a given period, the minimum of product only, another the average, and a third more than the average.	Beim Zeitlohn herrscht mit wenigen Ausnahmen gleicher Arbeitslohn für dieselben Funktionen, während beim Stücklohn der Preis der Arbeitszeit zwar durch ein bestimmtes Produktenquantum gemessen ist, der Tags- oder Wochenlohn dagegen wechselt mit der individuellen Verschiedenheit der Arbeiter, wovon der eine nur das Minimum des Produkts in einer gegebnen Zeit liefert, der andre den Durchschnitt, der dritte mehr als den Durchschnitt.	ch21_clean.en-ch21_clean.de
With regard to their actual income, then, there is great variety among the individual workers, according to their different degrees of skill, strength, energy and staying-power.	In bezug auf die wirkliche Einnahme treten hier also große Differenzen ein je nach dem verschiednen Geschick, Kraft, Energie, Ausdauer usw. der individuellen Arbeiter.	ch21_clean.en-ch21_clean.de
Of course, this does not alter the general relation between capital and wage-labour.	Dies ändert natürlich nichts an dem allgemeinen Verhältnis zwischen Kapital und Lohnarbeit.	ch21_clean.en-ch21_clean.de
First, the individual differences cancel each other out in the workshop as a whole, which thus supplies the average product within a given period of labour, and the total wages paid will be the average wage of that particular branch of industry.	Erstens gleichen sich die individuellen Unterschiede für die Gesamtwerkstatt aus, so daß sie in einer bestimmten Arbeitszeit das Durchschnittsprodukt liefert und der gezahlte Gesamtlohn der Durchschnittslohn des Geschäftszweigs sein wird.	ch21_clean.en-ch21_clean.de
Second, the proportion between wages and surplus-value remains unaltered, since the mass of surplus labour supplied by each particular worker corresponds with the wage he receives.	Zweitens bleibt die Proportion zwischen Arbeitslohn und Mehrwert unverändert, da dem individuellen Lohn des einzelnen Arbeiters die von ihm individuell gelieferte Masse von Mehrwert entspricht.	ch21_clean.en-ch21_clean.de
But the wider scope that piece-wages give to individuality tends to develop both that individuality, and with it the worker’s sense of liberty, independence and self-control, and also the competition of workers with each other.	Aber der größere Spielraum, den der Stücklohn der Individualität bietet, strebt einerseits dahin, die Individualität und damit Freiheitsgefühl, Selbständigkeit und Selbstkontrolle der Arbeiter zu entwickeln, andrerseits ihre Konkurrenz unter- und gegeneinander.	ch21_clean.en-ch21_clean.de
The piece-wage therefore has a tendency, while raising the wages of individuals above the average, to lower this average itself.	Er hat daher eine Tendenz, mit der Erhebung individueller Arbeitslöhne über das Durchschnittsniveau dies Niveau selbst zu senken.	ch21_clean.en-ch21_clean.de
However, where a particular rate of piece-wage has for a long time been a fixed tradition, and its lowering, therefore, has presented especial difficulties, in such exceptional cases the masters have sometimes had recourse to the forcible transformation of piece-wages into time-wages.	Wo aber bestimmter Stücklohn sich seit lange traditionell befestigt hatte und seine Herabsetzung daher besondre Schwierigkeiten bot, flüchteten die Meister ausnahmsweise auch zu seiner gewaltsamen Verwandlung in Zeitlohn.	ch21_clean.en-ch21_clean.de
In 1860, for instance, this action set off a big strike among the ribbon-weavers of Coventry.	Hiergegen z.B. 1860 großer strike unter den Bandwebern von Conventry.	ch21_clean.en-ch21_clean.de
Finally, the piece-wage is one of the chief supports of the hour-system described in the preceding chapter.	Der Stücklohn ist endlich eine Hauptstütze des früher geschilderten Stundensystems.	ch21_clean.en-ch21_clean.de
From what has been shown so far, it is apparent that the piece-wage is the form of wage most appropriate to the capitalist mode of production.	Aus der bisherigen Darstellung ergibt sich, daß der Stücklohn die der kapitalistischen Produktionsweise entsprechendste Form des Arbeitslohns ist.	ch21_clean.en-ch21_clean.de
Although by no means new – it figures officially side by side with time-wages in the French and English labour statutes of the fourteenth century – it only conquered a larger field of action during the period of manufacture properly so-called.	Obgleich keineswegs neu - er figuriert neben dem Zeitlohn offiziell u.a. in den französischen und englischen Arbeiterstatuten des vierzehnten Jahrhunderts -, gewinnt er doch erst größren Spielraum während der eigentlichen Manufakturperiode.	ch21_clean.en-ch21_clean.de
In the stormy youth of large-scale industry, and particularly from 1797 to 1815, it served as a lever for the lengthening of the working day and the lowering of wages.	In der Sturm- und Drangperiode der großen Industrie, namentlich von 1797 bis 1815, dient er als Hebel zur Verlängrung der Arbeitszeit und Herabsetzung des Arbeitslohns.	ch21_clean.en-ch21_clean.de
Very important material bearing on the movement of wages during that period is to be found in the two Blue Books Report and Evidence from the Select Committee on Petitions Respecting the Corn Laws (Parliamentary Session of 1813–14), and Report from the Lords’ Committee, on the State of the Growth, Commerce, and Consumption of Grain, and all Laws Relating Thereto (Session of 1814–15).	Sehr wichtiges Material für die Bewegung des Arbeitslohns während jener Periode findet man in den Blaubüchern: "Report and Evidence from the Select Committee on Petitions respecting the Corn Laws" (Parlamentssession 1813/14) und "Reports from the Lords' Committee, on the state of the Growth, Commerce, and Consumption of Grain, and all Laws relating thereto". (Session 1814/15.)	ch21_clean.en-ch21_clean.de
Here we find documentary evidence of the constant lowering of the price of labour from the beginning of the Anti-Jacobin War.	Man findet hier den dukumentarischen Nachweis für die fortwährende Senkung des Arbeitspreises seit dem Beginn des Antijakobinerkriegs.	ch21_clean.en-ch21_clean.de
In the weaving industry, for example, piece-wages had fallen so low that in spite of the very great lengthening of the working day, the daily wage was then lower than it had been before.	In der Weberei z.B. war der Stücklohn so gefallen, daß trotz des sehr verlängerten Arbeitstags der Taglohn jetzt niedriger stand als vorher.	ch21_clean.en-ch21_clean.de
‘The real earnings of the cotton weaver are now far less than they were; his superiority over the common labourer, which at first was very great, has now almost entirely ceased.	"Die reale Einnahme des Webers ist sehr viel weniger als früher: seine Superiorität über den gewöhnlichen Arbeiter, die erst sehr groß war, ist fast ganz verschwunden.	ch21_clean.en-ch21_clean.de
Indeed… the difference in the wages of skilful and common labour is far less now than at any former period.’	In der Tat, der Unterschied in den Löhnen geschickter und gewöhnlicher Arbeit ist jetzt viel unbedeutender als während irgendeiner früheren Periode."	ch21_clean.en-ch21_clean.de
How little the increased intensity and extension of labour through piece-wages benefited the agricultural proletariat can be seen from the following passage from a pamphlet in favour of the landlords and farmers: ‘By far the greater part of agricultural operations is done by people, who are hired for the day or on piece-work.	Wie wenig die mit dem Stücklohn gesteigerte Intensität und Ausdehnung der Arbeit dem ländlichen Proletariat fruchteten, zeige folgende einer Parteischrift für Landlords und Pächter entlehnte Stelle: "Bei weitem der größere Teil der Agrikulturoperationen wird durch Leute verrichtet, die für den Tag oder auf Stückwerk gedungen sind.	ch21_clean.en-ch21_clean.de
Their weekly wages are about 12 shillings, and although it may be assumed that a man earns on piece-work under the greater stimulus to labour, 1 shilling, or perhaps 2 shillings more than on weekly wages, yet it is found, on calculating his total income, that his loss of employment, during the year, outweighs this gain… Further, it will generally be found that the wages of these men bear a certain proportion to the price of the necessary means of subsistence, so that a man with two children is able to bring up his family without recourse to parish relief.’	Ihr Wochenlohn beträgt ungefähr 12 sh. ; und obgleich man voraussetzen mag, daß ein Mann bei Stücklohn, unter dem größeren Arbeitssporn, 1 sh. oder vielleicht 2 sh. mehr verdient als beim Wochenlohn, so findet man dennoch, bei Schätzung seiner Gesamteinnahme, daß sein Verlust an Beschäftigung im Lauf des Jahrs diesen Zuschuß aufwiegt ... Man wird ferner im allgemeinen finden, daß die Löhne dieser Männer ein gewisses Verhältnis zum Preis der notwendigen Lebensmittel haben, so daß ein Mann mit zwei Kindern fähig ist, seine Familie ohne Zuflucht zur Pfarreiunterstützung zu erhalten."	ch21_clean.en-ch21_clean.de
Malthus remarked at that time, with reference to the facts published by Parliament: ‘I confess that I see, with misgiving, the great extension of the practice of piece-wage.	Malthus bemerkte damals mit Bezug auf die vom Parlament veröffentlichten Tatsachen: "Ich gestehe, ich sehe mit Mißvergnügen die große Ausdehnung der Praxis des Stücklohns.	ch21_clean.en-ch21_clean.de
Really hard work during 12 or 14 hours of the day, or for any longer time, is too much for any human being.’	Wirklich harte Arbeit während 12 oder 14 Stunden des Tags, für irgend längere Zeitperioden, ist zuviel für ein menschliches Wesen."	ch21_clean.en-ch21_clean.de
In those workshops which are subject to the Factory Act, the piece-wage becomes the general rule, because there capital can increase the yield of the working day only by intensifying labour.	In den dem Fabrikgesetz unterworfenen Werkstätten wird Stücklohn allgemeine Regel, weil das Kapital dort den Arbeitstag nur noch intensiv ausweiten kann.	ch21_clean.en-ch21_clean.de
Changes in the productivity of labour mean that the same quantity of a given product represents an amount of labour-time which varies.	Mit der wechselnden Produktivität der Arbeit stellt dasselbe Produktenquantum wechselnde Arbeitszeit dar.	ch21_clean.en-ch21_clean.de
Therefore, the piece-wage also varies, for it is the expression of the price of a definite amount of labour-time.	Also wechselt auch der Stücklohn, da er Preisausdruck einer bestimmten Arbeitszeit.	ch21_clean.en-ch21_clean.de
In our earlier example, twenty-four pieces were produced in 12 hours, while the value-product of the 12 hours was 6 shillings, the daily value of the labour-power was 3 shillings, the price of an hour of labour was 3d., and the wage for one piece was l 1/2d. Half an hour of labour was absorbed in one piece.	In unserem obigen Beispiel wurden in 12 Stunden 24 Stück produziert, während das Wertprodukt der 12 Stunden 6 sh. war, der Tageswert der Arbeitskraft 3 sh., der Preis der Arbeitsstunde 3 d. und der Lohn für ein Stück 11/2 d. In einem Stück war 1/2 Arbeitsstunde eingesaugt.	ch21_clean.en-ch21_clean.de
If the productivity of labour is now doubled, so that the same working day supplies forty-eight pieces instead of twenty-four, and all other circumstances remain unchanged, then the piece-wage falls from ltd. to 3/4d., as every piece now only represents 1/ instead of 1/ a working hour. x l 1/2d. = 3s., and, similarly, 48x 3/4d. = 3s.	Liefert derselbe Arbeitstag nun etwa infolge verdoppelter Produktivität der Arbeit 48 Stück statt 24, und bleiben alle andern Umstände unverändert, so sinkt der Stücklohn von 11/2 d. auf 3/4 d., da jedes Stück jetzt nur noch 1/4 statt 1/2 Arbeitsstunde darstellt. 24 × 11/2 d. = 3 sh. und ebenso 48 × 3/4 d. = 3 sh.	ch21_clean.en-ch21_clean.de
In other words, the piece-wage is lowered in the same proportion as the number of pieces produced in the same time rises, and therefore in the same proportion as the amount of labour-time employed on the same piece falls.	In anderen Worten: Der Stücklohn wird in demselben Verhältnis heruntergesetzt, worin die Zahl der während derselben Zeit produzierten Stücke wächst , also die auf dasselbe Stück verwandte Arbeitszeit abnimmt.	ch21_clean.en-ch21_clean.de
This change in the piece-wage, so far purely nominal, leads to constant struggles between the capitalist and the worker, either because the capitalist uses it as a pretext for actually lowering the price of labour, or because an increase in the productivity of labour is accompanied by an increase in its intensity, or because the worker takes the outward appearance of piece-wages seriously, i.e. he thinks his product is being paid for and not his labour-power, and he therefore resists any reduction of wages which is not accompanied by a reduction in the selling price of the commodity.	Dieser Wechsel des Stück- lohns, soweit rein nominell, ruft beständige Kämpfe zwischen Kapitalist und Arbeiter hervor. Entweder, weil der Kapitalist den Vorwand benutzt, um wirklich den Preis der Arbeit herabzusetzen, oder weil die gesteigerte Produktivkraft der Arbeit von gesteigerter Intensität derselben begleitet ist. Oder weil der Arbeiter den Schein des Stücklohns, als ob ihm sein Produkt gezahlt werde und nicht seine Arbeitskraft, ernst nimmt und sich daher gegen eine Lohnherabsetzung sträubt, welcher die Herabsetzung im Verkaufspreis der Ware nicht entspricht.	ch21_clean.en-ch21_clean.de
‘The operatives… carefully watch the price of the raw material and the price of manufactured goods, and are thus enabled to form an accurate estimate of their master’s profits.’	"Die Arbeiter überwachen sorgfältig den Preis des Rohmaterials und den Preis der fabrizierten Güter und sind so fähig, die Profite ihrer Meister genau zu veranschlagen."	ch21_clean.en-ch21_clean.de
The capitalist rightly rejects such pretensions as being gross errors as to the nature of wage-labour.	Solchen Anspruch <3. und 4. Auflage: Ausspruch> fertigt das Kapital mit Recht als groben Irrtum über die Natur der Lohnarbeit ab.	ch21_clean.en-ch21_clean.de
He cries out against this presumptuous attempt to lay taxes on the progress of industry, and declares roundly that the productivity of labour does not concern the worker in the least.20	Es zetert über diese Anmaßung, Steuern auf den Fortschritt der Industrie zu legen, und erklärt rundweg, daß die Produktivität der Arbeit <4. Auflage: Arbeiter> den Arbeiter überhaupt nichts angeht.	ch21_clean.en-ch21_clean.de

