Chapter 22: National Differences in Wages In Chapter 17 we were concerned with the manifold combinations which may bring about a change in the magnitude of the value of labour-power – this magnitude being considered either absolutely or relatively (i.e. as compared with surplus-value).	ZWANZIGSTES KAPITEL Nationale Verschiedenheit der Arbeitslöhne Im fünfzehnten Kapitel beschäftigten uns die mannigfachen Kombinationen, welche einen Wechsel in der absoluten oder relativen (d.h. mit dem Mehrwert verglichen) Wertgröße der Arbeitskraft hervorbringen kann, während andrerseits wieder das Quantum von Lebensmitteln, worin der Preis der Arbeitskraft realisiert wird, von dem Wechsel dieses Preises unabhängige oder verschiedne Bewegung durchlaufen konnte.	ch22_clean.en-ch22_clean.de
We found also that the quantity of the means of subsistence in which the price of labour-power was realized might again undergo fluctuations independent of, or different from, the changes in this price.	Wie bereits bemerkt, verwandeln sich durch einfache Übersetzung des Werts, resp.	ch22_clean.en-ch22_clean.de
As has been said already, the simple translation of the value, or respectively of the price, of labour-power, into the exoteric form of wages transforms all these laws into laws governing the movement of wages.	Preises der Arbeitskraft in die exoterische Form des Arbeitslohns alle jene Gesetze in Gesetze der Bewegung des Arbeitslohns.	ch22_clean.en-ch22_clean.de
What appears within the movement of wages as a series of varying combinations may appear for different countries as a set of simultaneous differences in national wage-levels.	Was innerhalb dieser Bewegung als wechselnde Kombination, kann für verschiedne Länder als gleichzeitige Verschiedenheit nationaler Arbeitslöhne erscheinen.	ch22_clean.en-ch22_clean.de
In comparing wages in different nations, we must therefore take into account all the factors that determine changes in the amount of the value of labour-power; the price and the extent of the prime necessities of life in their natural and historical development, the cost of training the workers, the part played by the labour of women and children, the productivity of labour, and its extensive and intensive magnitude.	Beim Vergleich nationaler Arbeitslöhne sind also alle den Wechsel in der Wertgröße der Arbeitskraft bestimmende Momente zu erwägen, Preis und Umfang der natürlichen und historisch entwickelten ersten Lebensbedürfnisse, Erziehungskosten des Arbeiters, Rolle der Weiber- und Kinderarbeit, Produktivität der Arbeit, ihre extensive und intensive Größe.	ch22_clean.en-ch22_clean.de
Even the most superficial comparison requires the prior reduction of the average daily wage for the same trades, in different countries, to a uniform working day.	Selbst die oberflächlichste Vergleichung erheischt, zunächst den Durchschnitts-Taglohn für dieselben Gewerbe in verschiednen Ländern auf gleich große Arbeitstage zu reduzieren.	ch22_clean.en-ch22_clean.de
After this reduction of the daily wage to the same terms, the time-wage must again be translated into the piece-wage, as only the latter can be a measure both of the productivity and of the intensity of labour.	Nach solcher Ausgleichung der Taglöhne muß der Zeitlohn wieder in Stücklohn übersetzt werden, da nur der letztere ein Gradmesser sowohl für die Produktivität als die intensive Größe der Arbeit.	ch22_clean.en-ch22_clean.de
In every country there is a certain average intensity of labour, below which the labour for the production of a commodity requires more than the time socially necessary, and therefore does not count as labour of normal quality.	In jedem Lande gilt eine gewisse mittlere Intensität der Arbeit, unter welcher die Arbeit bei Produktion einer Ware mehr als die gesellschaftlich notwendige Zeit verbraucht, und daher nicht als Arbeit von normaler Qualität zählt.	ch22_clean.en-ch22_clean.de
In a given country, only a degree of intensity which is above the national average alters the measurement of value by the mere duration of labour-time.	Nur ein über den nationalen Durchschnitt sich erhebender Intensitätsgrad ändert, in einem gegebnen Lande, das Maß des Werts durch die bloße Dauer der Arbeitszeit.	ch22_clean.en-ch22_clean.de
It is otherwise on the world market, whose integral parts are the individual countries.	Anders auf dem Weltmarkt, dessen integrierende Teile die einzelnen Länder sind.	ch22_clean.en-ch22_clean.de
The average intensity of labour changes from country to country; here is it greater, there less.	Die mittlere Intensität der Arbeit wechselt von Land zu Land; sie ist hier größer, dort kleiner.	ch22_clean.en-ch22_clean.de
These national averages form a scale whose unit of measurement is the average unit of universal labour.	Diese nationalen Durchschnitte bilden also eine Stufenleiter, deren Maßeinheit die Durchschnittseinheit der universellen Arbeit ist.	ch22_clean.en-ch22_clean.de
The more intense national labour, therefore, as compared with the less intense, produces in the same time more value, which expresses itself in more money.	Verglichen mit der weniger intensiven, produziert also die intensivere nationale Arbeit in gleicher Zeit mehr Wert, der sich in mehr Geld ausdrückt.	ch22_clean.en-ch22_clean.de
But the law of value is yet more modified in its international application by the fact that, on the world market, national labour which is more productive also counts as more intensive, as long as the more productive nation is not compelled by competition to lower the selling price of its commodities to the level of their value.	Noch mehr aber wird das Wertgesetz in seiner internationalen Anwendung dadurch modifiziert, daß auf dem Weltmarkt die produktivere nationale Arbeit ebenfalls als intensivere zählt, sooft die produktivere Nation nicht durch die Konkurrenz gezwungen wird, den Verkaufspreis ihrer Ware auf ihren Wert zu senken.	ch22_clean.en-ch22_clean.de
In proportion as capitalist production is developed in a country, so, in the same proportion, do the national intensity and productivity of labour there rise above the international level.	Im Maß, wie in einem Lande die kapitalistische Produktion entwickelt ist, im selben Maß erheben sich dort auch die nationale Intensität und Produktivität der Arbeit über das internationale Niveau.	ch22_clean.en-ch22_clean.de
The different quantities of commodities of the same kind, produced in different countries in the same working time, have, therefore, unequal international values, which are expressed in different prices, i.e. in sums of money varying according to international values.	(64a) Die verschiedenen Warenquanta derselben Art, die in verschiedenen Ländern in gleicher Arbeitszeit produziert werden, haben also ungleiche internationale Werte, die sich in verschiedenen Preisen ausdrücken, d.h. in je nach den internationalen Werten verschiednen Geldsummen.	ch22_clean.en-ch22_clean.de
The relative value of money will therefore be less in the nation with a more developed capitalist mode of production than in the nation with a less developed capitalism.	Der relative Wert des Geldes wird also kleiner sein bei der Nation mit entwickelterer kapitalistischer Produktionsweise als bei der mit wenig entwickelter.	ch22_clean.en-ch22_clean.de
It follows then that nominal wages, the equivalent of labour-power expressed in money, will also be higher in the first nation than in the second; but this by no means proves that the same can be said of real wages, i.e. the means of subsistence placed at the disposal of the worker.	Folgt also, daß der nominelle Arbeitslohn, das Äquivalent der Arbeitskraft ausgedrückt in Geld, ebenfalls höher sein wird bei der ersten Nation als bei der zweiten; was keineswegs besagt, daß dies auch für den wirklichen Lohn gilt, d.h. für die dem Arbeiter zur Verfügung gestellten Lebensmittel.	ch22_clean.en-ch22_clean.de
But even apart from these relative differences in the value of money in different countries, it will frequently be found that the daily or weekly wage in the first nation is higher than in the second while the relative price of labour, i.e. the price of labour as compared both with surplus-value and with the value of the product, stands higher in the second than in the first.	Aber auch abgesehn von dieser relativen Verschiedenheit des Geldwerts in verschiedenen Ländern, wird man häufig finden, daß der Tages-, Wochen-, etc. Lohn bei der ersteren Nation höher ist als bei der zweiten, während der relative Arbeitspreis, d.h. der Arbeitspreis im Verhältnis sowohl zum Mehrwert wie zum Wert des Produkts, bei der zweiten Nation höher steht als bei der ersteren.	ch22_clean.en-ch22_clean.de
J. W. Cowell, a member of the Factory Commission of 1833, came to the conclusion, after careful investigation of the spinning trade, that ‘in England wages are virtually lower to the capitalist, though higher to the operative than on the Continent of Europe’ (Ure, p. 314).	J. W. Cowell, Mitglied der Fabrikkommission von 1833, kam nach sorgfältiger Untersuchung der Spinnerei zum Ergebnis, daß "in England die Löhne der Sache nach niedriger für den Fabrikanten sind als auf dem Kontinent, obwohl sie für den Arbeiter höher sein mögen" (Ure, p. 314).	ch22_clean.en-ch22_clean.de
The English factory inspector Alexander Redgrave, in his Report of 31 October 1866, proves, by comparing the statistics of Continental states, that in spite of lower wages and much longer hours of work, Continental labour is, in proportion to the product, dearer than English.	Der englische Fabrikinspektor Alexander Redgrave weist im Fabrikbericht vom 31. Oktober 1866 durch vergleichende Statistik mit den Kontinentalstaaten nach, daß trotz niedrigerem Lohn und viel längerer Arbeitszeit die kontinentale Arbeit, verhältnismäßig zum Produkt, teurer ist als die englische.	ch22_clean.en-ch22_clean.de
The English manager of a cotton factory in Oldenburg declared that the working hours there were from 5. a.m. to 8 p.m., Saturdays included, and that the workers, when under English overseers, did not supply during this time quite so much of the product as the English in 10 hours, while they supplied much less when under German overseers.	Ein englischer Direktor (manager) in einer Baumwollfabrik in Oldenburg erklärt, daß dort die Arbeitszeit von 5.30 Uhr morgens bis 8 Uhr abends währt, samstags eingeschlossen, und daß die dortigen Arbeiter, wenn unter englischen Arbeitsaufsehen, während dieser Zeit nicht ganz soviel Produkt liefern als Engländer in 10 Stunden, unter deutschen Arbeitsaufsehern aber noch viel weniger.	ch22_clean.en-ch22_clean.de
Wages are much lower than in England, in many cases lower by 50 per cent, but the number of ‘hands’ in proportion to the machinery is much greater, in certain departments in the proportion of 5:3. Mr Redgrave also gives very precise details as to the Russian cotton factories.	Der Lohn stehe viel tiefer als in England, in vielen Fällen um 50%, aber die Zahl der Hände im Verhältnis zur Maschinerie sei viel größer, in verschiedenen Departements im Verhältnis von 5 : 3. Herr Redgrave gibt sehr genaue Details über die russischen Baumwollfabriken.	ch22_clean.en-ch22_clean.de
The data were given him by an English manager until recently employed there.	Die Data sind ihm geliefert durch einen dort noch kürzlich beschäftigten englischen manager.	ch22_clean.en-ch22_clean.de
On this Russian soil, so fruitful of all infamies, the old horrors of the early days of English factories are in full swing.	Auf diesem russischen Boden, an allen Infamien so fruchtbar, stehn auch die alten Greuel aus der Kindheitspreiode der englischen factories <Fabriken> in vollster Blüte.	ch22_clean.en-ch22_clean.de
The managers are, of course, English, as the native Russian capitalist is incapable of handling factory business.	Die Dirigenten sind natürlich Engländer, da der eingeborene russische Kapitalist nicht für das Fabrikgeschäft taugt.	ch22_clean.en-ch22_clean.de
Despite all the over-work, which continues throughout the day and the night, despite the most shameful under-payment of the workers, Russian manufacturing only manages to vegetate thanks to the prohibition of foreign competition. I give, in conclusion, a comparative table of Mr Redgrave’s on the average number of spindles per factory and per spinner in the different countries of Europe.	Trotz aller Überarbeit, fortlaufender Tag- und Nachtarbeit und schmählichster Unterzahlung der Arbeiter, vegetiert das russische Fabrikat nur durch Prohibition des ausländischen. - Ich gebe schließlich noch eine vergleichende Übersicht des Herrn Redgrave über die Durchschnitts-Spindelzahl per Fabrik und per Spinner in verschiednen Ländern Europas.	ch22_clean.en-ch22_clean.de
He himself remarks that these figures were collected a few years ago, and that since that time the size of the factories and the number of spindles per worker in England has increased.	Herr Redgrave bemerkt selbst, daß er diese Zahlen vor einigen Jahren gesammelt hat und daß seit der Zeit die Größe der Fabriken und die Spindelzahl per Arbeiter in England gewachsen seien.	ch22_clean.en-ch22_clean.de
He assumes, however, that an approximately equal advance has been made in the Continental countries mentioned, so that the numbers given would still retain their value for purposes of comparison.	Er unterstellt aber verhältnismäßig gleich großen Fortschritt in den aufgezählten Kontinentalländern, so daß die Zahlenangaben ihren komparativen Wert behalten hätten.	ch22_clean.en-ch22_clean.de
AVERAGE NUMBER OF SPINDLES PER FATORY England 12, France 1, Prussia 1, Belgium 4, Saxony 4, Austria 7, Switzerland 8, AVERAGE NUMBER OF SPINDLES PER PERSON One person to: France 14 spindles Russia 28 ” Prussia 37 ” Bavaria 46 ” Austria 49 ” Belgium 50 ” Saxony 50 ” Switzerland 55 ” Smaller German states 55 ” Great Britain 74 ” ‘This comparison,’ says Mr Redgrave, ‘is yet more unfavourable to Great Britain, inasmuch as there is so large a number of factories in which weaving by power is carried on in conjunction with spinning’ (while in the table the weavers are not deducted) ‘and the factories abroad are chiefly spinning factories; if it were possible to compare like with like, strictly, I could find many cotton spinning factories in my district in which mules containing 2, spindles are minded by one man (the “minder”) and two assistants only, turning off daily 220 lb. of yarn, measuring 400 miles in length’ (Reports of the Inspectors of Factories… 31 October 1866, pp. 31–7, passim).	Durchschnittsanzahl von Spindeln per Fabrik In England Durchschnittszahl von Spindeln auf je eine Fabrik 12.600 In der Schweiz Durchschnittszahl von Spindeln auf je eine Fabrik 8.000 In Östreich Durchschnittszahl von Spindeln auf je eine Fabrik 7.000 In Sachsen Durchschnittszahl von Spindeln auf je eine Fabrik 4.500 In Belgien Durchschnittszahl von Spindeln auf je eine Fabrik 4.000 In Frankreich Durchschnittszahl von Spindeln auf je eine Fabrik 1.500 In Preußen Durchschnittszahl von Spindeln auf je eine Fabrik 1.500 Durchschnittsanzahl von Spindeln per Kopf In Frankreich eine Person auf 14 Spindeln In Rußland eine Person auf 28 Spindeln In Preußen eine Person auf 37 Spindeln In Bayern eine Person auf 46 Spindeln In Östreich eine Person auf 49 Spindeln In Belgien eine Person auf 50 Spindeln In Sachsen eine Person auf 50 Spindeln In den kleinern deutschen Staaten eine Person auf 55 Spindeln In der Schweiz eine Person auf 55 Spindeln In Großbritannien eine Person auf 74 Spindeln "Diese Vergleichung", sagt Herr Redgrave, "ist, außer andren Gründen, besonders auch deswegen für Großbritannien ungünstig, weil dort eine sehr große Zahl Fabriken existiert, worin die Maschinenweberei mit der Spinnerei verbunden ist, während die Rechnung keinen Kopf für die Webstühle abzieht. Die auswärtigen Fabriken sind dagegen meist bloße Spinnereien. Könnten wir genau Gleiches mit Gleichem vergleichen, so könne ich viele Baumwollspinnereien in meinem Distrikt aufzählen, worin Mules mit 2.200 Spindeln von einem einzigen Mann (minder) und zwei Handlangerinnen überwacht und täglich 220 Pfund Garn, 400 (englische) Meilen in Länge, fabriziert werden. "("Reports of Insp. of Fact., 31st Oct.	ch22_clean.en-ch22_clean.de
It is well known that in Eastern Europe, as well as in Asia, English companies have undertaken the construction of railways, and have, in making them, employed a certain number of English workers side by side with the locals.	1866", p. 31-37 passim.) Man weiß, daß in Osteuropa sowohl wie in Asien englische Kompanien Eisenbahnen in Bau übernommen haben und dabei neben einheimischen auch eine gewisse Zahl englischer Arbeiter verwenden.	ch22_clean.en-ch22_clean.de
Practical necessity has thus compelled them to take into account the national differences in the intensity of labour, but this has not brought them any loss.	Durch praktische Notwendigkeit gezwungen, so den nationalen Unterschieden in der Intensität der Arbeit Rechnung zu tragen, hat ihnen das keinen Schaden gebracht.	ch22_clean.en-ch22_clean.de
Their experience shows that even if the level of wages more or less corresponds with the average intensity of labour, the relative price of labour (i.e. the price of labour in relation to the product) generally varies in the inverse direction.	Ihre Erfahrung lehrt, daß, wenn auch die Höhe des Lohnes mehr oder weniger der mittleren Arbeitsintensität entspricht, der relative Arbeitspreis (im Verhältnis zum Produkt) sich im allgemeinen im entgegengesetzten Sinn bewegt.	ch22_clean.en-ch22_clean.de
In an Essay on the Rate of Wages, one of his first economic writings, H. Carey tries to prove that differences in national wage-levels are directly proportional to the degree of productivity of the working day of each nation, in order to draw from this international ratio the deduction that wages everywhere rise and fall in proportion to the productivity of labour.	In "Versuch über die Rate des Arbeitslohns" , einer seiner frühsten ökonomischen Schriften, sucht H. Carey nachzuweisen, daß die verschiednen nationalen Arbeitslöhne sich direkt verhalten wie die Produktivitätsgrade der nationalen Arbeitstage, um aus diesem internationalen Verhältnis den Schluß zu ziehen, daß der Arbeitslohn überhaupt steigt und fällt wie die Produktivität der Arbeit.	ch22_clean.en-ch22_clean.de
The whole of our analysis of the production of surplus-value shows that this deduction would be absurd even if Carey himself had demonstrated his premises, instead of shuffling a confused mass of statistical material to and fro in his usual uncritical and superficial manner.	Unsre ganze Analyse der Produktion des Mehrwerts beweist die Abgeschmacktheit dieser Schlußfolgerung, hätte Carey selbst seine Prämisse bewiesen, statt seiner Gewohnheit gemäß unkritisch und oberflächlich zusammengerafftes statistisches Material kunterbunt durcheinanderzuwürfeln.	ch22_clean.en-ch22_clean.de
The best of all is that he does not assert that things actually are as they ought to be according to his theory.	Das Beste ist, daß er nicht behauptet, die Sache verhalte sich wirklich so, wie sie sich der Theorie nach verhalten sollte.	ch22_clean.en-ch22_clean.de
For state intervention has falsified the natural economic relation.	Die Staatseinmischung hat nämlich das naturgemäße ökonomische Verhältnis verfälscht.	ch22_clean.en-ch22_clean.de
The different national wages must therefore be calculated on the assumption that the part of them that goes to the state in the form of taxes was received by the worker himself.	Man muß daher die nationalen Arbeitslöhne so berechnen, als ob der Teil derselben, der dem Staat in der Form von Steuern zufällt, dem Arbeiter selbst zufiele.	ch22_clean.en-ch22_clean.de
Ought not Mr Carey to consider further whether these ‘state expenses’ are not the ‘natural fruits’ of capitalist development?	Sollte Herr Carey nicht weiter darüber nachdenken, ob diese "Staatskosten" nicht auch "naturgemäße Früchte" der kapitalistischen Entwicklung sind?	ch22_clean.en-ch22_clean.de
His reasoning is quite worthy of the man who, first of all, declared that capitalist relations of production were eternal laws of nature and reason, whose free and harmonious working was only disturbed by the intervention of the state, and then discovered afterwards that state intervention, i.e. the defence of those laws of nature and reason by the state, alias the system of protection, was necessitated by the diabolical influence of England on the world market, an influence which, it appears, does not spring from the natural laws of capitalist production.	Das Räsonnement ist ganz des Mannes würdig, der die kapitalistischen Produktionsverhältnisse erst für ewige Natur- und Vernunftsgesetze erklärte, deren frei harmonisches Spiel nur durch die Staatseinmischung gestört werde, um hinterher zu entdecken, daß Englands diabolischer Einfluß auf den Weltmarkt, ein Einfluß, der, wie es scheint, nicht den Naturgesetzen der kapitalistischen Produktion entspringt, die Staatseinmischung nötig macht, nämlich den Schutz jener Natur- und Vernunftsgesetze durch den Staat, alias das Protektionssystem.	ch22_clean.en-ch22_clean.de
He discovered, further, that the theorems of Ricardo and others, in which existing social antagonisms and contradictions are formulated, are not the ideal product of the real economic movement, but, on the contrary, that the real antagonisms of capitalist production in England and elsewhere are the result of the theories of Ricardo and others!	Er entdeckte ferner, daß die Theoreme Ricardos usw., worin existierende gesellschaftliche Gegensätze und Widersprüche formuliert sind, nicht das ideale Produkt der wirklichen ökonomischen Bewegung, sondern daß umgekehrt die wirklichen Gegensätze der kapitalistischen Produktion in England und anderswo das Resultat der Ricardoschen usw. Theorie sind!	ch22_clean.en-ch22_clean.de
Finally he discovered that it is, in the last resort, trade which destroys the inborn beauties and harmonies of the capitalist mode of production.	Er entdeckte schließlich, daß es in letzter Instanz der Handel ist, der die eingebornen Schönheiten und Harmonien der kapitalistischen Produktionsweise vernichtet.	ch22_clean.en-ch22_clean.de
A step further, and he will perhaps discover that the one evil in capitalist production is capital itself.	Noch einen Schritt weiter, und er entdeckt vielleicht, daß der einzige Mißstand an der kapitalistischen Produktion das Kapital selbst ist.	ch22_clean.en-ch22_clean.de
Only a man with such an atrocious lack of the critical faculty, and such spurious erudition, deserved, in spite of his Protectionist heresy, to become the secret source of the harmonious wisdom of a Bastiat, and of all the other free-trade optimists of the present day.	Nur ein Mann von so entsetzlicher Kritiklosigkeit und solcher Gelehrsamkeit de faux aloi <von falschem Gehalt> verdiente, trotz seiner protektionistische Ketzerei, die Geheimquelle der harmonischen Weisheit eines Bastiat und aller andern freihändlerischen Optimisten der Gegenwart zu werden.	ch22_clean.en-ch22_clean.de
Part Seven The Process of Accumulation of Capital The transformation of a sum of money into means of production and labour-power is the first phase of the movement undergone by the quantum of value which is going to function as capital.		ch22_clean.en-ch22_clean.de
It takes place in the market, within the sphere of circulation. The second phase of the movement, the process of production, is complete as soon as the means of production have been converted into commodities whose value exceeds that of their component parts, and therefore contains the capital originally advanced plus a surplus-value. These commodities must then be thrown back into the sphere of circulation.		ch22_clean.en-ch22_clean.de
They must be sold, their value must be realized in money, this money must be transformed once again into capital, and so on, again and again.		ch22_clean.en-ch22_clean.de
This cycle, in which the same phases are continually gone through in succession, forms the circulation of capital.		ch22_clean.en-ch22_clean.de
The first condition of accumulation is that the capitalist must have contrived to sell his commodities, and to reconvert into capital the greater part of the money received from their sale.		ch22_clean.en-ch22_clean.de
In the following pages, we shall assume that capital passes through its process of circulation in the normal way.		ch22_clean.en-ch22_clean.de
The detailed analysis of the process will be found in Volume 2.		ch22_clean.en-ch22_clean.de
The capitalist who produces surplus-value, i.e. who extracts unpaid labour directly from the workers and fixes it in commodities, is admittedly the first appropriator of this surplus-value, but he is by no means its ultimate proprietor.		ch22_clean.en-ch22_clean.de
He has to share it afterwards with capitalists who fulfil other functions in social production taken as a whole, with the owner of the land, and with yet other people.		ch22_clean.en-ch22_clean.de
Surplus-value is therefore split up into various parts.		ch22_clean.en-ch22_clean.de
Its fragments fall to various categories of person, and take on various mutually independent forms, such as profit, interest, gains made through trade, ground rent, etc.		ch22_clean.en-ch22_clean.de
We shall be able to deal with these modified forms of surplus-value only in Volume 3.		ch22_clean.en-ch22_clean.de
On the one hand, then, we assume here that the capitalist sells the commodities he has produced at their value, and we shall not concern ourselves with their later return to the market, or the new forms that capital assumes while in the sphere of circulation, or the concrete conditions of reproduction hidden within those forms.		ch22_clean.en-ch22_clean.de
On the other hand, we treat the capitalist producer as the owner of the entire surplus-value, or, perhaps better, as the representative of all those who will share the booty with him.		ch22_clean.en-ch22_clean.de
We shall therefore begin by considering accumulation from an abstract point of view, i.e. simply as one aspect of the immediate process of production.		ch22_clean.en-ch22_clean.de
In so far as accumulation actually takes place, the capitalist must have succeeded in selling his commodities, and in reconverting the money shaken loose from them into capital.		ch22_clean.en-ch22_clean.de
Moreover, the break-up of surplus-value into various fragments does not affect either its nature or the conditions under which it becomes an element in accumulation.		ch22_clean.en-ch22_clean.de
Whatever the proportion of surplus-value which the capitalist producer retains for himself, or yields up to others, he is the one who in the first instance appropriates it.		ch22_clean.en-ch22_clean.de
In our presentation of accumulation, then, we assume no more than is assumed by the actual process of accumulation itself.		ch22_clean.en-ch22_clean.de
On the other hand, the simple, fundamental form of the process of accumulation is obscured both by the splitting-up of surplus-value and by the mediating movement of circulation.		ch22_clean.en-ch22_clean.de
An exact analysis of the process, therefore, demands that we should, for a time, disregard all phenomena that conceal the workings of its inner mechanism.		ch22_clean.en-ch22_clean.de

