Chapter 23: Simple Reproduction Whatever the social form of the production process, it has to be continuous, it must periodically repeat the same phases.	EINUNDZWANZIGSTES KAPITEL Einfache Reproduktion Welches immer die gesellschaftliche Form des Produktionsprozesses, er muß kontinuierlich sein oder periodisch stets von neuem dieselben Stadien durchlaufen.	ch23_clean.en-ch23_clean.de
A society can no more cease to produce than it can cease to consume.	Sowenig eine Gesellschaft aufhören kann zu konsumieren, kann sie aufhören zu produzieren.	ch23_clean.en-ch23_clean.de
When viewed, therefore, as a connected whole, and in the constant flux of its incessant renewal, every social process of production is at the same time a process of reproduction.	In einem stetigen Zusammenhang und dem beständigen Fluß seiner Erneuerung betrachtet, ist jeder gesellschaftliche Produktionsprozeß daher zugleich Reproduktionsprozeß.	ch23_clean.en-ch23_clean.de
The conditions of production are at the same time the conditions of reproduction.	Die Bedingungen der Produktion sind zugleich die Bedingungen der Reproduktion.	ch23_clean.en-ch23_clean.de
No society can go on producing, in other words no society can reproduce, unless it constantly reconverts a part of its products into means of production, or elements of fresh products.	Keine Gesellschaft kann fortwährend produzieren, d.h. reproduzieren, ohne fortwährend einen Teil ihrer Produkte in Produktionsmittel oder Elemente der Neuproduktion rückzuverwandeln.	ch23_clean.en-ch23_clean.de
All other circumstances remaining the same, the society can reproduce or maintain its wealth on the existing scale only by replacing the means of production which have been used up – i.e. the instruments of labour, the raw material and the auxiliary substances – with an equal quantity of new articles. These must be separated from the mass of the yearly product, and incorporated once again into the production process.	Unter sonst gleichbleibenden Umständen kann sie ihren Reichtum nur auf derselben Stufenleiter reproduzieren oder erhalten, indem sie die, während des Jahres z.B., verbrauchten Produktionsmittel, d.h. Arbeitsmittel, Rohmateriale und Hilfsstoffe, in natura durch ein gleiches Quantum neuer Exemplare ersetzt, welches von der jährlichen Produktenmasse abgeschieden und von neuem dem Produktionsprozeß einverleibt wird.	ch23_clean.en-ch23_clean.de
Hence a definite portion of each year’s product belongs to the sphere of production.	Ein bestimmtes Quantum des jährlichen Produkts gehört also der Produktion.	ch23_clean.en-ch23_clean.de
Destined for productive consumption from the very first, this portion exists, for the most part, in forms which by their very nature exclude the possibility of individual consumption.	Von Haus aus für die produktive Konsumtion bestimmt, existiert es großenteils in Naturalformen, die von selbst die individuelle Konsumtion ausschließen.	ch23_clean.en-ch23_clean.de
If production has a capitalist form, so too will reproduction.	Hat die Produktion kapitalistische Form, so die Reproduktion.	ch23_clean.en-ch23_clean.de
Just as in the capitalist mode of production the labour process appears only as a means towards the process of valorization, so in the case of reproduction it appears only as a means of reproducing the value advanced as capital, i.e. as self-valorizing value.	Wie in der kapitalistischen Produktionsweise der Arbeitsprozeß nur als ein Mittel für den Verwertungsprozeß erscheint, so die Reproduktion nur als ein Mittel, den vorgeschoßnen Wert als Kapital zu reproduzieren, d.h. als sich verwertenden Wert.	ch23_clean.en-ch23_clean.de
The economic character of capitalist becomes firmly fixed to a man only if his money constantly functions as capital.	Die ökonomische Charaktermaske des Kapitalisten hängt nur dadurch an einem Menschen fest, daß sein Geld fortwährend als Kapital funktioniert.	ch23_clean.en-ch23_clean.de
If, for instance, a sum of £ has this year been converted into capital, and has produced a surplus-value of £20, it must continue during the next year, and subsequent years, to repeat the same operation.	Hat z.B. die vorgeschoßne Geldsumme von 100 Pfd.St. sich dieses Jahr in Kapital verwandelt und einen Mehrwert von 20 Pfd.St. produziert, so muß sie das nächste Jahr usf. dieselbe Operation wiederholen.	ch23_clean.en-ch23_clean.de
As a periodic increment of the value of the capital, or a periodic fruit borne by capital-in-process, surplus-value acquires the form of a revenue arising out of capital.	Als periodisches Inkrement des Kapitalwerts, oder periodische Frucht des prozessierenden Kapitals, erhält der Mehrwert die Form einer aus dem Kapital entspringenden Revenue.	ch23_clean.en-ch23_clean.de
If this revenue serves the capitalist only as a fund to provide for his consumption, and if it is consumed as periodically as it is gained, then, other things being equal, simple reproduction takes place.	Dient diese Revenue dem Kapitalisten nur als Konsumtionsfonds oder wird sie ebenso periodisch verzehrt wie gewonnen, so findet, unter sonst gleichbleibenden Umständen, einfache Reproduktion statt.	ch23_clean.en-ch23_clean.de
And although this reproduction is a mere repetition of the process of production, on the same scale as before, this mere repetition, or continuity, imposes on the process certain new characteristics, or rather, causes the disappearance of some apparent characteristics possessed by the process in isolation.	Obgleich letztere nun bloße Wiederholung des Produktionsprozesses auf derselben Stufenleiter, drückt diese bloße Wiederholung oder Kontinuität dem Prozesse gewisse neue Charaktere auf oder löst vielmehr die Scheincharaktere seines nur vereinzelten Vorgangs auf.	ch23_clean.en-ch23_clean.de
The purchase of labour-power for a fixed period is the prelude to the production process; and this prelude is constantly repeated when the period of time for which the labour-power has been sold comes to an end, when a definite period of production, such as a week or a month, has elapsed.	Der Produktionsprozeß wird eingeleitet mit dem Kauf der Arbeitskraft für eine bestimmte Zeit, und diese Einleitung erneuert sich beständig, sobald der Verkaufstermin der Arbeit fällig und damit eine bestimmte Produktionsperiode, Woche, Monat usw., abgelaufen ist.	ch23_clean.en-ch23_clean.de
But the worker is not paid until after he has expended his labour-power, and realized both the value of his labour-power and a certain quantity of surplus-value in the shape of commodities.	Gezahlt wird der Arbeiter aber erst, nachdem seine Arbeitskraft gewirkt und sowohl ihren eignen Wert als den Mehrwert in Waren realisiert hat.	ch23_clean.en-ch23_clean.de
He has therefore produced not only surplus-value, which we for the present regard as a fund to meet the private consumption of the capitalist, but also the variable capital, the fund out of which he himself is paid, before it flows back to him in the shape of wages; and his employment lasts only as long as he continues to reproduce this fund.	Er hat also wie den Mehrwert, den wir einstweilen nur als Konsumtionsfonds des Kapitalisten betrachten, so den Fonds seiner eignen Zahlung, das variable Kapital produziert, bevor es ihm in der Form des Arbeitslohnes zurückfließt, und er wird nur so lange beschäftigt, als er ihn beständig reproduziert.	ch23_clean.en-ch23_clean.de
This is the reason for the formula of the economists, mentioned in Chapter 18, under II, which presents wages as a share in the product itself.	Daher die im sechzehnten Kapitel unter II. erwähnte Formel der Ökonomen, die das Salair als Anteil am Produkt selbst darstellt.	ch23_clean.en-ch23_clean.de
What flows back to the worker in the shape of wages is a portion of the product he himself continuously reproduces.	Es ist ein Teil des vom Arbeiter selbst beständig reproduzierten Produkts, das ihm in der Form des Arbeitslohns beständig zurückfließt.	ch23_clean.en-ch23_clean.de
The capitalist, it is true, pays him the value of the commodity in money, but this money is merely the transmuted form of the product of his labour.	Der Kapitalist zahlt ihm den Warenwert allerdings in Geld. Dies Geld ist aber nur die verwandelte Form des Arbeitsprodukts.	ch23_clean.en-ch23_clean.de
While he is converting a portion of the means of production into products, a portion of his former product is being turned into money.	Während der Arbeiter einen Teil der Produktionsmittel in Produkt verwandelt, rückverwandelt sich ein Teil seines früheren Produkts in Geld.	ch23_clean.en-ch23_clean.de
It is his labour of last week, or of last year, that pays for his labour-power this week or this year.	Es ist seine Arbeit von voriger Woche oder vom letzten halben Jahre, womit seine Arbeit von heute oder vom nächsten halben Jahr gezahlt wird.	ch23_clean.en-ch23_clean.de
The illusion created by the money-form vanishes immediately if, instead of taking a single capitalist and a single worker, we take the whole capitalist class and the whole working class.	Die Illusion, welche die Geldform erzeugt, verschwindet sofort, sobald statt des einzelnen Kapitalisten und des einzelnen Arbeiters Kapitalistenklasse und Arbeiterklasse betrachtet werden.	ch23_clean.en-ch23_clean.de
The capitalist class is constantly giving to the working class drafts, in the form of money, on a portion of the product produced by the latter and appropriated by the former.	Die Kapitalistenklasse gibt der Arbeiterklasse beständig in Geldform Anweisungen auf einen Teil des von der letzteren produzierten und von der erstren angeeigneten Produkts.	ch23_clean.en-ch23_clean.de
The workers give these drafts back just as constantly to the capitalists, and thereby withdraw from the latter their allotted share of their own product.	Diese Anweisungen gibt der Arbeiter der Kapitalistenklasse ebenso beständig zurück und entzieht ihr damit den ihm selbst zufallenden Teil seines eignen Produkts.	ch23_clean.en-ch23_clean.de
The transaction is veiled by the commodity-form of the product and the money-form of the commodity.	Die Warenform des Produkts und die Geldform der Ware verkleiden die Transaktion.	ch23_clean.en-ch23_clean.de
Variable capital is therefore only a particular historical form of appearance of the fund for providing the means of subsistence, or the labour-fund, which the worker requires for his own maintenance and reproduction, and which, in all systems of social production, he must himself produce and reproduce.	Das variable Kapital ist also nur eine besondre historische Erscheinungsform des Fonds von Lebensmitteln oder des Arbeitsfonds, den der Arbeiter zu seiner Selbsterhaltung und Reproduktion bedarf und den er in allen Systemen der gesellschaftlichen Produktion stets selbst produzieren und reproduzieren muß.	ch23_clean.en-ch23_clean.de
If the labour-fund constantly flows to him in the form of money that pays for his labour, it is because his own product constantly moves away from him in the form of capital.	Der Arbeitsfonds fließt ihm nur beständig in Form von Zahlungsmitteln seiner Arbeit zu, weil sein eignes Produkt sich beständig in der Form des Kapitals von ihm entfernt.	ch23_clean.en-ch23_clean.de
But this form of appearance of the labour-fund makes no difference to the fact that it is the worker’s own objectified labour which is advanced to him by the capitalist.	Aber diese Erscheinungsform des Arbeitsfonds ändert nichts daran, daß dem Arbeiter seine eigne vergegenständlichte Arbeit vom Kapitalisten vorgeschossen wird.	ch23_clean.en-ch23_clean.de
Let us take a peasant liable to do compulsory labour services.	Nehmen wir einen Fronbauer.	ch23_clean.en-ch23_clean.de
He works on his own land with his own means of production for, say, three days a week.	Er arbeitet mit seinen eignen Produktionsmitteln auf seinem eignen Acker z.B. 3 Tage in der Woche.	ch23_clean.en-ch23_clean.de
The other three days are devoted to forced labour on the lord’s domain.	Die drei andren Wochentage verrichtet er Fronarbeit auf dem herrschaftlichen Gut.	ch23_clean.en-ch23_clean.de
He constantly reproduces his own labour-fund, which never, in his case, takes the form of a money payment for his labour, advanced by another person.	Er reproduziert seinen eignen Arbeitsfonds beständig, und dieser erhält ihm gegenüber nie die Form von einem Dritten für seine Arbeit vorgeschoßner Zahlungsmittel.	ch23_clean.en-ch23_clean.de
But in return his unpaid and forced labour for the lord never acquires the character of voluntary and paid labour.	Im Ersatz erhält auch niemals seine unbezahlte Zwangsarbeit die Form freiwilliger und bezahlter Arbeit.	ch23_clean.en-ch23_clean.de
If one, fine morning, the landowner appropriates to himself the plot of land, the cattle, the seed, in short, the means of production of the peasant, the latter will thenceforth be obliged to sell his labour-power to the former.	Wenn morgen der Gutsherr den Acker, das Zugvieh, die Samen, kurz die Produktionsmittel des Fronbauern sich selbst aneignet, so hat dieser von nun an seine Arbeitskraft an den Fronherrn zu verkaufen.	ch23_clean.en-ch23_clean.de
He will, other things being equal, labour six days a week as before, three for himself, three for his former lord, who thenceforth becomes a wage-paying capitalist.	Unter sonst gleichbleibenden Umständen wird er nach wie vor 6 Tage in der Woche arbeiten, 3 Tage für sich selbst, 3 für den Exfronherrn, der jetzt in einen Lohnherrn verwandelt ist.	ch23_clean.en-ch23_clean.de
As before, he will use up the means of production as means of production, and transfer their value to the product.	Er wird nach wie vor die Produktionsmittel als Produktionsmittel vernutzen und ihren Wert auf das Produkt übertragen.	ch23_clean.en-ch23_clean.de
As before, a definite portion of the product will be devoted to reproduction.	Nach wie vor wird ein bestimmter Teil des Produkts in die Reproduktion eingehn.	ch23_clean.en-ch23_clean.de
But from the moment that forced labour is changed into wage-labour, the labour-fund, which the peasant himself continues as before to produce and reproduce, takes the form of a quantity of capital advanced in the form of wages by the lord of the land.	Wie aber die Fronarbeit die Form der Lohnarbeit, nimmt der vom Fronbauer nach wie vor produzierte und reproduzierte Arbeitsfonds die Form eines ihm vom Fronherrn vorgeschoßnen Kapitals an.	ch23_clean.en-ch23_clean.de
The bourgeois economist, whose limited mentality is unable to separate the form of appearance from the thing which appears within that form, shuts his eyes to the fact that even at the present time the labour-fund only crops up exceptionally on the face of the globe in the form of capital.	Der bürgerliche Ökonom, dessen beschränktes Hirn die Erscheinungsform von dem, was darin erscheint, nicht trennen kann, schließt die Augen vor der Tatsache, daß selbst noch heutzutag der Arbeitsfonds nur ausnahmsweis auf dem Erdrund in der Form von Kapital auftritt.	ch23_clean.en-ch23_clean.de
Variable capital, it is true, loses its character of a value advanced out of the capitalist’s funds only when we view the process of capitalist production in the flow of its constant renewal.	Allerdings verliert das variable Kapital nur den Sinn eines aus dem eignen Fonds des Kapitalisten vorgeschoßnen Wertes (4a), sobald wir den kapitalistischen Produktionsprozeß im beständigen Fluß seiner Erneuerung betrachten.	ch23_clean.en-ch23_clean.de
But that process must have had a beginning of some kind.	Aber er muß doch irgendwo und irgendwann anfangen.	ch23_clean.en-ch23_clean.de
From our present standpoint it therefore seems likely that the capitalist, once upon a time, became possessed of money by some form of primitive* accumulation [ursprüngliche Akkumulation] that took place independently of the unpaid labour of other people, and that this was therefore how he was able to frequent the market as a buyer of labour-power.	Von unsrem bisherigen Standpunkt ist es daher wahrscheinlich, daß der Kapitalist irgendeinmal durch irgendeine, von unbezahlter fremder Arbeit unabhängige, ursprüngliche Akkumulation Geldbesitzer ward und daher den Markt als Käufer von Arbeitskraft beschreiten konnte.	ch23_clean.en-ch23_clean.de
However this may be, the mere continuity of the process of capitalist production, or simple reproduction, brings about other remarkable transformations which seize hold of not only the variable, but the total capital.	Indes bewirkt die bloße Kontinuität des kapitalistischen Produktionsprozesses, oder die einfache Reproduktion, noch andre sonderbare Wechsel, die nicht nur den variablen Kapitalteil ergreifen, sondern das Gesamtkapital.	ch23_clean.en-ch23_clean.de
If a surplus-value of £ is generated every year by the use of a capital of £1,000, and if this surplus-value is consumed every year, it is clear that when this process has been repeated for five years, the surplus-value consumed will amount to 5 × £200, or the £1, originally advanced.	Beträgt der mit einem Kapital von 1.000 Pfd.St. periodisch, z.B. jährlich, erzeugte Mehrwert 200 Pfd.St. und wird dieser Mehrwert jährlich verzehrt, so ist es klar, daß nach fünfjähriger Wiederholung desselben Prozesses die Summe des verzehrten Mehrwerts = 5 × 200 ist oder gleich dem ursprünglich vorgeschoßnen Kapitalwert von 1.000 Pfd.St.	ch23_clean.en-ch23_clean.de
If only a part were consumed, say one-half, the same result would follow at the end of ten years, since 10× £ = £1,000.	Würde der jährliche Mehrwert nur teilweis verzehrt, z.B. nur zur Hälfte, so ergäbe sich dasselbe Resultat nach zehnjähriger Wiederholung des Produktionsprozesses, denn 10 × 100 = 1.000.	ch23_clean.en-ch23_clean.de
The following general formulation emerges: the value of the capital advanced divided by the surplus-value annually consumed gives the number of years, or periods of reproduction, at the expiration of which the capital originally advanced has been consumed by the capitalist and has disappeared.	Allgemein: Der vorgeschoßne Kapitalwert, dividiert durch den jährlich verzehrten Mehrwert, ergibt die Jahresanzahl oder die Anzahl von Reproduktionsperioden, nach deren Ablauf das ursprünglich vorgeschoßne Kapital vom Kapitalisten aufgezehrt und daher verschwunden ist.	ch23_clean.en-ch23_clean.de
The capitalist thinks that he is consuming the produce of the unpaid labour of others, i.e. the surplus-value, and is keeping intact the value of his original capital; but what he thinks cannot alter the actual situation.	Die Vorstellung des Kapitalisten, daß er das Produkt der fremden unbezahlten Arbeit, den Mehrwert, verzehrt und den ursprünglichen Kapitalwert erhält, kann absolut nichts an der Tatsache ändern.	ch23_clean.en-ch23_clean.de
After the lapse of a certain number of years, the value of the capital he possesses is equal to the sum total of the surplus-value he has appropriated during those years, and the total value he has consumed is equal to the value of his original capital.	Nach Abfluß einer gewissen Jahreszahl ist der von ihm geeignete Kapitalwert gleich der Summe des während derselben Jahreszahl ohne Äquivalent angeeigneten Mehrwerts und die von ihm verzehrte Wertsumme gleich dem ursprünglichen Kapitalwert.	ch23_clean.en-ch23_clean.de
It is true that he has in hand a quantity of capital whose magnitude has not changed, and that part of it, such as buildings, machinery, etc., was already there when he began to conduct his business operations.	Allerdings behält er in der Hand ein Kapital, dessen Größe sich nicht verändert hat, wovon ein Teil, Gebäude, Maschinen usw., bereits vorhanden war, als er sein Geschäft in Gang brachte.	ch23_clean.en-ch23_clean.de
But we are not concerned here with the material components of the capital.	Aber hier handelt es sich vom Wert des Kapitals und nicht von seinen materiellen Bestandteilen.	ch23_clean.en-ch23_clean.de
We are concerned with its value. When a person consumes the whole of his property, by taking upon himself debts equal to the value of that property, it is clear that his property represents nothing but the sum total of his debts.	Wenn jemand sein ganzes Besitztum aufzehrt dadurch, daß er Schulden aufnimmt, die dem Wert dieses Besitztums gleichkommen, so repräsentiert eben das ganze Besitztum nur die Gesamtsumme seiner Schulden.	ch23_clean.en-ch23_clean.de
And so it is with the capitalist; when he has consumed the equivalent of his original capital, the value of his present capital represents nothing but the total amount of surplus-value appropriated by him without payment.	Und ebenso, wenn der Kapitalist das Äquivalent seines vorgeschoßnen Kapitals aufgezehrt hat, repräsentiert der Wert dieses Kapitals nur noch die Gesamtsumme des von ihm unentgeltlich angeeigneten Mehrwerts.	ch23_clean.en-ch23_clean.de
Not a single atom of the value of his old capital continues to exist.	Kein Wertatom seines alten Kapitals existiert fort.	ch23_clean.en-ch23_clean.de
Therefore, entirely leaving aside all accumulation, the mere continuity of the production process, in other words simple reproduction, sooner or later, and necessarily, converts all capital into accumulated capital, or capitalized surplus-value.	Ganz abgesehn von aller Akkumulation verwandelt also die bloße Kontinuität des Produktionsprozesses, oder die einfache Reproduktion, nach kürzerer oder längerer Periode jedes Kapital notwendig in akkumuliertes Kapital oder kapitalisierten Mehrwert.	ch23_clean.en-ch23_clean.de
Even if that capital was, on its entry into the process of production, the personal property of the man who employs it, and was originally acquired by his own labour, it sooner or later becomes value appropriated without an equivalent, the unpaid labour of others materialized either in the money-form or in some other way.	War es selbst bei seinem Eintritt in den Produktionsprozeß persönlich erarbeitetes Eigentum seines Anwenders, früher oder später wird es ohne äquivalent angeeigneter Wert oder Materiatur, ob in Geldform oder anders, unbezahlter fremder Arbeit.	ch23_clean.en-ch23_clean.de
We saw in Chapter 4 that for the transformation of money into capital something more was required than the production and circulation of commodities.	Wir sahen im vierten Kapitel: Um Geld in Kapital zu verwandeln, genügte nicht das Vorhandensein von Warenproduktion <4. Auflage: Wertproduktion> und Warenzirkulation.	ch23_clean.en-ch23_clean.de
We saw that on the one hand the possessor of value or money, on the other hand the possessor of the value-creating substance – on the one hand, the possessor of the means of production and subsistence, on the other, the possessor of nothing but labour-power – must confront each other as buyer and seller.	Es mußten erst, hier Besitzer von Wert oder Geld, dort Besitzer der wertschaffenden Substanz; hier Besitzer von Produktions- und Lebensmitteln, dort Besitzer von nichts als Arbeitskraft, einander als Käufer und Verkäufer gegenübertreten.	ch23_clean.en-ch23_clean.de
A division between the product of labour and labour itself, between the objective conditions of labour and subjective labour-power, was therefore the real foundation and the starting-point of the process of capitalist production.	Scheidung zwischen dem Arbeitsprodukt und der Arbeit selbst, zwischen den objektiven Arbeitsbedingungen und der subjektiven Arbeitskraft, war also die tatsächlich gegebne Grundlage, der Ausgangspunkt des kapitalistischen Produktionsprozesses.	ch23_clean.en-ch23_clean.de
But what at first was merely a starting-point becomes, by means of nothing but the continuity of the process, by simple reproduction, the characteristic result of capitalist production, a result which is constantly renewed and perpetuated.	Was aber anfangs nur Ausgangspunkt war, wird vermittelst der bloßen Kontinuität des Prozesses, der einfachen Reproduktion, stets aufs neue produziert und verewigt als eignes Resultat der kapitalistischen Produktion.	ch23_clean.en-ch23_clean.de
On the one hand, the production process incessantly converts material wealth into capital, into the capitalist’s means of enjoyment and his means of valorization.	Einerseits verwandelt der Produktionsprozeß fortwährend den stofflichen Reichtum in Kapital, in Verwertungs- und Genußmittel für den Kapitalisten.	ch23_clean.en-ch23_clean.de
On the other hand, the worker always leaves the process in the same state as he entered it – a personal source of wealth, but deprived of any means of making that wealth a reality for himself.	Andrerseits kommt der Arbeiter beständig aus dem Prozeß heraus, wie er in ihn eintrat - persönliche Quelle des Reichtums, aber entblößt von allen Mitteln, diesen Reichtum für sich zu verwirklichen.	ch23_clean.en-ch23_clean.de
Since, before he enters the process, his own labour has already been alienated [entfremdet] from him, appropriated by the capitalist, and incorporated with capital, it now, in the course of the process, constantly objectifies itself so that it becomes a product alien to him [fremder Produkt].	Da vor seinem Eintritt in den Prozeß seine eigne Arbeit ihm selbst entfremdet, dem Kapitalisten angeeignet und dem Kapital einverleibt ist, vergegenständlicht sie sich während des Prozesses beständig in fremdem Produkt.	ch23_clean.en-ch23_clean.de
Since the process of production is also the process of the consumption of labour-power by the capitalist, the worker’s product is not only constantly converted into commodities, but also into capital, i.e. into value that sucks up the worker’s value-creating power, means of subsistence that actually purchase human beings, and means of production that employ the people who are doing the producing.	Da der Produktionsprozeß zugleich der Konsumtionsprozeß der Arbeitskraft durch den Kapitalisten, verwandelt sich das Produkt des Arbeiters nicht nur fortwährend in Ware, sondern in Kapital, Wert, der die wertschöpfende Kraft aussaugt, Lebensmittel, die Personen kaufen, Produktionsmittel, die den Produzenten anwenden.	ch23_clean.en-ch23_clean.de
Therefore the worker himself constantly produces objective wealth, in the form of capital, an alien power that dominates and exploits him; and the capitalist just as constantly produces labour-power, in the form of a subjective source of wealth which is abstract, exists merely in the physical body of the worker, and is separated from its own means of objectification and realization; in short, the capitalist produces the worker as a wage-labourer.	Der Arbeiter selbst produziert daher beständig den objektiven Reichtum als Kapital, ihm fremde, ihn beherrschende und ausbeutende Macht, und der Kapitalist produziert ebenso beständig die Arbeitskraft als subjektive, von ihren eignen Vergegenständlichungs- und Verwirklichungsmitteln getrennte, abstrakte, in der bloßen Leiblichkeit des Arbeiters existierende Reichtumsquelle, kurz den Arbeiter als Lohnarbeiter.	ch23_clean.en-ch23_clean.de
This incessant reproduction, this perpetuation of the worker, is the absolutely necessary condition for capitalist production.	Diese beständige Reproduktion oder Verewigung des Arbeiters ist das sine qua non <die unerläßliche Bedingung> der kapitalistischen Produktion.	ch23_clean.en-ch23_clean.de
The worker’s consumption is of two kinds. While producing he consumes the means of production with his labour, and converts them into products with a higher value than that of the capital advanced.	Die Konsumtion des Arbeiters ist doppelter Art. In der Produktion selbst konsumiert er durch seine Arbeit Produktionsmittel und verwandelt sie in Produkte von höherem Wert als dem des vorgeschoßnen Kapitals.	ch23_clean.en-ch23_clean.de
This is his productive consumption.	Dies ist seine produktive Konsumtion.	ch23_clean.en-ch23_clean.de
It is at the same time consumption of his labour-power by the capitalist who has bought it.	Sie ist gleichzeitig Konsumtion seiner Arbeitskraft durch den Kapitalisten, der sie gekauft hat.	ch23_clean.en-ch23_clean.de
On the other hand, the worker uses the money paid to him for his labour-power to buy the means of subsistence; this is his individual consumption.	Andrerseits verwendet der Arbeiter das für den Kauf der Arbeitskraft gezahlte Geld in Lebensmittel: dies ist seine individuelle Konsumtion.	ch23_clean.en-ch23_clean.de
The worker’s productive consumption and his individual consumption are therefore totally distinct.	Die produktive und die individuelle Konsumtion des Arbeiters sind also total verschieden.	ch23_clean.en-ch23_clean.de
In the former, he acts as the motive power of capital, and belongs to the capitalist. In the latter, he belongs to himself, and performs his necessary vital functions outside the production process.	In der ersten handelt er als bewegende Kraft des Kapitals und gehört dem Kapitalisten; in der zweiten gehört er sich selbst und verrichtet Lebens- funktionen außerhalb des Produktionsprozesses.	ch23_clean.en-ch23_clean.de
The result of the first kind of consumption is that the capitalist continues to live, of the second, that the worker himself continues to live.	Das Resultat der einen ist das Leben des Kapitalisten, das der andern ist das Leben des Arbeiters selbst.	ch23_clean.en-ch23_clean.de
When dealing with the ‘working day’, we saw that the worker is often compelled to make his individual consumption into a merely incidental part of the production process.	Bei Betrachtung des "Arbeitstags" usw. zeigte sich gelegentlich, daß der Arbeiter oft gezwungen ist, seine individuelle Konsumtion zu einem bloßen Inzident des Produktionsprozesses zu machen.	ch23_clean.en-ch23_clean.de
In such a case, he provides himself with means of subsistence in order to keep his labour-power in motion, just as coal and water are supplied to the steam-engine, and oil to the wheel.	In diesem Fall setzt er sich Lebensmittel zu, um seine Arbeitskraft im Gang zu halten, wie der Dampfmaschine Kohle und Wasser, dem Rad Öl zugesetzt wird.	ch23_clean.en-ch23_clean.de
His means of consumption are then merely the means of consumption of a means of production; his individual consumption is directly productive consumption.	Seine Konsumtionsmittel sind dann bloß Konsumtionsmittel eines Produktionsmittels, seine individuelle Konsumtion direkt produktive Konsumtion.	ch23_clean.en-ch23_clean.de
This, however, appears to be an abuse, rather than an essential attribute of the capitalist process of production.	Dies erscheint jedoch als ein dem kapitalistischen Produktionsprozeß unwesentlicher Mißbrauch.	ch23_clean.en-ch23_clean.de
The matter takes quite another aspect if we contemplate not the single capitalist and the single worker, but the capitalist class and the working class, not an isolated process of production, but capitalist production in full swing, and on its actual social scale. By converting part of his capital into labour-power, the capitalist valorizes the value of his entire capital.	Anders sieht die Sache aus, sobald wir nicht den einzelnen Kapitalisten und den einzelnen Arbeiter betrachten, sondern die Kapitalistenklasse und die Arbeiterklasse, nicht den vereinzelten Produktionsprozeß der Ware, sondern den kapitalistischen Produktionsprozeß in seinem Fluß und in seinem gesellschaftlichen Umfang. - Wenn der Kapitalist einen Teil seines Kapitals in Arbeitskraft umsetzt, verwertet er damit sein Gesamtkapital.	ch23_clean.en-ch23_clean.de
He kills two birds with one stone.	Er schlägt zwei Fliegen mit einer Klappe.	ch23_clean.en-ch23_clean.de
He profits not only by what he receives from the worker, but also by what he gives him.	Er profitiert nicht nur von dem, was er vom Arbeiter empfängt, sondern auch von dem, was er ihm gibt.	ch23_clean.en-ch23_clean.de
The capital given in return for labour-power is converted into means of subsistence which have to be consumed to reproduce the muscles, nerves, bones and brains of existing workers, and to bring new workers into existence.	Das im Austausch gegen Arbeitskraft veräußerte Kapital wird in Lebensmittel verwandelt, deren Konsumtion dazu dient, Muskel, Nerven, Knochen, Hirn vorhandner Arbeiter zu reproduzieren und neue Arbeiter zu zeugen.	ch23_clean.en-ch23_clean.de
Within the limits of what is absolutely necessary, therefore, the individual consumption of the working class is the reconversion of the means of subsistence given by capital in return for labour-power into fresh labour-power which capital is then again able to exploit.	Innerhalb der Grenzen des absolut Notwendigen ist daher die individuelle Konsumtion der Arbeiterklasse Rückverwandlung der vom Kapital gegen Arbeitskraft veräußerten Lebensmittel in vom Kapital neu exploitierbare Arbeitskraft.	ch23_clean.en-ch23_clean.de
It is the production and reproduction of the capitalist’s most indispensable means of production: the worker.	Sie ist Produktion und Reproduktion des dem Kapitalisten unentbehrlichsten Produktionsmittels, des Arbeiters selbst.	ch23_clean.en-ch23_clean.de
The individual consumption of the worker, whether it occurs inside or outside the workshop, inside or outside the labour process, remains an aspect of the production and reproduction of capital, just as the cleaning of machinery does, whether it is done during the labour process, or when intervals in that process permit.	Die individuelle Konsumtion des Arbeiters bleibt also ein Moment der Produktion und Reproduktion des Kapitals, ob sie innerhalb oder außerhalb der Werkstatt, Fabrik usw., innerhalb oder außerhalb des Arbeitsprozesses vorgeht, ganz wie die Reinigung der Maschine, ob sie während des Arbeitsprozesses oder bestimmter Pausen desselben geschieht.	ch23_clean.en-ch23_clean.de
The fact that the worker performs acts of individual consumption in his own interest, and not to please the capitalist, is something entirely irrelevant to the matter.	Es tut nichts zur Sache, daß der Arbeiter seine individuelle Konsumtion sich selbst und nicht dem Kapitalisten zulieb vollzieht.	ch23_clean.en-ch23_clean.de
The consumption of food by a beast of burden does not become any less a necessary aspect of the production process because the beast enjoys what it eats.	So bleibt der Konsum des Lastviehs nicht minder ein notwendiges Moment des Produktionsprozesses, weil das Vieh selbst genießt, was es frißt.	ch23_clean.en-ch23_clean.de
The maintenance and reproduction of the working class remains a necessary condition for the reproduction of capital.	Die beständige Er- haltung und Reproduktion der Arbeiterklasse bleibt beständige Bedingung für die Reproduktion des Kapitals.	ch23_clean.en-ch23_clean.de
But the capitalist may safely leave this to the worker’s drives for self-preservation and propagation.	Der Kapitalist kann ihre Erfüllung getrost dem Selbsterhaltungs- und Fortpflanzungstrieb der Arbeiter überlassen.	ch23_clean.en-ch23_clean.de
All the capitalist cares for is to reduce the worker’s individual consumption to the necessary minimum, and an immense distance separates his attitude from the crudeness of the South American mine-owners, who force their workers to consume the more substantial, rather than the less substantial, kind of food.	Er sorgt nur dafür, ihre individuelle Konsumtion möglichst auf das Notwendige einzuschränken, und ist himmelweit entfernt von jener südamerikanischen Roheit, die den Arbeiter zwingt, substantiellere statt weniger substantieller Nahrungsmittel einzunehmen.	ch23_clean.en-ch23_clean.de
Hence both the capitalist and his ideologist, the political economist, consider only that part of the worker’s individual consumption to be productive which is required for the perpetuation of the working class, and which therefore must take place in order that the capitalist may have labour-power to consume. What the worker consumes over and above that minimum for his own pleasure is seen as unproductive consumption.	Daher betrachtet auch der Kapitalist und sein Ideolog, der politische Ökonom, nur den Teil der individuellen Konsumtion des Arbeiters als produktiv, der zur Verewigung der Arbeiterklasse erheischt ist, also in der Tat verzehrt werden muß, damit das Kapital die Arbeitskraft verzehre; was der Arbeiter außerdem zu seinem Vergnügen verzehren mag, ist unproduktive Konsumtion.	ch23_clean.en-ch23_clean.de
If the accumulation of capital were to cause a rise of wages and an increase in the worker’s consumption unaccompanied by an increase in the consumption of labour-power by capital, the additional capital would be consumed unproductively.	Würde die Akkumulation des Kapitals eine Erhöhung des Arbeitslohns und daher Vermehrung der Konsumtionsmittel des Arbeiters verursachen ohne Konsum von mehr Arbeitskraft durch das Kapital, so wäre das zuschüssige Kapital unproduktiv konsumiert.	ch23_clean.en-ch23_clean.de
In reality, the individual consumption of the worker is unproductive even from his own point of view, for it simply reproduces the needy individual; it is productive to the capitalist and to the state, since it is the production of a force which produces wealth for other people.	In der Tat: die individuelle Konsumtion des Arbeiters ist für ihn selbst unproduktiv, denn sie reproduziert nur das bedürftige Individuum; sie ist produktiv für den Kapitalisten und den Staat, denn sie ist Produktion der den fremden Reichtum produzierenden Kraft.	ch23_clean.en-ch23_clean.de
From the standpoint of society, then, the working class, even when it stands outside the direct labour process, is just as much an appendage of capital as the lifeless instruments of labour are.	Von gesellschaftlichem Standpunkt ist also die Arbeiterklasse, auch außerhalb des unmittelbaren Arbeitsprozesses, ebensosehr Zubehör des Kapitals als das tote Arbeitsinstrument.	ch23_clean.en-ch23_clean.de
Even its individual consumption is, within certain limits, a mere aspect of the process of capital’s reproduction.	Selbst ihre individuelle Konsum- tion ist innerhalb gewisser Grenzen nur ein Moment des Reproduktionsprozesses des Kapitals.	ch23_clean.en-ch23_clean.de
That process, however, takes good care to prevent the workers, those instruments of production who are possessed of consciousness, from running away, by constantly removing their product from one pole to the other, to the opposite pole of capital.	Der Prozeß aber sorgt dafür, daß diese selbstbewußten Produktionsinstrumente nicht weglaufen, indem er ihr Produkt beständig von ihrem Pol zum Gegenpol des Kapitals entfernt.	ch23_clean.en-ch23_clean.de
Individual consumption provides, on the one hand, the means for the workers’ maintenance and reproduction; on the other hand, by the constant annihilation of the means of subsistence, it provides for their continued re-appearance on the labour-market.	Die individuelle Konsumtion sorgt einerseits für ihre eigne Erhaltung und Reproduktion, andrerseits durch Vernichtung der Lebensmittel für ihr beständiges Wiedererscheinen auf dem Arbeitsmarkt.	ch23_clean.en-ch23_clean.de
The Roman slave was held by chains; the wage-labourer is bound to his owner by invisible threads.	Der römische Sklave war durch Ketten, der Lohnarbeiter ist durch unsichtbare Fäden an seinen Eigentümer gebunden.	ch23_clean.en-ch23_clean.de
The appearance of independence is maintained by a constant change in the person of the individual employer, and by the legal fiction of a contract.	Der Schein seiner Unabhängigkeit wird durch den beständigen Wechsel der individuellen Lohnherrn und die fictio juris des Kontrakts aufrechterhalten.	ch23_clean.en-ch23_clean.de
In former times, capital resorted to legislation, whenever it seemed necessary, in order to enforce its proprietary rights over the free worker.	Früher machte das Kapital, wo es ihm nötig schien, sein Eigentumsrecht auf den freien Arbeiter durch Zwangsgesetz geltend.	ch23_clean.en-ch23_clean.de
For instance, down to 1815 the emigration of mechanics employed in machine-making was forbidden in England, on pain of severe punishment.	So war z.B. die Emigration der Maschinenarbeiter in England bis 1815 bei schwerer Strafe verboten.	ch23_clean.en-ch23_clean.de
The reproduction of the working class implies at the same time the transmission and accumulation of skills from one generation to another.	Die Reproduktion der Arbeiterklasse schließt zugleich die Überlieferung und Häufung des Geschicks von einer Generation zur andren ein.	ch23_clean.en-ch23_clean.de
The capitalist regards the existence of such a skilled working class as one of the conditions of production which belong to him, and in fact views it as the real existence of his variable capital. This becomes very clear as soon as a crisis threatens him with its loss.	Wie sehr der Kapitalist das Dasein einer solchen geschickten Arbeiterklasse unter die ihm zugehörigen Produktionsbedingungen zählt, sie in der Tat als die reale Existenz seines variablen Kapitals betrachtet, zeigt sich, sobald eine Krise deren Verlust androht.	ch23_clean.en-ch23_clean.de
As a result of the American Civil War and the accompanying cotton famine, the majority of the cotton workers of Lancashire were, as is well known, thrown out of work.	Infolge des Amerikanischen Bürgerkriegs und der ihn begleitenden Baumwollnot wurde bekanntlich die Mehrzahl der Baumwollarbeiter in Lancashire usw. aufs Pflaster geworfen.	ch23_clean.en-ch23_clean.de
Both from the working class itself, and from other social strata, there arose a cry for state aid, or voluntary national subscriptions, in order to make possible the emigration of those who were ‘redundant’ to the English colonies or to the United States.	Aus dem Schoß der Arbeiterklasse selbst, wie andrer Gesellschaftsschichten, erhob sich der Ruf nach Staatsunterstützung oder freiwilliger Nationalkollekte, um die Emigration der "Überflüssigen" in englische Kolonien oder die Vereinigten Staaten zu ermöglichen.	ch23_clean.en-ch23_clean.de
That was the time when The Times published a letter ( March 1863) from Edmund Potter, a former President of the Manchester Chamber of Commerce.	Damals veröffentlichte die "Times" (24. März 1863) einen Brief von Edmund Potter, früher Präsident der Manchester Handelskammer.	ch23_clean.en-ch23_clean.de
This letter was rightly described in the House of Commons as ‘the manifesto of the manufacturers’.	Sein Brief ward mit Recht im Unterhaus als "das Manifest der Fabrikanten" bezeichnet.	ch23_clean.en-ch23_clean.de
We shall reproduce here a few characteristic passages, in which the proprietary rights of capital over labour-power are unblushingly asserted. ’He’ (the man out of work) ‘may be told the supply of cotton-workers is too large… and… must… in fact be reduced by a third, perhaps, and that then there will be a healthy demand for the remaining two-thirds… Public opinion… urges emigration… The master cannot willingly see his labour supply being removed; he may think, and perhaps justly, that it is both wrong and unsound… But if the public funds are to be devoted to assist emigration, he has a right to be heard, and perhaps to protest.’	Wir geben hier einige charak- teristische Stellen, worin der Eigentumstitel des Kapitals auf die Arbeitskraft unverblümt ausgesprochen wird. "Den Baumwollarbeitern mag gesagt werden, daß ihre Zufuhr zu groß ist ... sie müsse vielleicht um ein Dritteil reduziert werden, und dann würde eine gesunde Nachfrage für die übrigen zwei Dritteile eintreten ... Die öffentliche Meinung dringt auf Emigration ... Der Meister" (d.h. der Baumwollfabrikant) "kann nicht willig seine Arbeitszufuhr entfernt sehn; er mag denken, daß das ebenso ungerecht als unrichtig ist ... Wenn die Emigration aus öffentlichen Fonds unterstützt wird, hat er ein Recht, Gehör zu verlangen und vielleicht zu protestieren."	ch23_clean.en-ch23_clean.de
The same Potter then proceeds to point out how useful the cotton industry is, how ‘it has undoubtedly drawn the surplus population from Ireland and from the agricultural districts’, how immense is its extent, how it yielded 5/13ths of total English exports in the year 1860, how, after a few years, it will again expand by the extension of the market, particularly of the Indian market, and by calling forth a plentiful supply of cotton at 6d. per lb.	Selbiger Potter setzt dann weiter auseinander, wie nützlich die Baumwollindustrie, wie "sie unzweifelhaft die Bevölkerung aus Irland und den englischen Agrikulturdistrikten wegdrainiert hat", wie ungeheuer ihr Umfang, wie sie im Jahr 1860 5/13 des ganzen englischen Exporthandels lieferte, wie sie nach wenigen Jahren sich wieder ausdehnen werde durch Erweiterung des Markts, besonders Indiens, und durch Erzwingung hinreichender "Baumwollzufuhr, zu 6 d. das Pfund".	ch23_clean.en-ch23_clean.de
He then continues: ‘[It is not to be denied that] time – one, two, or three years it may be – will produce the quantity… The question I would put then is this – Is the trade worth retaining?	Er fährt dann fort: "Zeit - ein, zwei, drei Jahre vielleicht - wird die nötige Quantität produzieren ...	ch23_clean.en-ch23_clean.de
Is it worth while to keep the machinery’ (he means the living labour-machines) ‘in order, and is it not the greatest folly to think of parting with that?	Ich möchte dann die Frage stellen, ist diese Industrie wert, sie festzuhalten, ist es der Mühe wert, die Maschinerie" (nämlich die lebendigen Arbeitsmaschinen) "in Ordnung zu halten, und ist es nicht die größte Narrheit, daran zu denken, sie aufzugeben!	ch23_clean.en-ch23_clean.de
I think it is.	Ich glaube das.	ch23_clean.en-ch23_clean.de
I allow that the workers are not a property, not the property of Lancashire and the masters; but they are the strength of both; they are the mental and trained power which cannot be replaced for a generation; the mere machinery which they work might much of it be beneficially replaced, nay improved, in a twelvemonth.	Ich will zugeben, daß die Arbeiter nicht Eigentum sind (I allow that the workers are not a property), nicht das Eigentum Lancashires und der Meister; aber sie sind die Stärke beider; sie sind die geistige und geschulte Kraft, die in einer Generation nicht ersetzt werden kann; die andere Maschinerie dagegen, woran sie arbeiten (the mere machinery which they work), könnte zum großen Teil mit Vorteil ersetzt und verbessert werden in zwölf Monaten.	ch23_clean.en-ch23_clean.de
Encourage or allow (!) the working-power to emigrate, and what of the capitalist?’	Ermuntert oder erlaubt (!) die Emigration der Arbeitskraft, und was wird aus dem Kapitalisten?	ch23_clean.en-ch23_clean.de
	(Encourage or allow the working power to emigrate, and what of the capitalist?)"	ch23_clean.en-ch23_clean.de
This cry from the heart reminds one of Lord Chamberlain Kalb. * ‘Take away the cream of the workers, and fixed capital will depreciate in a great degree, and the floating will not subject itself to a struggle with the short supply of inferior labour… We are told the workers wish it’ (emigration).	Dieser Herzensstoß erinnert an Hofmarschall Kalb. " ... Nehmt den Rahm der Arbeiter weg, und das fixe Kapital wird in hohem Grade entwertet und das zirkulierende Kapital wird sich nicht dem Kampf mit schmaler Zufuhr einer niedrigeren Sorte von Arbeit aussetzen ...	ch23_clean.en-ch23_clean.de
‘Very natural it is that they should do so… Reduce, compress the cotton trade by taking away its working power and reducing their wages expenditure, say one-fifth, or five millions, and what then would happen to the class above, the small shopkeepers; and what of the rents, the cottage rents… Trace out the effects upward to the small farmer, the better householder, and… the landowner, and say if there could be any suggestion more suicidal to all classes of the country than enfeebling a nation by exporting the best of its manufacturing population, and destroying the value of some of its most productive capital and enrichment… I advise a loan (of five or six millions sterling)… extending it may be over two or three years, administered by special commissioners added to the Boards of Guardians in the cotton districts, under special legislative regulations, enforcing some occupation or labour, as a means of keeping up at least the moral standard of the recipients of the loan… can anything be worse for landowners or masters than parting with the best of the workers, and demoralizing and disappointing the rest by an extended depletive emigration, a depletion of capital and value in an entire province?’	Man sagt uns, die Arbeiter selbst wünschen die Emigration. Es ist sehr natürlich, daß sie das tun ... Reduziert, komprimiert das Baumwollgeschäft durch Wegnahme seiner Arbeitskräfte (by taking away its working power), durch Verminderung ihrer Lohnverausgabung sage um 1/3 oder 5 Millionen, und was wird dann aus der nächsten Klasse über ihnen, den Kleinkrämern?	ch23_clean.en-ch23_clean.de
Potter, the chosen mouthpiece of the cotton manufacturers, distinguishes between two sorts of ‘machinery’.	Was aus den Grundrenten, was aus der Miete der cottages? ... was aus dem kleinen Pächter, dem besseren Hausbesitzer und dem Grundeigentümer?	ch23_clean.en-ch23_clean.de
	Und sagt nun, ob irgendein Plan für alle Klassen des Landes selbstmörderischer sein kann als dieser, die Nation zu schwächen durch den Export ihrer besten Fabrikarbeiter und die Entwertung eines Teils ihres produktivsten Kapitals und Reichtums?"	ch23_clean.en-ch23_clean.de
	"Ich rate zu einer Anleihe von 5 bis 6 Millionen, über 2 oder 3 Jahre verteilt, administriert durch Spezialkommissäre, beigeordnet den Armenverwaltungen in den Baumwolldistrikten, unter speziellen gesetzlichen Regulationen, mit gewisser Zwangsarbeit, um die moralische Valuta der Almosenempfänger aufrechtzuerhalten ...	ch23_clean.en-ch23_clean.de
	Kann es irgend etwas Schlimmeres geben für Grundeigentümer oder Meister (can anything be worse for landowners or masters), als ihre besten Arbeiter aufzugeben und die übrigbleibenden zu demoralisieren und zu verstimmen durch eine ausgedehnte entleerende Emigration und Entleerung von Wert und Kapital in einer ganzen Provinz?"	ch23_clean.en-ch23_clean.de
Both belong to the capitalist, but one stands in his factory, while the other is housed in cottages outside the factory at night-time and on Sundays.	Potter, das auserwählte Organ der Baumwollfabrikanten, unterscheidet doppelte "Maschinerie", deren jede dem Kapitalisten gehört und wovon die eine in seiner Fabrik steht, die andre des Nachts und Sonntags auswärtig in cottages haust.	ch23_clean.en-ch23_clean.de
The one is inanimate, the other living.	Die eine ist tot, die andre lebendig.	ch23_clean.en-ch23_clean.de
The inanimate machinery not only wears out and loses value from day to day, but also much of it becomes out of date so quickly, owing to constant technical progress, that it can be replaced with advantage by new machinery after a few months.	Die tote Maschinerie verschlechtert und entwertet sich nicht nur jeden Tag, sondern von ihrer existierenden Masse veraltet ein großer Teil durch den steten technischen Fortschritt beständig so sehr, daß sie vorteilhaft und in wenigen Monaten durch neuere Maschinerie ersetzbar.	ch23_clean.en-ch23_clean.de
With the living machinery the reverse is true: it gets better the longer it lasts, and in proportion as the skill handed down from one generation to another accumulates.	Die lebendige Maschinerie verbessert sich umgekehrt, je länger sie währt, je mehr sie das Geschick von Generationen in sich aufhäuft.	ch23_clean.en-ch23_clean.de
Here is the answer given by The Times to the cotton magnate: ‘Mr Edmund Potter is so impressed with the exceptional and supreme importance of the cotton masters that, in order to preserve this class and perpetuate their profession, he would keep half a million of the labouring class confined in a great moral workhouse against their will.	Die "Times" antwortete dem Fabrikmagnaten u.a.: "Herr E. Potter ist so impressioniert von der außerordentlichen und absoluten Wichtigkeit der Baumwollmeister, daß er, um diese Klasse zu erhalten und ihr Metier zu verewigen, eine halbe Million der Arbeiterklasse wider ihren Willen in ein großes moralisches Workhouse einsperren will.	ch23_clean.en-ch23_clean.de
“Is the trade worth retaining?” asks Mr Potter.	Ist diese Industrie wert, sie festzuhalten? fragt Herr Potter.	ch23_clean.en-ch23_clean.de
“Certainly by all honest means it is,” we answer.	Sicher, durch alle ehrbaren Mittel, antworten wir.	ch23_clean.en-ch23_clean.de
“Is it worth while keeping the machinery in order?” again asks Mr Potter.	Ist es der Mühe wert, die Maschinerie in Ordnung zu halten? fragt wieder Herr Potter.	ch23_clean.en-ch23_clean.de
Here we hesitate.	Hier stutzen wir.	ch23_clean.en-ch23_clean.de
By the “machinery”, Mr Potter means the human machinery, for he goes on to protest that he does not mean to use them as an absolute property.	Unter der Maschinerie versteht Herr Potter die menschliche Maschinerie, denn er beteuert, daß er sie nicht als absolutes Eigentum zu behandeln vorhat.	ch23_clean.en-ch23_clean.de
We must confess that we do not think it “worth while”, or even possible, to keep the human machinery in order – that is to shut it up and keep it oiled till it is wanted.	Wir müssen gestehn, wir halten es nicht 'der Mühe wert' oder selbst für möglich, die menschliche Maschinerie in Ordnung zu halten, d.h. sie einzusperren und einzuölen, bis man ihrer bedarf.	ch23_clean.en-ch23_clean.de
Human machinery will rust under inaction, oil and rub it as you may.	Menschliche Maschinerie hat die Eigenschaft, während der Untätigkeit zu verrosten, ihr mögt noch soviel dran ölen oder reiben.	ch23_clean.en-ch23_clean.de
Moreover, the human machinery will, as we have just seen, get the steam up of its own accord, and burst or run amuck in our great towns.	Zudem ist menschliche Maschinerie, wie der Augenschein uns eben lehrt, imstand, von eignen Stücken den Dampf anzulassen und zu platzen oder einen Veitstanz in unsren großen Städten zu tollen.	ch23_clean.en-ch23_clean.de
It might, as Mr Potter says, require some time to reproduce the workers, but, having machinists and capitalists at hand, we could always find thrifty, hard, industrious men wherewith to improvise more master-manufacturers than we can ever want.	Es mag, wie Herr Potter sagt, längere Zeit zur Reproduktion der Arbeiter erheischt sein, aber mit Maschinisten und Geld zur Hand werden wir stets betriebsame, harte, industrielle Männer finden, um daraus mehr Fabrikmeister zu fabrizieren, als wir je verbrauchen können ...	ch23_clean.en-ch23_clean.de
Mr Potter talks of the trade reviving “in one, two, or three years”, and he asks us not “to encourage or allow (!) the working power to emigrate”.	Herr Potter plaudert von einer Wiederbelebung der Industrie in 1, 2, 3 Jahren und verlangt von uns, die Emigration der Arbeitskraft nicht zu ermuntern oder nicht zu erlauben!	ch23_clean.en-ch23_clean.de
He says that it is very natural the workers should wish to emigrate; but he thinks that in spite of their desire, the nation ought to keep this half million of workers with their 700, dependants, shut up in the cotton districts; and as a necessary consequence, he must of course think that the nation ought to keep down their discontent by force, and sustain them by alms – and upon the chance that the cotton masters may some day want them… The time is come when the great public opinion of these islands must operate to save this “working power” from those who would deal with it as they would deal with iron, and coal, and cotton.’	Er sagt, es sei natürlich, daß die Arbeiter zu emigrieren wünschen, aber er meint, daß die Nation diese halbe Million Arbeiter mit den 700.000, die an ihnen hängen, ihrem Verlangen zum Trotz in die Baumwolldistrikte einsperren und, eine notwendige Konsequenz, ihr Mißvergnügen durch Gewalt niederschlagen und sie selbst durch Almosen fristen muß, alles das auf die Chance hin, daß die Baumwollmeister ihrer an einem beliebigen Tag wieder bedürfen mögen ... Die Zeit ist gekommen, wo die große öffentliche Meinung dieser Eilande etwas tun muß, um 'diese Arbeitskraft' vor denen zu retten, die sie behandeln wollen, wie sie Kohle, Eisen und Baumwolle behandeln (to save this 'working power' from those who would deal with it as they deal with iron, coal and cotton)."	ch23_clean.en-ch23_clean.de
This article was only a jeu d’esprit.	Der "Times"-Artikel war nur ein jeu d'esprit <geistreiches Gedankenspiel>.	ch23_clean.en-ch23_clean.de
The ‘great public opinion’ was in fact of Mr Potter’s own opinion, it too thought that the factory workers were movable accessories to the factories.	Die "große öffentliche Meinung" war in der Tat der Meinung des Herrn Potter, daß die Fabrikarbeiter Mobiliarzubehör der Fabriken.	ch23_clean.en-ch23_clean.de
Their emigration was prevented.	Ihre Emigration wurde verhindert.	ch23_clean.en-ch23_clean.de
They were locked up in that ‘moral workhouse’, the cotton districts, and they form, as before, ‘the strength’ of the cotton manufacturers of Lancashire.	Man sperrte sie in das "moralische Workhouse" der Baumwolldistrikte, und sie bilden nach wie vor "die Stärke (the strength) der Baumwollmeister von Lancashire".	ch23_clean.en-ch23_clean.de
Capitalist production therefore reproduces in the course of its own process the separation between labour-power and the conditions of labour.	Der kapitalistische Produktionsprozeß reproduziert also durch seinen eignen Vorgang die Scheidung zwischen Arbeitskraft und Arbeitsbedingungen.	ch23_clean.en-ch23_clean.de
It thereby reproduces and perpetuates the conditions under which the worker is exploited.	Er reproduziert und verewigt damit die Exploitationsbedingungen des Arbeiters.	ch23_clean.en-ch23_clean.de
It incessantly forces him to sell his labour-power in order to live, and enables the capitalist to purchase labour-power in order that he may enrich himself.	Er zwingt beständig den Arbeiter zum Verkauf seiner Arbeitskraft, um zu leben, und befähigt beständig den Kapitalisten zu ihrem Kauf, um sich zu bereichern.	ch23_clean.en-ch23_clean.de
It is no longer a mere accident that capitalist and worker confront each other in the market as buyer and seller.	Es ist nicht mehr der Zufall, welcher Kapitalist und Arbeiter als Käufer und Verkäufer einander auf dem Warenmarkt gegenüberstellt.	ch23_clean.en-ch23_clean.de
It is the alternating rhythm of the process itself which throws the worker back onto the market again and again as a seller of his labour-power and continually transforms his own product into a means by which another man can purchase him.	Es ist die Zwickmühle des Prozesses selbst, die den einen stets als Verkäufer seiner Arbeitskraft auf den Warenmarkt zurückschleudert und sein eignes Produkt stets in das Kaufmittel des andren verwandelt.	ch23_clean.en-ch23_clean.de
In reality, the worker belongs to capital before he has sold himself to the capitalist.	In der Tat gehört der Arbeiter dem Kapital, bevor er sich dem Kapitalisten verkauft.	ch23_clean.en-ch23_clean.de
His economic bondage is at once mediated through, and concealed by, the periodic renewal of the act by which he sells himself, his change of masters, and the oscillations in the market-price of his labour.	Seine ökonomische Hörigkeit ist zugleich vermittelt und zugleich versteckt durch die periodische Erneurung seines Selbstverkaufs, den Wechsel seiner individuellen Lohnherrn und die Oszillation im Marktpreise der Arbeit.	ch23_clean.en-ch23_clean.de
The capitalist process of production, therefore, seen as a total, connected process, i.e. a process of reproduction, produces not only commodities, not only surplus-value, but it also produces and reproduces the capital-relation itself; on the one hand the capitalist, on the other the wage-labourer.21	Der kapitalistische Produktionsprozeß, im Zusammenhang betrachtet oder als Reproduktionsprozeß, produziert also nicht nur Ware, nicht nur Mehrwert, er produziert und reproduziert das Kapitalverhältnis selbst, auf der einen Seite den Kapitalisten, auf der andren den Lohnarbeiter.	ch23_clean.en-ch23_clean.de

