Chapter 24: The Transformation of Surplus-Value into Capital 1. CAPITALIST PRODUCTION ON A PROGRESSIVELY INCREASING SCALE.	ZWEIUNDZWANZIGSTES KAPITEL Verwandlung von Mehrwert in Kapital 1. Kapitalistischer Produktionsprozeß auf erweiterter Stufenleiter.	ch24_clean.en-ch24_clean.de
THE INVERSION WHICH CONVERTS THE PROPERTY LAWS OF COMMODITY PRODUCTION INTO LAWS OF CAPITALIST APPROPRIATION Earlier we considered how surplus-value arises from capital; now we have to see how capital arises from surplus-value.	Umschlag der Eigentumsgesetze der Warenproduktion in Gesetze der kapitalistischen Aneignung Früher hatten wir zu betrachten, wie der Mehrwert aus dem Kapital, jetzt wie das Kapital aus dem Mehrwert entspringt.	ch24_clean.en-ch24_clean.de
The employment of surplus-value as capital, or its reconversion into capital, is called accumulation of capital.	Anwendung von Mehrwert als Kapital oder Rückverwandlung von Mehrwert in Kapital heißt Akkumulation des Kapitals.	ch24_clean.en-ch24_clean.de
Let us first consider this process from the standpoint of the individual capitalist.	Betrachten wir diesen Vorgang zunächst vom Standpunkt des einzelnen Kapitalisten.	ch24_clean.en-ch24_clean.de
Suppose a master-spinner has advanced a capital of £10,000, of which four-fifths (£8,000) is laid out in cotton, machinery, etc. and one-fifth (£2,000) in wages.	Ein Spinner z.B. habe ein Kapital von 10.000 Pfd.St. vorgeschossen, wovon vier Fünftel in Baumwolle, Maschinen etc., das letzte Fünftel in Arbeitslohn.	ch24_clean.en-ch24_clean.de
Let him produce 240, lb. of yarn every year, and let the value of this yarn be £12,000.	Er produziere jährlich 240.000 Pfd. Garn zum Wert von 12.000 Pfd.St..	ch24_clean.en-ch24_clean.de
The rate of surplus-value being 100 per cent, the surplus-value is contained in the surplus, or net product, of 40, lb. of yarn, which is one-sixth of the gross product, and has a value of £2, which will be realized by a sale. £2, is £2,000.	Bei einer Rate des Mehrwerts von 100% steckt der Mehrwert im Mehrprodukt oder Nettoprodukt von 40.000 Pfd. Garn, einem Sechstel des Bruttoprodukts, zum Wert von 2.000 Pfd. Sterling, den der Verkauf realisieren wird.	ch24_clean.en-ch24_clean.de
Neither seeing nor smelling will tell us that this sum of money is surplus-value.	Eine Wertsumme von 2.000 Pfd.St. ist eine Wertsumme von 2.000 Pfd.St.	ch24_clean.en-ch24_clean.de
	Man riecht und sieht diesem Gelde nicht an, daß es Mehrwert ist.	ch24_clean.en-ch24_clean.de
When we know that a given value is surplus-value, we know how its owner came by it; but that does not alter the nature either of value or of money.	Der Charakter eines Werts als Mehrwert zeigt, wie er zu seinem Eigner kam, ändert aber nichts an der Natur des Werts oder des Geldes.	ch24_clean.en-ch24_clean.de
In order to transform this newly acquired sum of £2, into capital, the master-spinner will, all circumstances remaining as before, advance four-fifths of it (£1,600) in the purchase of cotton, etc. and one-fifth (£400) in the purchase of additional spinning workers, who will find in the market the means of subsistence whose value the master has advanced to them.	Um die neu hinzugekommne Summe von 2.000 Pfd.St. in Kapital zu verwandeln, wird also der Spinner, alle andern Umstände gleichbleibend, vier Fünftel davon vorschießen im Ankauf von Baumwolle usw. und ein Fünftel im Ankauf neuer Spinnarbeiter, die auf dem Markte die Lebensmittel finden werden, deren Wert er ihnen vorgeschossen hat.	ch24_clean.en-ch24_clean.de
The new capital of £2, then functions in the spinning-mill and in its turn brings in a surplus value of £400.	Dann fungiert das neue Kapital von 2.000 Pfd.St. in der Spinnerei und bringt seinerseits einen Mehrwert von 400 Pfd. ein.	ch24_clean.en-ch24_clean.de
The capital-value was originally advanced in the form of money. The surplus-value, however, existed from the outset as the value of a definite portion of the gross product.	Der Kapitalwert war ursprünglich vorgeschossen in Geldform; der Mehrwert dagegen existiert von vornherein als Wert eines bestimmten Teils des Bruttoprodukts.	ch24_clean.en-ch24_clean.de
If this gross product is sold, converted into money, the capital-value regains its original form.	Wird dieses verkauft, in Geld verwandelt, so gewinnt der Kapitalwert seine ursprüngliche Form wieder, aber der Mehrwert verwandelt seine ursprüngliche Daseinsweise.	ch24_clean.en-ch24_clean.de
From this moment on, the capital-value and surplus-value are both sums of money, and their reconversion into capital takes place in precisely the same way.	Von diesem Augenblick an sind jedoch Kapitalwert und Mehrwert beides Geldsummen, und ihre Wiederverwandlung in Kapital vollzieht sich auf ganz dieselbe Weise.	ch24_clean.en-ch24_clean.de
The one as well as the other is laid out by the capitalist in the purchase of commodities that place him in a position to start making his goods again, and indeed, on a larger scale this time.	Die eine wie die andre legt der Kapitalist an im Ankauf der Waren, die ihn instand setzen, die Verfertigung seines Artikels von neuem zu beginnen, und zwar diesmal auf erweiterter Stufenleiter.	ch24_clean.en-ch24_clean.de
But in order to be able to buy these commodities, he must find them ready in the market.	Um aber diese Waren zu kaufen, muß er sie auf dem Markte vorfinden.	ch24_clean.en-ch24_clean.de
His own yarn circulates only because he brings his annual product to market, as do all other capitalists with their commodities.	Seine eignen Garne zirkulieren nur, weil er sein Jahresprodukt auf den Markt bringt, wie das alle andern Kapitalisten mit ihren Waren ebenfalls tun.	ch24_clean.en-ch24_clean.de
But these commodities, before coming to market, were already part of the annual production fund, i.e. part of the total mass of objects of every kind into which the sum total of the individual capitals, or the total social capital, had been converted in the course of the year, and of which each capitalist had in hand only a small fraction.	Aber ehe sie auf den Markt kamen, hatten sie sich schon befunden im jährlichen Produktionsfonds, d.h. der Gesamtmasse der Gegenstände aller Art, worin die Gesamtsumme der Einzelkapitale oder das gesellschaftliche Gesamtkapital im Laufe des Jahres sich verwandelt und wovon jeder Einzelkapitalist nur einen aliquoten Teil in Händen hat.	ch24_clean.en-ch24_clean.de
All the transactions in the market can accomplish is the interchange of the individual components of this annual product, their transfer from one hand to another. They cannot increase the total annual production, nor can they alter the nature of the objects produced.	Die Vorgänge auf dem Markt bewerkstelligen nur den Umsatz der einzelnen Bestandteile der Jahresproduktion, schicken sie von einer Hand in die andre, aber sie können weder die Gesamt-Jahresproduktion vergrößern noch die Natur der produzierten Gegenstände ändern.	ch24_clean.en-ch24_clean.de
Hence the use that can be made of the total annual product depends entirely on its own composition, and in no way on circulation.	Welcher Gebrauch also von dem jährlichen Gesamtprodukt gemacht werden kann, das hängt ab von seiner eignen Zusammensetzung, keineswegs aber von der Zirkulation.	ch24_clean.en-ch24_clean.de
Annual production must in the first place furnish all those objects (use-values) from which the material components of capital, used up in the course of the year, have to be replaced.	Zunächst muß die Jahresproduktion alle die Gegenstände (Gebrauchswerte) liefern, aus denen die im Lauf des Jahres verbrauchten sachlichen Bestandteile des Kapitals zu ersetzen sind.	ch24_clean.en-ch24_clean.de
After we have deducted this, there remains the net or surplus product, which contains the surplus-value.	Nach Abzug dieser bleibt das Netto- oder Mehrprodukt, worin der Mehrwert steckt.	ch24_clean.en-ch24_clean.de
And what does this surplus product consist of?	Und woraus besteht dies Mehrprodukt?	ch24_clean.en-ch24_clean.de
Only of things destined to satisfy the needs and desires of the capitalist class, things which consequently enter into the consumption fund of the capitalists?	Vielleicht in Dingen, bestimmt zur Befriedigung der Bedürfnisse und Gelüste der Kapitalistenklasse, die also in ihren Konsumtionsfonds eingehn?	ch24_clean.en-ch24_clean.de
If that were all, the cup of surplus-value would be drained to the very dregs, and nothing but simple reproduction would ever take place.	Wäre das alles, so würde der Mehrwert verjubelt bis auf die Hefen, und es fände bloß einfache Reproduktion statt.	ch24_clean.en-ch24_clean.de
Accumulation requires the transformation of a portion of the surplus product into capital.	Um zu akkumulieren, muß man einen Teil des Mehrprodukts in Kapital verwandeln.	ch24_clean.en-ch24_clean.de
But we cannot, except by a miracle, transform into capital anything but such articles as can be employed in the labour process (i.e. means of production), and such further articles as are suitable for the sustenance of the worker (i.e. means of subsistence).	Aber, ohne Wunder zu tun, kann man nur solche Dinge in Kapital verwandeln, die im Arbeitsprozeß verwendbar sind, d.h. Produktionsmittel, und des ferneren Dinge, von denen der Arbeiter sich erhalten kann, d.h. Lebensmittel.	ch24_clean.en-ch24_clean.de
Consequently, a part of the annual surplus labour must have been applied to the production of additional means of production and subsistence, over and above the quantity of these things required to replace the capital advanced.	Folglich muß ein Teil der jährlichen Mehrarbeit verwandt worden sein zur Herstellung zusätzlicher Produktions- und Lebensmittel, im Überschuß über das Quantum, das zum Ersatz des vorgeschossenen Kapitals erforderlich war.	ch24_clean.en-ch24_clean.de
In a word, surplus-value can be transformed into capital only because the surplus product, whose value it is, already comprises the material components of a new quantity of capital.	Mit einem Wort: der Mehrwert ist nur deshalb in Kapital verwandelbar, weil das Mehrprodukt, dessen Wert er ist, bereits die sachlichen Bestandteile eines neuen Kapitals enthält.	ch24_clean.en-ch24_clean.de
Now, in order that these components may actually function as capital, the capitalist class requires additional labour.	(21a) Um nun diese Bestandteile tatsächlich als Kapital fungieren zu lassen, bedarf die Kapitalistenklasse eines Zuschusses von Arbeit.	ch24_clean.en-ch24_clean.de
If the exploitation of the workers already employed does not increase, either extensively or intensively, additional labour-powers must be enlisted.	Soll nicht die Ausbeutung der schon beschäftigten Arbeiter extensiv oder intensiv wachsen, so müssen zusätzliche Arbeitskräfte eingestellt werden.	ch24_clean.en-ch24_clean.de
The mechanism of capitalist production has already provided for this in advance, by reproducing the working class as a class dependent on wages, a class whose ordinary wages suffice, not only to maintain itself, but also to increase its numbers.	Dafür hat der Mechanismus der kapitalistischen Produktion ebenfalls schon gesorgt, indem er die Arbeiterklasse reproduziert als vom Arbeitslohn abhängige Klasse, deren gewöhnlicher Lohn hinreicht, nicht nur ihre Erhaltung zu sichern, sondern auch ihre Vermehrung.	ch24_clean.en-ch24_clean.de
All capital needs to do is to incorporate this additional labour-power, annually supplied by the working class in the shape of labour-powers of all ages, with the additional means of production comprised in the annual product, and the transformation of surplus-value into capital has been accomplished.	Diese, ihm durch die Arbeiterklasse auf verschiednen Altersstufen jährlich gelieferten, zuschüssigen Arbeitskräfte braucht das Kapital nur noch den in der Jahresproduktion schon enthaltnen zuschüssigen Produktionsmitteln einzuverleiben, und die Verwandlung des Mehrwerts in Kapital ist fertig.	ch24_clean.en-ch24_clean.de
Looked at concretely, accumulation can be resolved into the production of capital on a progressively increasing scale.	Konkret betrachtet, löst sich die Akkumulation auf in Reproduktion des Kapitals auf progressiver Stufenleiter.	ch24_clean.en-ch24_clean.de
The cycle of simple reproduction alters its form and, to use Sismondi’s expression, changes into a spiral.	Der Kreislauf der einfachen Reproduktion verändert sich und verwandelt sich, nach Sismondis Ausdruck, in eine Spirale.	ch24_clean.en-ch24_clean.de
Let us now return to our example.	(21b) Kehren wir jetzt zu unserm Beispiel zurück.	ch24_clean.en-ch24_clean.de
It is the old story: Abraham begat Isaac, Isaac begat Jacob and so on. The original capital of £10, brings in a surplus-value of £2,000, which is capitalized.	Es ist die alte Geschichte: Abraham zeugte Isaak, Isaak zeugte Jakob usw. Das ursprüngliche Kapital von 10.000 Pfd.St. bringt einen Mehrwert von 2.000 Pfd.St., der kapitalisiert wird.	ch24_clean.en-ch24_clean.de
The new capital of £2, brings in a surplus-value of £400, and this too is capitalized, transformed into a second additional capital, which in its turn produces a further surplus-value of £80. And the process continues in this way. We leave out of account here the portion of the surplus-value consumed by the capitalist.	Das neue Kapital von 2.000 Pfd.St. bringt einen Mehrwert von 400 Pfd.St. ; dieser, wiederum kapitalisiert, also in ein zweites zusätzliches Kapital verwandelt, bringt einen neuen Mehrwert von 80 Pfd.St., usw. Wir sehen hier ab von dem vom Kapitalisten verzehrten Teil des Mehrwerts.	ch24_clean.en-ch24_clean.de
We are also not interested, for the moment, in whether the additional capital is joined on to the original capital, or separated from it so that it can valorize itself independently. Nor are we concerned whether the same capitalist employs it who originally accumulated it, or whether he hands it over to others.	Ebensowenig interessiert es uns für den Augenblick, ob die Zusatzkapitale zum ursprünglichen Kapital geschlagen oder von ihm zu selbständiger Verwertung getrennt werden; ob derselbe Kapitalist sie ausnutzt, der sie akkumuliert hat, oder ob er sie andern überträgt.	ch24_clean.en-ch24_clean.de
All we must remember is this: by the side of the newly formed capital, the original capital continues to reproduce itself and to produce surplus-value, and this is true of all accumulated capital in relation to the additional capital engendered by it.	Nur dürfen wir nicht vergessen, daß neben den neugebildeten Kapitalen das ursprüngliche Kapital fortfährt sich zu reproduzieren und Mehrwert zu produzieren, und daß dasselbe gilt von jedem akkumulierten Kapital in Beziehung auf das von ihm erzeugte Zusatzkapital.	ch24_clean.en-ch24_clean.de
The original capital was formed by the advance of £10,000.	Das ursprüngliche Kapital bildete sich durch den Vorschuß von 10.000 Pfd.St.	ch24_clean.en-ch24_clean.de
Where did its owner get it from?	Woher hat sie ihr Besitzer?	ch24_clean.en-ch24_clean.de
‘From his own labour and that of his forefathers’, is the unanimous answer of the spokesmen of political economy. And, in fact, their assumption appears to be the only one consonant with the laws of commodity production.	Durch seine eigne Arbeit und die seiner Vorfahren! antworten uns einstimmig die Wortführer der politischen Ökonomie (21c), und ihre Annahme scheint in der Tat die einzige, die zu den Gesetzen der Warenproduktion stimmt.	ch24_clean.en-ch24_clean.de
But it is quite otherwise with regard to the additional capital of £2,000.	Ganz anders verhält es sich mit dem Zusatzkapital von 2.000 Pfd.St.	ch24_clean.en-ch24_clean.de
We know perfectly well how that originated.	Seinen Entstehungsprozeß kennen wir ganz genau.	ch24_clean.en-ch24_clean.de
	Es ist kapitalisierter Mehrwert.	ch24_clean.en-ch24_clean.de
There is not one single atom of its value that does not owe its existence to unpaid labour.	Von Ursprung an enthält er nicht ein einziges Wertatom, das nicht aus unbezahlter fremder Arbeit herstammt.	ch24_clean.en-ch24_clean.de
The means of production with which the additional labour-power is incorporated, as well as the necessaries with which the workers are sustained, are nothing but component parts of the surplus product, parts of the tribute annually exacted from the working class by the capitalist class.	Die Produktionsmittel, denen die zuschüssige Arbeitskraft einverleibt wird, wie die Lebensmittel, von denen diese sich erhält, sind nichts als integrierende Bestandteile des Mehrprodukts, des der Arbeiterklasse jährlich durch die Kapitalistenklasse entrissenen Tributs.	ch24_clean.en-ch24_clean.de
Even if the latter uses a portion of that tribute to purchase the additional labour-power at its full price, so that equivalent is exchanged for equivalent, the whole thing still remains the age-old activity of the conqueror, who buys commodities from the conquered with the money he has stolen from them.	Wenn diese mit einem Teil des Tributs von jener zusätzliche Arbeitskraft kauft, selbst zum vollen Preise, so daß Äquivalent sich austauscht gegen Äquivalent - es bleibt immer das alte Verfahren des Eroberers, der den Besiegten Waren abkauft mit ihrem eignen, geraubten Geld.	ch24_clean.en-ch24_clean.de
If the additional capital employs the person who produced it, this producer must not only continue to valorize the value of the original capital, but must buy back the fruits of his previous labour with more labour than they cost.	Wenn das Zusatzkapital seinen eignen Produzenten beschäftigt, so muß dieser erstens fortfahren, das ursprüngliche Kapital zu verwerten, und zudem den Ertrag seiner früheren Arbeit zurückkaufen mit mehr Arbeit, als er gekostet hat.	ch24_clean.en-ch24_clean.de
If we view this as a transaction between the capitalist class and the working class, it makes no difference that additional workers are employed by means of the unpaid labour of the previously employed workers.	Als Transaktion zwischen der Kapitalistenklasse und der Arbeiterklasse betrachtet, ändert es nichts an der Sache, wenn mit der unbezahlten Arbeit der bisher beschäftigten Arbeiter zuschüssige Arbeiter beschäftigt werden.	ch24_clean.en-ch24_clean.de
The capitalist may even convert the additional capital into a machine that throws the producers of that capital out of work, and replaces them with a few children.	Der Kapitalist verwandelt vielleicht auch das Zusatzkapital in eine Maschine, die den Produzenten des Zusatzkapitals aufs Pflaster wirft und durch ein paar Kinder ersetzt.	ch24_clean.en-ch24_clean.de
In every case, the working class creates by the surplus labour of one year the capital destined to employ additional labour in the following year.	In allen Fällen hat die Arbeiterklasse durch ihre diesjährige Mehrarbeit das Kapital geschaffen, das im nächsten Jahr zuschüssige Arbeit beschäftigen wird.	ch24_clean.en-ch24_clean.de
And this is what is called creating capital out of capital.	Das ist es, was man nennt: Kapital durch Kapital erzeugen.	ch24_clean.en-ch24_clean.de
The accumulation of the first additional capital of £2, presupposes that a value of £10, exists, advanced by the capitalist, and belonging to him by virtue of his ‘original labour’.	Die Voraussetzung der Akkumulation des ersten Zusatzkapitals von 2.000 Pfd.St. war eine vom Kapitalisten vorgeschoßne, ihm kraft seiner "ursprünglichen Arbeit" gehörige Wertsumme von 10.000 Pfd.St.	ch24_clean.en-ch24_clean.de
The second additional capital of £ presupposes, on the contrary, only the prior accumulation of the £2,000, of which the £ is the capitalized surplus-value.	Die Voraussetzung des zweiten Zusatzkapitals von 400 Pfd.St. dagegen ist nichts andres als die vorhergegangne Akkumulation des ersten, der 2.000 Pfd.St., dessen kapitalisierter Mehrwert es ist.	ch24_clean.en-ch24_clean.de
The ownership of past unpaid labour is thenceforth the sole condition for the appropriation of living unpaid labour on a constantly increasing scale.	Eigentum an vergangner unbezahlter Arbeit erscheint jetzt als die einzige Bedingung für gegenwärtige Aneignung lebendiger unbezahlter Arbeit in stets wachsendem Umfang.	ch24_clean.en-ch24_clean.de
The more the capitalist has accumulated, the more is he able to accumulate.	Je mehr der Kapitalist akkumuliert hat, desto mehr kann er akkumulieren.	ch24_clean.en-ch24_clean.de
The surplus-value that makes up additional capital no. is the result of the purchase of labour-power with part of the original capital, a purchase which conformed to the laws of commodity exchange and which, from a legal standpoint, presupposes nothing beyond the worker’s power to dispose freely of his own capacities, and the money-owner’s or commodity-owner’s power to dispose freely of the values that belong to him; equally, additional capital no. is merely the result of additional capital no. 1, and is therefore a consequence of the relations described above; hence each individual transaction continues to conform to the laws of commodity exchange, with the capitalist always buying labour-power and the worker always selling it at what we shall assume is its real value. It is quite evident from this that the laws of appropriation or of private property, laws based on the production and circulation of commodities, become changed into their direct opposite through their own internal and inexorable dialectic.	Insofern der Mehrwert, woraus Zusatzkapital Nr. I besteht, das Resultat des Ankaufs der Arbeitskraft durch einen Teil des Originalkapitals war, ein Kauf, der den Gesetzen des Warenaustausches entsprach, und, juristisch betrachtet, nichts voraussetzt als freie Verfügung auf seiten des Arbeiters über seine eignen Fähigkeiten, auf seiten des Geld- oder Warenbesitzers über ihm gehörige Werte; sofern Zusatzkapital Nr. II usw. bloß Resultat von Zusatzkapital Nr. I, also Konsequenz jenes ersten Verhältnisses; sofern jede einzelne Transaktion fortwährend dem Gesetz des Warenaustausches entspricht, der Kapitalist stets die Arbeitskraft kauft, der Arbeiter sie stets verkauft, und wir wollen annehmen selbst zu ihrem wirklichen Wert, schlägt offenbar das auf Warenproduktion und Warenzirkulation beruhende Gesetz der Aneignung oder Gesetz des Privateigentums durch seine eigne, innere, unvermeidliche Dialektik in sein direktes Gegenteil um.	ch24_clean.en-ch24_clean.de
The exchange of equivalents, the original operation with which we started, is now turned round in such a way that there is only an apparent exchange, since, firstly, the capital which is exchanged for labour-power is itself merely a portion of the product of the labour of others which has been appropriated without an equivalent; and, secondly, this capital must not only be replaced by its producer, the worker, but replaced together with an added surplus.	Der Austausch von Äquivalenten, der als die ursprüngliche Operation erschien, hat sich so gedreht, daß nur zum Schein ausgetauscht wird, indem erstens der gegen Arbeitskraft ausgetauschte Kapitalteil selbst nur ein Teil des ohne Äquivalent angeeigneten fremden Arbeitsproduktes ist und zweitens von seinem Produzenten, dem Arbeiter, nicht nur ersetzt, sondern mit neuem Surplus ersetzt werden muß.	ch24_clean.en-ch24_clean.de
The relation of exchange between capitalist and worker becomes a mere semblance belonging only to the process of circulation, it becomes a mere form, which is alien to the content of the transaction itself, and merely mystifies it.	Das Verhältnis des Austausches zwischen Kapitalist und Arbeiter wird also nur ein dem Zirkulationsprozeß angehöriger Schein, bloße Form, die dem Inhalt selbst fremd ist und ihn nur mystifiziert.	ch24_clean.en-ch24_clean.de
The constant sale and purchase of labour-power is the form; the content is the constant appropriation by the capitalist, without equivalent, of a portion of the labour of others which has already been objectified, and his repeated exchange of this labour for a greater quantity of the living labour of others.	Der beständige Kauf und Verkauf der Arbeitskraft ist die Form. Der Inhalt ist, daß der Kapitalist einen Teil der bereits vergegenständlichten fremden Arbeit, die er sich unaufhörlich ohne Äquivalent aneignet, stets wieder gegen größeres Quantum lebendiger fremder Arbeit umsetzt.	ch24_clean.en-ch24_clean.de
Originally the rights of property seemed to us to be grounded in a man’s own labour.	Ursprünglich erschien uns das Eigentumsrecht gegründet auf eigne Arbeit.	ch24_clean.en-ch24_clean.de
Some such assumption was at least necessary, since only commodity-owners with equal rights confronted each other, and the sole means of appropriating the commodities of others was the alienation of a man’s own commodities, commodities which, however, could only be produced by labour.	Wenigstens mußte diese Annahme gelten, da sich nur gleichberechtigte Warenbesitzer gegenüberstehn, das Mittel zur Aneignung fremder Ware aber nur die Veräußerung der eignen Ware, und letztere nur durch Arbeit herstellbar ist.	ch24_clean.en-ch24_clean.de
Now, however, property turns out to be the right, on the part of the capitalist, to appropriate the unpaid labour of others or its product, and the impossibility, on the part of the worker, of appropriating his own product.	Eigentum erscheint jetzt auf Seite des Kapitalisten als das Recht, fremde unbezahlte Arbeit oder ihr Produkt, auf Seite des Arbeiters als Unmöglichkeit, sich sein eignes Produkt anzueignen.	ch24_clean.en-ch24_clean.de
The separation of property from labour thus becomes the necessary consequence of a law that apparently originated in their identity.	Die Scheidung zwischen Eigentum und Arbeit wird zur notwendigen Konsequenz eines Gesetzes, das scheinbar von ihrer Identität ausging.	ch24_clean.en-ch24_clean.de
Therefore,* however much the capitalist mode of appropriation may seem to fly in the face of the original laws of commodity production, it nevertheless arises, not from a violation of these laws but, on the contrary, from their application.	Sosehr die kapitalistische Aneignungsweise also den ursprünglichen Gesetzen der Warenproduktion ins Gesicht zu schlagen scheint, so entspringt sie doch keineswegs aus der Verletzung, sondern im Gegenteil aus der Anwendung dieser Gesetze.	ch24_clean.en-ch24_clean.de
Let us make this clear once more by briefly reviewing the consecutive phases of motion whose culminating point is capitalist accumulation.	Ein kurzer Rückblick auf die Reihenfolge der Bewegungsphasen, deren Schlußpunkt die kapitalistische Akkumulation ist, stelle dies nochmals klar.	ch24_clean.en-ch24_clean.de
We saw, in the first place, that the original transformation of a sum of values into capital was achieved in complete accordance with the laws of exchange.	Zuerst haben wir gesehn, daß die ursprüngliche Verwandlung einer Wertsumme in Kapital sich durchaus gemäß den Gesetzen des Austausches vollzog.	ch24_clean.en-ch24_clean.de
One party to the contract sells his labour-power, the other buys it.	Der eine Kontrahent verkauft seine Arbeitskraft, der andre kauft sie.	ch24_clean.en-ch24_clean.de
The former receives the value of his commodity, whose use-value – labour – is thereby alienated to the buyer.	Der erstre empfängt den Wert seiner Ware, deren Gebrauchswert - die Arbeit - damit an den zweiten veräußert ist.	ch24_clean.en-ch24_clean.de
Means of production which already belong to the latter are then transformed by him, with the aid of labour equally belonging to him, into a new product which is likewise lawfully his.	Dieser verwandelt nunmehr ihm bereits gehörende Produktionsmittel mit Hilfe von ihm ebenfalls gehörender Arbeit in ein neues Produkt, das ihm ebenfalls von Rechts wegen gehört.	ch24_clean.en-ch24_clean.de
The value of this product includes: first, the value of the means of production which have been used up.	Der Wert dieses Produkts schließt ein: erstens den Wert der verbrauchten Produktionsmittel.	ch24_clean.en-ch24_clean.de
Useful labour cannot consume these means of production without transferring their value to the new product; but, to be saleable, labour-power must be capable of supplying useful labour in the branch of industry in which it is to be employed.	Die nützliche Arbeit kann diese Produktionsmittel nicht verbrauchen, ohne ihren Wert auf das neue Produkt zu übertragen; um aber verkäuflich zu sein, muß die Arbeitskraft imstande sein, in dem Industriezweig, wo sie verwandt werden soll, nützliche Arbeit zu liefern.	ch24_clean.en-ch24_clean.de
The value of the new product includes, further, the equivalent of the value of the labour-power together with a surplus-value.	Der Wert des neuen Produkts schließt ferner ein: das Äquivalent des Werts der Arbeitskraft und einen Mehrwert.	ch24_clean.en-ch24_clean.de
This is so because the value of the labour-power – sold for a definite length of time, say a day, a week, etc. – is less than the value created by its use during that time.	Und zwar deshalb, weil die für einen bestimmten Zeitraum, Tag, Woche etc., verkaufte Arbeitskraft weniger Wert besitzt, als ihr Gebrauch während dieser Zeit schafft.	ch24_clean.en-ch24_clean.de
But the worker has received payment for the exchange-value of his labour-power and by so doing has alienated its use-value – this being the case in every sale and purchase.	Der Arbeiter aber hat den Tauschwert seiner Arbeitskraft bezahlt erhalten und hat damit ihren Gebrauchswert veräußert - wie das bei jedem Kauf und Verkauf der Fall.	ch24_clean.en-ch24_clean.de
The fact that this particular commodity, labour-power, possesses the peculiar use-value of supplying labour, and therefore of creating value, cannot affect the general law of commodity production.	Daß diese besondre Ware Arbeitskraft den eigentümlichen Gebrauchswert hat, Arbeit zu liefern, also Wert zu schaffen, das kann das allgemeine Gesetz der Warenproduktion nicht berühren.	ch24_clean.en-ch24_clean.de
If, therefore, the amount of value advanced in wages is not merely found again in the product, but augmented by a surplus-value, this is not because the seller has been defrauded, for he has really received the value of his commodity; it is due solely to the fact that this commodity has been used up by the buyer.	Wenn also die in Arbeitslohn vorgeschoßne Wertsumme sich in Produkt nicht bloß einfach wieder vorfindet, sondern um einen Mehrwert vermehrt vorfindet, so rührt dies nicht her aus einer Übervorteilung des Verkäufers, der ja den Wert seiner Ware erhalten, sondern nur aus dem Verbrauch dieser Ware durch den Käufer.	ch24_clean.en-ch24_clean.de
The law of exchange requires equality only between the exchange-values of the commodities given in exchange for one another.	Das Gesetz des Austausches bedingt Gleichheit nur für die Tauschwerte der gegeneinander weggegebenen Waren.	ch24_clean.en-ch24_clean.de
From the very outset, indeed, it presupposes a difference between their use-values and it has nothing whatever to do with their consumption, which begins only after the contract has been concluded and executed.	Es bedingt sogar von vornherein Verschiedenheit ihrer Gebrauchswerte und hat absolut nichts zu schaffen mit ihrem Verbrauch, der erst nach geschloßnem und vollzognem Handel beginnt.	ch24_clean.en-ch24_clean.de
Thus the original transformation of money into capital takes place in the most exact accordance with the economic laws of commodity production and with the rights of property derived from them.	Die ursprüngliche Verwandlung des Geldes in Kapital vollzieht sich also im genauesten Einklang mit den ökonomischen Gesetzen der Warenproduktion und mit dem daraus sich ableitenden Eigentumsrecht.	ch24_clean.en-ch24_clean.de
Nevertheless, its result is: (1) that the product belongs to the capitalist and not to the worker; (2) that the value of this product includes, apart from the value of the capital advanced, a surplus-value which costs the worker labour but the capitalist nothing, and which none the less becomes the legitimate property of the capitalist; (3) that the worker has retained his labour-power and can sell it anew if he finds another buyer.	Trotzdem aber hat sie zum Ergebnis: 1. daß das Produkt dem Kapitalisten gehört und nicht dem Arbeiter; 2. daß der Wert dieses Produkts, außer dem Wert des vorgeschoßnen Kapitals, einen Mehrwert einschließt, der dem Arbeiter Arbeit, dem Kapitalisten aber nichts gekostet hat und der dennoch das rechtmäßige Eigentum des Kapitalisten wird; 3. daß der Arbeiter seine Arbeitskraft forterhalten hat und sie aufs neue verkaufen kann, wenn er einen Käufer findet.	ch24_clean.en-ch24_clean.de
Simple reproduction is only the periodic repetition of this first operation; each time, money is freshly transformed into capital.	Die einfache Reproduktion ist nur die periodische Wiederholung dieser ersten Operation; jedesmal wird, stets von neuem, Geld in Kapital verwandelt.	ch24_clean.en-ch24_clean.de
Thus the law is not broken; on the contrary, it gains the opportunity to operate continuously.	Das Gesetz wird also nicht gebrochen, im Gegenteil es erhält nur Gelegenheit, sich dauernd zu betätigen.	ch24_clean.en-ch24_clean.de
‘Several successive acts of exchange have only made the last represent the first.’	"Plusieurs échanges successifs n'ont fait du dernier que le représentant du premier." <"Mehrere aufeinander folgende Tauschakte machen aus dem letzten nur den Repräsentanten des ersten. "> (Sismondi, l.c.p. 70.)	ch24_clean.en-ch24_clean.de
And yet we have seen that simple reproduction suffices to stamp this first operation, in so far as it is conceived as an isolated process, with a totally changed character.	Und dennoch haben wir gesehn, daß die einfache Reproduktion hinreicht, um dieser ersten Operation - soweit sie als isolierter Vorgang gefaßt war - einen total veränderten Charakter aufzuprägen.	ch24_clean.en-ch24_clean.de
‘Of those who share the national income among themselves, the one side’ (the workers) ‘acquire each year a fresh right to their share by fresh labour; the others’ (the capitalists) ‘have already acquired, by their original labour, a permanent right to their share.’	"Parmi ceux qui se partagent le revenu national, les uns" (die Arbeiter) "y acquièrent chaque année un nouveau droit par un nouveau travail, les autres" (die Kapitalisten) "y ont acquis antérieurement un droit permanent par un travail primitif." <"Von denen, die sich in das nationale Einkommen teilen, erwerben die einen" (die Arbeiter) "jedes Jahr durch neue Arbeit ein neues Recht darauf, die andren" (die Kapitalisten) "haben bereits vorher durch eine ursprüngliche Arbeit ein dauerndes Recht darauf erworben. "> (Sismondi, l.c.p.	ch24_clean.en-ch24_clean.de
It is indeed a well-known fact that the sphere of labour is not the only one in which primogeniture works miracles.	110, 111.) Das Gebiet der Arbeit ist bekanntlich nicht das einzige, wo die Erstgeburt Wunder tut.	ch24_clean.en-ch24_clean.de
Nor does it matter if simple reproduction is replaced by reproduction on an extended scale, by accumulation.	Es verschlägt auch nichts, wenn die einfache Reproduktion ersetzt wird durch die Reproduktion auf erweiterter Stufenleiter, durch die Akkumulation.	ch24_clean.en-ch24_clean.de
In the former case the capitalist squanders the whole of the surplus-value in dissipation, in the latter he demonstrates his bourgeois virtue by consuming only a portion of it and converting the rest into money.	Bei jener vermöbelt der Kapitalist den gesamten Mehrwert, bei dieser beweist er seine Bürgertugend durch Verzehrung nur eines Teils, und Verwandlung des Restes in Geld.	ch24_clean.en-ch24_clean.de
The surplus-value is his property; it has never belonged to anyone else.	Der Mehrwert ist sein Eigentum, er hat nie einem andern gehört.	ch24_clean.en-ch24_clean.de
If he advances it for the purposes of production, the advances made come from his own funds, exactly as on the day when he first entered the market.	Schießt er ihn zur Produktion vor, so macht er, ganz wie am Tag, wo er zuerst den Markt beschritt, Vorschüsse aus seinem eignen Fonds.	ch24_clean.en-ch24_clean.de
The fact that on this occasion the funds are derived from the unpaid labour of his workers makes absolutely no difference.	Daß dieser Fonds diesmal aus der unbezahlten Arbeit seiner Arbeiter stammt, tut absolut nichts zur Sache.	ch24_clean.en-ch24_clean.de
If worker B is paid out of the surplus-value which worker A produced, then, in the first place, A furnished that surplus-value without having the fair price of his commodity cut by even a farthing, and, in the second place, the transaction is no concern of B’s whatever.	Wird Arbeiter B beschäftigt mit dem Mehrwert, den Arbeiter A produziert hat, so hat erstens A diesen Mehrwert geliefert, ohne daß man ihm den gerechten Preis seiner Ware um einen Heller verkürzt hat, und zweitens geht dies Geschäft den B überhaupt nichts an.	ch24_clean.en-ch24_clean.de
What B claims, and has a right to claim, is that the capitalist should pay him the value of his labour-power.	Was B verlangt und das Recht hat zu verlangen, ist, daß der Kapitalist ihm den Wert seiner Arbeitskraft zahle.	ch24_clean.en-ch24_clean.de
‘Both of them still benefited: the worker because he was advanced the fruits of his labour’ (should read: of the unpaid labour of other workers) ‘before the work was done ‘(should read: before his own labour had borne fruit);’ the employer, because the labour of this worker was worth more than his wages’ (should read: produced more value than the value of his wages).	"Tous deux gagnaient encore; l'ouvrier parce qu'on lui avançait les fruits de son travail" (soll heißen du travail gratuit d'autres ouvriers) "avant qu'il fût fait;" (soll heißen: avant que le sien ait porté de fruit) "le maître, parce que le travail de cet ouvrier valait plus que le salaire" (soll heißen: produisait plus de valeur que celle de son salaire). <"Alle beide gewannen noch; der Arbeiter, weil man ihm die Früchte seiner Arbeit vorgeschossen" (soll heißen: unbezahlter Arbeit andrer Arbeiter), "bevor sie getan war;" (soll heißen: bevor seine eigne Früchte getragen) "der Unternehmer, weil die Arbeit dieses Arbeiters mehr wert war als sein Lohn" (soll heißen: mehr Wert erzeugte als den seines Lohns).> (Sismondi, l.c.p. 135.)	ch24_clean.en-ch24_clean.de
To be sure, the matter looks quite different if we consider capitalist production in the uninterrupted flow of its renewal, and if, in place of the individual capitalist and the individual worker, we view them in their totality, as the capitalist class and the working class confronting each other.	Allerdings sieht die Sache ganz anders aus, wenn wir die kapitalistische Produktion im ununterbrochnen Fluß ihrer Erneuerung betrachten und statt des einzelnen Kapitalisten und des einzelnen Arbeiters die Gesamtheit, die Kapitalistenklasse und ihr gegenüber die Arbeiterklasse ins Auge fassen.	ch24_clean.en-ch24_clean.de
But in so doing we should be applying standards entirely foreign to commodity production.	Damit aber würden wir einen Maßstab anlegen, der der Warenproduktion total fremd ist.	ch24_clean.en-ch24_clean.de
Only the mutually independent buyer and seller face each other in commodity production.	In der Warenproduktion stehn sich nur, voneinander unabhängig, Verkäufer und Käufer gegenüber.	ch24_clean.en-ch24_clean.de
Relations between them cease on the day when the term stipulated in the contract they concluded expires.	Ihre gegenseitigen Beziehungen sind zu Ende mit dem Verfalltag des zwischen ihnen abgeschloßnen Vertrags.	ch24_clean.en-ch24_clean.de
If the transaction is repeated, it is repeated as the result of a new agreement which has nothing to do with the previous one and in which it is only an accident that brings the same seller together again with the same buyer.	Wiederholt sich das Geschäft, dann <4. Auflage: denn> infolge eines neuen Vertrags, der mit dem vorhergehenden nichts zu tun hat und bei dem nur ein Zufall denselben Käufer mit demselben Verkäufer wieder zusammenbringt.	ch24_clean.en-ch24_clean.de
If, therefore, commodity production, or one of its associated processes, is to be judged according to its own economic laws, we must consider each act of exchange by itself, apart from any connection with the act of exchange preceding it and that following it.	Soll also die Warenproduktion oder ein ihr angehöriger Vorgang nach ihren eignen ökonomischen Gesetzen beurteilt werden, so müssen wir jeden Austauschakt für sich betrachten, außerhalb alles Zusammenhangs mit dem Austauschakt, der ihm vorherging, wie mit dem, der ihm nachfolgt.	ch24_clean.en-ch24_clean.de
And since sales and purchases are negotiated solely between particular individuals, it is not admissible to look here for relations between whole social classes.	Und da Käufe und Verkäufe nur zwischen einzelnen Individuen abgeschlossen werden, so ist es unzulässig, Beziehungen zwischen ganzen Gesellschaftsklassen darin zu suchen.	ch24_clean.en-ch24_clean.de
However long a series of periodic reproductions and preceding accumulations the capital functioning today may have passed through, it always preserves its original virginity.	Wie lang auch die Reihenfolge der periodischen Reproduktionen und vorhergegangnen Akkumulationen, die das heute funktionierende Kapital durchgemacht hat, es bewahrt immer seine ursprüngliche Jungfräulichkeit.	ch24_clean.en-ch24_clean.de
As long as the laws of exchange are observed in every single act of exchange – taken in isolation – the mode of appropriation can be completely revolutionized without in any way affecting the property rights which correspond to commodity production.	Solange bei jedem Austauschakt - einzeln genommen - die Gesetze des Austausches eingehalten werden, kann die Aneignungsweise eine totale Umwälzung erfahren, ohne das, der Warenproduktion gemäße, Eigentumsrecht irgendwie zu berühren.	ch24_clean.en-ch24_clean.de
The same rights remain in force both at the outset, when the product belongs to its producer, who, exchanging equivalent for equivalent, can enrich himself only by his own labour, and in the period of capitalism, when social wealth becomes to an ever-increasing degree the property of those who are in a position to appropriate the unpaid labour of others over and over again.	Dieses selbe Recht steht in Kraft wie am Anfang, wo das Produkt dem Produzenten gehört und wo dieser, Äquivalent gegen Äquivalent austauschend, sich nur durch eigne Arbeit bereichern kann, so auch in der kapitalistischen Periode, wo der gesellschaftliche Reichtum in stets steigendem Maß das Eigentum derer wird, die in der Lage sind, sich stets aufs neue die unbezahlte Arbeit andrer anzueignen.	ch24_clean.en-ch24_clean.de
This result becomes inevitable from the moment there is a free sale, by the worker himself, of labour-power as a commodity.	Dies Resultat wird unvermeidlich, sobald die Arbeitskraft durch den Arbeiter selbst als Ware frei verkauft wird.	ch24_clean.en-ch24_clean.de
But it is also only from then onwards that commodity production is generalized and becomes the typical form of production; it is only from then onwards that every product is produced for sale from the outset and all wealth produced goes through the sphere of circulation.	Aber auch erst von da an verallgemeinert sich die Warenproduktion und wird sie typische Produktionsform; erst von da an wird jedes Produkt von vornherein für den Verkauf produziert und geht aller produzierte Reichtum durch die Zirkulation hindurch.	ch24_clean.en-ch24_clean.de
Only where wage-labour is its basis does commodity production impose itself upon society as a whole; but it is also true that only there does it unfold all its hidden potentialities.	Erst da, wo die Lohnarbeit ihre Basis, zwingt die Warenproduktion sich der gesamten Gesellschaft auf; aber auch erst da entfaltet sie alle ihre verborgnen Potenzen.	ch24_clean.en-ch24_clean.de
To say that the intervention of wage-labour adulterates commodity production is to say that commodity production must not develop if it is to remain unadulterated.	Sagen, daß die Dazwischenkunft der Lohnarbeit die Warenproduktion fälscht, heißt sagen, daß die Warenproduktion, will sie unverfälscht bleiben, sich nicht entwickeln darf.	ch24_clean.en-ch24_clean.de
To the extent that commodity production, in accordance with its own immanent laws, undergoes a further development into capitalist production, the property laws of commodity production must undergo a dialectical inversion so that they become laws of capitalist appropriation.	Im selben Maß, wie sie nach ihren eignen immanenten Gesetzen sich zur kapitalistischen Produktion fortbildet, in demselben Maß schlagen die Eigentumsgesetze der Warenproduktion um in Gesetze der kapitalistischen Aneignung.	ch24_clean.en-ch24_clean.de
We have seen that even in the case of simple reproduction, all capital, whatever its original source, is transformed into accumulated capital, or capitalized surplus-value.	Man sah, daß selbst bei einfacher Reproduktion alles vorgeschoßne Kapital, wie immer ursprünglich erworben, sich in akkumuliertes Kapital oder kapitalisierten Mehrwert verwandelt.	ch24_clean.en-ch24_clean.de
But in the flood of production the total capital originally advanced becomes a vanishing quantity (magnitudo evanescens in the mathematical sense), in comparison with the directly accumulated capital, i.e. the surplus-value or surplus product that is reconverted into capital. This occurs whether the capital originally advanced is functioning in the hands of the man who accumulated it, or in the hands of other people.	Aber im Strom der Produktion wird überhaupt alles ursprünglich vorgeschoßne Kapital eine verschwindende Größe (magnitudo evanescens im mathematischen Sinn), verglichen mit dem direkt akkumulierten Kapital, d.h. dem in Kapital rückverwandelten Mehrwert oder Mehrprodukt, ob nun funktionierend in der Hand, die akkumuliert hat, oder in fremder Hand.	ch24_clean.en-ch24_clean.de
Hence the political economists describe capital in general as ‘accumulated wealth’ (transformed surplus-value or revenue) ‘that is employed over again in the production of surplus-value’, and the capitalist himself as ‘the owner of surplus-value’.	Die politische Ökonomie stellt das Kapital daher überhaupt dar als "akkumulierten Reichtum" (verwandelten Mehrwert oder Revenue), "der von neuem zur Produktion von Mehrwert verwandt wird" , oder auch den Kapitalisten als "Besitzer des Mehrprodukts" .	ch24_clean.en-ch24_clean.de
This same way of looking at things is merely expressed in another form in the statement that all existing capital is accumulated or capitalized interest, for interest is nothing but a fragment of surplus-value.	Dieselbe Anschauungsweise besitzt nur andre Form in dem Ausdruck, daß alles vorhandne Kapital akkumulierter oder kapitalisierter Zins sei, denn der Zins ist ein bloßes Bruchstück des Mehrwerts.	ch24_clean.en-ch24_clean.de
2. THE POLITICAL ECONOMISTS’ ERRONEOUS CONCEPTION OF REPRODUCTION ON AN INCREASING SCALE Before we attempt to give a more detailed characterization of accumulation or the reconversion of surplus-value into capital, we must clear out of the way an ambiguity concocted by the classical economists.	2. Irrige Auffassung der Reproduktion auf erweiterter Stufenleiter seitens der politischen Ökonomie Bevor wir nun auf einige nähere Bestimmungen der Akkumulation oder der Rückverwandlung von Mehrwert in Kapital eingehn, ist eine von der klassischen Ökonomie ausgeheckte Zweideutigkeit zu beseitigen.	ch24_clean.en-ch24_clean.de
The commodities the capitalist buys with a part of the surplus-value for his own consumption do not serve as means of production or means of valorization; similarly, the labour he buys for the satisfaction of his natural and social requirements does not serve as productive labour.	So wenig die Waren, die der Kapitalist mit einem Teil des Mehrwerts für seine eigne Konsumtion kauft, ihm als Produktions- und Verwertungsmittel dienen, so wenig ist die Arbeit, die er zur Befriedigung seiner natürlichen und sozialen Bedürfnisse kauft, produktive Arbeit.	ch24_clean.en-ch24_clean.de
Instead of transforming surplus-value into capital, he rather consumes or expends it as revenue when he purchases those commodities and that labour.	Statt durch den Kauf jener Waren und Arbeit den Mehrwert in Kapital zu verwandeln, verzehrt oder verausgabt er ihn umgekehrt als Revenue.	ch24_clean.en-ch24_clean.de
It was of decisive importance for the bourgeois economists, when confronted with the habitual mode of life of the old nobility, which, as Hegel rightly says, ‘consists in consuming what is available’,* and is displayed in particular in the luxury of personal retainers, to promulgate the doctrine that the accumulation of capital is the first duty of every citizen, and to preach unceasingly that accumulation is impossible if a man eats up all his revenue, instead of spending a good part of it on the acquisition of additional productive workers, who bring in more than they cost.	Gegenüber der altadligen Gesinnung, die, wie Hegel richtig sagt, "im Verzehren des Vorhandenen besteht" und namentlich auch im Luxus persönlicher Dienste sich breitmacht, war es für die bürgerliche Ökonomie entscheidend wichtig, die Akkumulation des Kapitals als erste Bürgerpflicht zu verkünden und unermüdlich zu predigen: man kann nicht akkumulieren, wenn man seine ganze Revenue aufißt, statt einen guten Teil davon zu verausgaben in Werbung zuschüssiger produktiver Arbeiter, die mehr einbringen, als sie kosten.	ch24_clean.en-ch24_clean.de
On the other hand, the economists also had to contend against the popular prejudice which confuses capitalist production with hoarding, and therefore imagines that accumulated wealth is either wealth that is rescued from destruction in its existing natural form, i.e. withdrawn from consumption, or wealth that does not enter into circulation.	Andrerseits hatte sie gegen das Volksvorurteil zu polemisieren, welches die kapitalistische Produktion mit der Schatzbildung verwechselt und daher wähnt, akkumulierter Reichtum sei Reichtum, welcher der Zerstörung in seiner vorhandnen Naturalform, also dem Verbrauch entzogen oder auch vor der Zirkulation gerettet werde.	ch24_clean.en-ch24_clean.de
The exclusion of money from circulation would constitute precisely the opposite of its valorization as capital, and the accumulation of commodities in the sense of hoarding them would be sheer foolishness.	Verschluß des Geldes gegen die Zirkulation wäre grade das Gegenteil seiner Verwertung als Kapital und Warenakkumulation im schatzbildnerischen Sinn reine Narrheit.	ch24_clean.en-ch24_clean.de
In fact the accumulation of commodities in great masses is the result either of a bottleneck in circulation or of overproduction.	(28a) Akkumulation von Waren in großen Massen ist Resultat einer Zirkulationsstockung oder der Überproduktion.	ch24_clean.en-ch24_clean.de
It is true that the popular mind is impressed, on the one hand, by the sight of the mass of goods that are stored up for gradual consumption by the rich, and on the other hand by the formation of a reserve.	Allerdings läuft in der Volksvorstellung einerseits das Bild der im Konsumtionsfonds der Reichen gehäuften, langsam sich verzehrenden Güter unter, andrerseits die Vorratbildung, ein Phänomen, das allen Produktionsweisen angehört und wobei wir einen Augenblick in der Analyse des Zirkulationsprozesses verweilen werden.	ch24_clean.en-ch24_clean.de
The latter is a phenomenon which is common to all modes of production, and we shall dwell on it for a moment when we come to analyse the process of circulation. * The classical economists are therefore quite right to maintain that the consumption of the surplus product by productive, instead of unproductive, workers is a characteristic feature of the process of accumulation.	Soweit also ist die klassische Ökonomie im Recht, wenn sie den Verzehr von Mehrprodukt durch produktive Arbeiter statt durch unproduktive als charakteristisches Moment des Akkumulationsprozesses betont.	ch24_clean.en-ch24_clean.de
But at this point the mistakes also begin.	Aber hier beginnt auch ihr Irrtum.	ch24_clean.en-ch24_clean.de
Adam Smith has made it the fashion to present accumulation as nothing more than the consumption of the surplus product by productive workers. This amounts to saying that the capitalization of surplus-value consists merely in turning surplus-value into labour-power.	A. Smith hat es zur Mode gemacht, die Akkumulation bloß als Konsumtion des Mehrprodukts durch produktive Arbeiter oder die Kapitalisierung des Mehrwerts als dessen bloßen Umsatz in Arbeitskraft darzustellen.	ch24_clean.en-ch24_clean.de
Let us listen to Ricardo on this point: ‘It must be understood that all the productions of a country are consumed; but it makes the greatest difference imaginable whether they are consumed by those who reproduce, or by those who do not reproduce another value.	Hören wir z.B. Ricardo: "Man muß verstehn, daß alle Produkte eines Landes konsumiert werden; aber es macht den größten Unterschied, den man denken kann, ob sie konsumiert werden durch solche, die einen andren Wert reproduzieren, oder durch solche, die ihn nicht reproduzieren.	ch24_clean.en-ch24_clean.de
When we say that revenue is saved, and added to capital, what we mean is, that the portion of revenue, so said to be added to capital, is consumed by productive instead of unproductive labourers.	Wenn wir sagen, daß Revenue erspart und zum Kapital geschlagen wird, so meinen wir, daß der Teil der Revenue, von dem es heißt, er sei zum Kapital geschlagen, durch produktive statt durch unproduktive Arbeiter verzehrt wird.	ch24_clean.en-ch24_clean.de
There can be no greater error than in supposing that capital is increased by non-consumption.’	Es gibt keinen größern Irrtum, als zu unterstellen, daß Kapital durch Nicht-Konsum vermehrt wird."	ch24_clean.en-ch24_clean.de
There can be no greater error than the one repeated after Adam Smith by Ricardo and all subsequent political economists, namely the view that ‘the portion of revenue so said to be added to capital, is consumed by productive labourers’.	Es gibt keinen größern Irrtum als der dem A. Smith von Ricardo und allen späteren nachgeplauderte, daß "der Teil der Revenue, von dem es heißt, er sei zum Kapital geschlagen, von produktiven Arbeitern verzehrt wird".	ch24_clean.en-ch24_clean.de
According to this, all surplus-value that is transformed into capital becomes variable capital.	Nach dieser Vorstellung würde aller Mehrwert, der in Kapital verwandelt wird, zu variablem Kapital.	ch24_clean.en-ch24_clean.de
However, in actual fact the surplus-value, like the value originally advanced, divides up into constant and variable capital, into means of production and labour-power.	Er teilt sich vielmehr, wie der ursprünglich vorgeschoßne Wert, in konstantes Kapital und variables Kapital, in Produktionsmittel und Arbeitskraft.	ch24_clean.en-ch24_clean.de
Labour-power is the form in which variable capital exists during the process of production.	Arbeitskraft ist die Form, worin das variable Kapital innerhalb des Produktionsprozesses existiert.	ch24_clean.en-ch24_clean.de
In this process the labour-power is itself consumed by the capitalist while the means of production are consumed by the labour-power in the exercise of its function, i.e. labour.	In diesem Prozeß wird sie selbst vom Kapitalisten verzehrt. Sie verzehrt durch ihre Funktion - die Arbeit - Produktionsmittel.	ch24_clean.en-ch24_clean.de
At the same time, the money paid for the purchase of the labour-power is converted into means of subsistence, which are consumed, not by ‘productive labour’, but by the ‘productive worker’.	Zugleich verwandelt sich das im Ankauf der Arbeitskraft gezahlte Geld in Lebensmittel, die nicht von der "produktiven Arbeit", sondern vom "produktiven Arbeiter" verzehrt werden.	ch24_clean.en-ch24_clean.de
Adam Smith, at the end of a quite preposterous analysis, comes to the absurd conclusion that even though each individual capital is divided into a constant and a variable part, the capital of society can be entirely resolved into variable capital, i.e. it is laid out exclusively in the payment of wages. * For instance, suppose a cloth manufacturer converts £2, into capital.	A. Smith gelangt durch eine grundverkehrte Analyse zu dem abgeschmackten Resultat daß, wenn auch jedes individuelle Kapital sich in konstanten und variablen Bestandteil teilt, das gesellschaftliche Kapital sich in nur variables Kapital auflöst oder nur in Zahlung von Arbeitslohn verausgabt wird.	ch24_clean.en-ch24_clean.de
He lays out one part of the money in buying weavers, the other in woollen yarn, machinery, etc.	Z.B. ein Tuchfabrikant verwandle 2.000 Pfd.St. in Kapital.	ch24_clean.en-ch24_clean.de
But the people from whom he buys the yarn and the machinery themselves use a part of the purchase money to pay for labour, and so on until the whole £2, is spent in the payment of wages, i.e. until the entire product represented by the £2, has been consumed by productive workers.	Er legt einen Teil des Geldes im Ankauf von Webern aus, den andern Teil in Wollengarn, Wollenmaschinerie usw. Aber die Leute, von denen er das Garn und die Maschinerie kauft, zahlen wieder mit einem Teil davon Arbeit usw., bis die ganzen 2.000 Pfd.St. in Zahlung von Arbeitslohn verausgabt sind oder das ganze durch die 2.000 Pfd.St. repräsentierte Produkt durch produktive Arbeiter verzehrt ist.	ch24_clean.en-ch24_clean.de
It is evident that the entire thrust of this argument lies in the words ‘and so on’, which send us from pillar to post.	Man sieht: die ganze Wucht dieses Arguments liegt in dem Wort "usw.", das uns von Pontius zu Pilatus schickt.	ch24_clean.en-ch24_clean.de
In fact, Adam Smith breaks off the investigation just where the difficulties begin.	In der Tat, A. Smith bricht die Untersuchung grade da ab, wo ihre Schwierigkeit beginnt.	ch24_clean.en-ch24_clean.de
The annual process of reproduction is easily understood, as long as we look solely at the sum total of the year’s production.	Solange man nur den Fonds der Gesamt-Jahresproduktion ins Auge faßt, ist der jährliche Reproduktionsprozeß leicht verständlich.	ch24_clean.en-ch24_clean.de
But every single component of this annual product must be brought into the market as a commodity, and there the difficulties begin.	Aber alle Bestandteile der Jahresproduktion müssen auf den Warenmarkt gebracht werden, und da beginnt die Schwierigkeit.	ch24_clean.en-ch24_clean.de
The movements of the individual capitals and personal revenues cross and intermingle, and become lost in a general alternation of positions, i.e. in the circulation of society’s wealth. This confuses the onlooker, and provides the investigation with very complicated problems to solve.	Die Bewegungen der Einzelkapitale und persönlichen Revenuen kreuzen, vermengen, verlieren sich in einem allgemeinen Stellenwechsel - der Zirkulation des gesellschaftlichen Reichtums - , der den Blick verwirrt und der Untersuchung sehr verwickelte Aufgaben zu lösen gibt.	ch24_clean.en-ch24_clean.de
In the third part of Volume 2 I shall give an analysis of the way the whole system is actually linked together. It is one of the great merits of the Physiocrats that in their Tableau économique† they were the first to attempt to depict the year’s production in the shape in which it emerges from circulation.	Im dritten Abschnitt des Zweiten Buches werde ich die Analyse des wirklichen Zusammenhanges geben. - Es ist das große Verdienst der Physiokraten, in ihrem Tableau economique zum ersten Mal den Versuch gemacht zu haben, ein Bild der Jahresproduktion zu geben in der Gestalt, in welcher sie aus der Zirkulation hervorgeht.	ch24_clean.en-ch24_clean.de
For the rest, it goes without saying that political economy has not failed to exploit, in the interests of the capitalist class, Adam Smith’s doctrine that the whole of that part of the net product which is transformed into capital is consumed by the working class.	Es versteht sich übrigens von selbst, daß die politische Ökonomie nicht verfehlt hat, im Interesse der Kapitalistenklasse A. Smiths Satz auszubeuten: daß der ganze in Kapital verwandelte Teil des Nettoprodukts von der Arbeiterklasse verzehrt wird.	ch24_clean.en-ch24_clean.de
3. DIVISION OF SURPLUS-VALUE INTO CAPITAL AND REVENUE.	3. Teilung des Mehrwerts in Kapital und Revenue.	ch24_clean.en-ch24_clean.de
THE ABSTINENCE THEORY In the previous chapter, we treated surplus-value (or the surplus product) solely as a fund for satisfying the capitalist’s individual consumption requirements. In this chapter, so far, we have treated it solely as a fund for accumulation.	Die Abstinenztheorie Im vorigen Kapitel betrachteten wir den Mehrwert, resp. das Mehrprodukt, nur als individuellen Konsumtionsfonds des Kapitalisten, in diesem Kapitel bisher nur als einen Akkumulationsfonds.	ch24_clean.en-ch24_clean.de
In fact, however, it is neither the one nor the other: it is both.	Er ist aber weder nur das eine noch das andre, sondern beides zugleich.	ch24_clean.en-ch24_clean.de
One part of the surplus-value is consumed by the capitalist as revenue, the other part is employed as capital, i.e. it is accumulated.	Ein Teil des Mehr- werts wird vom Kapitalisten als Revenue verzehrt , ein andrer Teil als Kapital angewandt oder akkumuliert.	ch24_clean.en-ch24_clean.de
With a given mass of surplus-value, then, the larger the one part, the smaller the other.	Bei gegebner Masse des Mehrwerts wird der eine dieser Teile um so größer sein, je kleiner der andre ist.	ch24_clean.en-ch24_clean.de
Other things being equal, the ratio of these parts determines the magnitude of the accumulation.	Alle andern Umstände als gleichbleibend genommen, bestimmt das Verhältnis, worin diese Teilung sich vollzieht, die Größe der Akkumulation.	ch24_clean.en-ch24_clean.de
But it is the owner of the surplus-value, the capitalist, who makes this division.	Wer aber diese Teilung vornimmt, das ist der Eigentümer des Mehrwerts, der Kapitalist.	ch24_clean.en-ch24_clean.de
It is an act of his will.	Sie ist also sein Willensakt.	ch24_clean.en-ch24_clean.de
That part of the tribute exacted by him which he accumulates is said to be saved by him, because he does not consume it, i.e. because he performs his function as a capitalist, and enriches himself.	Von dem Teil des von ihm erhobnen Tributs, den er akkumuliert, sagt man, er spare ihn, weil er ihn nicht aufißt, d.h., weil er seine Funktion als Kapitalist ausübt, nämlich die Funktion, sich zu bereichern.	ch24_clean.en-ch24_clean.de
Except as capital personified, the capitalist has no historical value, and no right to that historical existence which, to use Lichnowsky’s amusing expression, ‘ain’t got no date’. * It is only to this extent that the necessity of the capitalist’s own transitory existence is implied in the transitory necessity of the capitalist mode of production.	Nur soweit der Kapitalist personifiziertes Kapital ist, hat er einen historischen Wert und jenes historische Existenzrecht, das, wie der geistreiche Lichnowski sagt, keinen Datum nicht hat.	ch24_clean.en-ch24_clean.de
But, in so far as he is capital personified, his motivating force is not the acquisition and enjoyment of use-values, but the acquisition and augmentation of exchange-values.	Nur soweit steckt seine eigne transitorische Notwendigkeit in der transitorischen Notwendigkeit der kapitalistischen Produktionsweise.	ch24_clean.en-ch24_clean.de
He is fanatically intent on the valorization of value; consequently he ruthlessly forces the human race to produce for production’s sake.	Aber soweit sind auch nicht Gebrauchswert und Genuß, sondern Tauschwert und dessen Vermehrung sein treibendes Motiv.	ch24_clean.en-ch24_clean.de
In this way he spurs on the development of society’s productive forces, and the creation of those material conditions of production which alone can form the real basis of a higher form of society, a society in which the full and free development of every individual forms the ruling principle.	Als Fanatiker der Verwertung des Werts zwingt er rücksichtslos die Menschheit zur Produktion um der Produktion willen, daher zu einer Entwicklung der gesellschaftlichen Produktivkräfte und zur Schöpfung von materiellen Produktionsbedingungen, welche allein die reale Basis einer höheren Gesellschaftsform bilden können, deren Grundprinzip die volle und freie Entwicklung jedes Individuums ist.	ch24_clean.en-ch24_clean.de
Only as a personification of capital is the capitalist respectable.	Nur als Personifikation des Kapitals ist der Kapitalist respektabel.	ch24_clean.en-ch24_clean.de
As such, he shares with the miser an absolute drive towards self-enrichment.	Als solche teilt er mit dem Schatzbildner den absoluten Bereicherungstrieb.	ch24_clean.en-ch24_clean.de
But what appears in the miser as the mania of an individual is in the capitalist the effect of a social mechanism in which he is merely a cog.	Was aber bei diesem als individuelle Manie erscheint, ist beim Kapitalisten Wirkung des gesellschaftlichen Mechanismus, worin er nur ein Triebrad ist.	ch24_clean.en-ch24_clean.de
Moreover, the development of capitalist production makes it necessary constantly to increase the amount of capital laid out in a given industrial undertaking, and competition subordinates every individual capitalist to the immanent laws of capitalist production, as external and coercive laws.	Außerdem macht die Entwicklung der kapitalistischen Produktion eine fortwährende Steigerung des in einem industriellen Unternehmen angelegten Kapitals zur Notwendigkeit, und die Konkurrenz herrscht jedem individuellen Kapitalisten die immanenten Gesetze der kapitalistischen Produktionsweise als äußere Zwangsgesetze auf.	ch24_clean.en-ch24_clean.de
It compels him to keep extending his capital, so as to preserve it, and he can only extend it by means of progressive accumulation.	Sie zwingt ihn, sein Kapital fortwährend auszudehnen, um es zu erhalten, und ausdehnen kann er es nur vermittelst progressiver Akkumulation.	ch24_clean.en-ch24_clean.de
In so far, therefore, as his actions are a mere function of capital – endowed as capital is, in his person, with consciousness and a will – his own private consumption counts as a robbery committed against the accumulation of his capital, just as, in double-entry book-keeping, the private expenditure of the capitalist is placed on the debit side of his account against his capital.	Soweit daher sein Tun und Lassen nur Funktion des in ihm mit Willen und Bewußtsein begabten Kapitals, gilt ihm sein eigner Privatkonsum als ein Raub an der Akkumulation seines Kapitals, wie in der italienischen Buchhaltung Privatausgaben auf der Debetseite des Kapitalisten gegen das Kapital figurieren.	ch24_clean.en-ch24_clean.de
Accumulation is the conquest of the world of social wealth.	Die Akkumulation ist Eroberung der Welt des gesellschaftlichen Reichtums.	ch24_clean.en-ch24_clean.de
It is the extension of the area of exploited human material and, at the same time, the extension of the direct and indirect sway of the capitalist.	Sie dehnt mit der Masse des exploitierten Menschenmaterials zugleich die direkte und indirekte Herrschaft des Kapitalisten aus.	ch24_clean.en-ch24_clean.de
But original sin is at work everywhere.	Aber die Erbsünde wirkt überall.	ch24_clean.en-ch24_clean.de
With the development of the capitalist mode of production, with the growth of accumulation and wealth, the capitalist ceases to be merely the incarnation of capital.	Mit der Entwicklung der kapitalistischen Produktionsweise, der Akkumulation und des Reichtums, hört der Kapitalist auf, bloße Inkarnation des Kapitals zu sein.	ch24_clean.en-ch24_clean.de
He begins to feel a human warmth towards his own Adam, and his education gradually enables him to smile at his former enthusiasm for asceticism, as an old-fashioned miser’s prejudice.	Er fühlt ein "menschliches Rühren" für seinen eignen Adam und wird so gebildet, die Schwärmerei für Askese als Vorurteil des altmodischen Schatzbildners zu belächeln.	ch24_clean.en-ch24_clean.de
While the capitalist of the classical type brands individual consumption as a sin against his function, as ‘abstinence’ from accumulating, the modernized capitalist is capable of viewing accumulation as ‘renunciation’ of pleasure.	Während der klassische Kapitalist den individuellen Konsum als Sünde gegen seine Funktion und "Enthaltung" von der Akkumulation brandmarkt, ist der modernisierte Kapitalist imstande, die Akkumulation als "Entsagung" seines Genußtriebs aufzufassen.	ch24_clean.en-ch24_clean.de
‘Two souls, alas, do dwell within his breast; The one is ever parting from the other.’* At the historical dawn of the capitalist mode of production – and every capitalist upstart has to go through this historical stage individually – avarice, and the drive for self-enrichment, are the passions which are entirely predominant.	"Zwei Seelen wohnen, ach! in seiner Brust, die eine will sich von der andren trennen!" In den historischen Anfängen der kapitalistischen Produktionsweise, und jeder kapitalistische Parvenü macht dies historische Stadium individuell durch - herrschen Bereicherungstrieb und Geiz als absolute Leidenschaften vor.	ch24_clean.en-ch24_clean.de
But the progress of capitalist production not only creates a world of delights; it lays open, in the form of speculation and the credit system, a thousand sources of sudden enrichment.	Aber der Fortschritt der kapitalistischen Produktion schafft nicht nur eine Welt von Genüssen. Er öffnet mit der Spekulation und dem Kreditwesen tausend Quellen plötzlicher Bereicherung.	ch24_clean.en-ch24_clean.de
When a certain stage of development has been reached, a conventional degree of prodigality, which is also an exhibition of wealth, and consequently a source of credit, becomes a business necessity to the ‘unfortunate’ capitalist.	Auf einer gewissen Entwicklungshöhe wird ein konventioneller Grad von Verschwendung, die zugleich Schaustellung des Reichtums und daher Kreditmittel ist, sogar zu einer Geschäftsnotwendigkeit des "unglücklichen" Kapitalisten.	ch24_clean.en-ch24_clean.de
Luxury enters into capital’s expenses of representation.	Der Luxus geht in die Repräsentationskosten des Kapitals ein.	ch24_clean.en-ch24_clean.de
Moreover, the capitalist gets rich, not, like the miser, in proportion to his personal labour and restricted consumption, but at the same rate as he squeezes out labour-power from others, and compels the worker to renounce all the enjoyments of life.	Ohnehin bereichert sich der Kapitalist nicht, gleich dem Schatzbildner, im Verhältnis seiner persönlichen Arbeit und seines persönlichen Nichtkonsums, sondern im Maß, worin er fremde Arbeitskraft aussaugt und dem Arbeiter Entsagung aller Lebensgenüsse aufzwingt.	ch24_clean.en-ch24_clean.de
Thus although the expenditure of the capitalist never possesses the bona fide character of the dashing feudal lord’s prodigality, but, on the contrary, is always restrained by the sordid avarice and anxious calculation lurking in the background, this expenditure nevertheless grows with his accumulation, without the one necessarily restricting the other.	Obgleich daher die Verschwendung des Kapitalisten nie den bona fide Charakter der Verschwendung des flotten Feudalherrn besitzt, in ihrem Hintergrund vielmehr stets schmutzigster Geiz und ängstlichste Berechnung lauern, wächst dennoch seine Verschwendung mit seiner Akkumulation, ohne daß die eine die andre zu beabbruchen braucht.	ch24_clean.en-ch24_clean.de
At the same time, however, there develops in the breast of the capitalist a Faustian conflict between the passion for accumulation and the desire for enjoyment.	Damit entwickelt sich gleichzeitig in der Hochbrust des Kapitalindividuums ein faustischer Konflikt zwischen Akkumulations- und Genußtrieb.	ch24_clean.en-ch24_clean.de
Dr Aikin says, in a work published in 1795: ‘The trade of Manchester may be divided into four periods.	"Die Industrie von Manchester", heißt es in einer Schrift, die Dr. Aikin 1795 veröffentlichte, "kann in vier Perioden geteilt werden.	ch24_clean.en-ch24_clean.de
First, when manufacturers were obliged to work hard for their livelihood.’	In der ersten waren die Fabrikanten gezwungen, hart für ihren Lebensunterhalt zu arbeiten."	ch24_clean.en-ch24_clean.de
They enriched themselves chiefly by robbing the parents whose children were bound as apprentices to them: the parents paid a high premium, while the apprentices were starved.	Sie bereicherten sich besonders durch Bestehlung der Eltern, die ihnen Jungen als apprentices (Lehrlinge) zuwiesen und dafür schwer blechen mußten, während die Lehrlinge ausgehungert wurden.	ch24_clean.en-ch24_clean.de
On the other hand, the average profits were low, and, in order to accumulate, extreme parsimony was needed.	Andrerseits waren die Durchschnittsprofite niedrig, und die Akkumulation verlangte große Sparsamkeit.	ch24_clean.en-ch24_clean.de
They lived like misers, and were far from consuming even the interest on their capital.	Sie lebten wie Schatzbildner und verzehrten bei weitem nicht einmal die Zinsen ihres Kapitals.	ch24_clean.en-ch24_clean.de
‘The second period, when they had begun to acquire little fortunes, but worked as hard as before’ (for the direct exploitation of labour costs labour, as every slave-driver knows) ‘and lived in as plain a manner as before… The third, when luxury began, and the trade was pushed by sending out riders for orders into every market town in the Kingdom… It is probable that few or no capitals of £3, to £4, acquired by trade existed here before 1690.	"In der zweiten Periode hatten sie begonnen, kleine Vermögen zu erwerben, arbeiteten aber ebenso hart als zuvor", denn die unmittelbare Exploitation der Arbeit kostet Arbeit, wie jeder Sklaventreiber weiß, "und lebten nach wie vor in demselben frugalen Stil ... In der dritten Periode begann der Luxus, und das Geschäft wurde ausgedehnt durch Aussendung von Reitern" (berittenen Commis voyageurs) "für Ordres in jeder Marktstadt des Königreichs.	ch24_clean.en-ch24_clean.de
	Es ist wahrscheinlich, daß wenige oder keine Kapitale von 3.000 bis 4.000 Pfd.St., in der Industrie erworben, vor 1690 existierten.	ch24_clean.en-ch24_clean.de
However, about that time, or a little later, the traders had got money beforehand, and began to build modern brick houses, instead of those of wood and plaster.’	Um diese Zeit jedoch oder etwas später hatten die Industriellen schon Geld akkumuliert und begannen steinerne Häuser statt der von Holz und Mörtel aufzuführen ...	ch24_clean.en-ch24_clean.de
Even in the early part of the eighteenth century, a Manchester manufacturer who placed a pint of foreign wine before his guests exposed himself to the remarks and headshakings of all his neighbours.	Noch in den ersten Dezennien des 18. Jahrhunderts setzte sich ein Manchester Fabrikant, der eine Pint fremden Weins seinen Gästen vorsetzte, den Glossen und dem Kopfschütteln aller seiner Nachbarn aus."	ch24_clean.en-ch24_clean.de
Before the rise of machinery, a manufacturer’s evening expenditure at the public house where they all met never exceeded sixpence for a glass of punch, and a penny for a screw of tobacco.	Vor dem Aufkommen der Maschinerie betrug der abendliche Konsum der Fabrikanten in den Kneipen, wo sie zusammenkamen, nie mehr als 6 d. für ein Glas Punsch und 1 d. für eine Rolle Tabak.	ch24_clean.en-ch24_clean.de
It was not till 1758, and this marks an epoch, that a person actually engaged in business was seen with a carriage of his own.	Erst 1758, und dies macht Epoche, sah man "eine im Geschäft wirklich engagierte Person mit eigner Equipage!"	ch24_clean.en-ch24_clean.de
‘The fourth period,’ the last thirty years of the eighteenth century, ‘is that in which expense and luxury have made great progress, supported by a trade extended by means of riders and factors through every part of Europe.’	"Die vierte Periode", das letzte Dritteil des 18. Jahrhunderts, "ist die von großem Luxus und Verschwendung, unterstützt durch die Ausdehnung des Geschäfts."	ch24_clean.en-ch24_clean.de
What would the good Dr Aikin say if he could rise from the grave and see the Manchester of today?	Was würde der gute Dr. Aikin sagen, wenn er heutzutag in Manchester auferstände!	ch24_clean.en-ch24_clean.de
Accumulate, accumulate!	Akkumuliert, Akkumuliert!	ch24_clean.en-ch24_clean.de
That is Moses and the prophets!	Das ist Moses und die Propheten!	ch24_clean.en-ch24_clean.de
‘Industry furnishes the material which saving accumulates.’	"Die Industrie liefert das Material, welches die Sparsamkeit akkumuliert."	ch24_clean.en-ch24_clean.de
Therefore save, save, i.e. reconvert the greatest possible portion of surplus-value or surplus product into capital!	Also spart, spart, d.h., rückverwandelt möglichst großen Teil des Mehrwerts oder Mehrprodukts in Kapital!	ch24_clean.en-ch24_clean.de
Accumulation for the sake of accumulation, production for the sake of production: this was the formula in which classical economics expressed the historical mission of the bourgeoisie in the period of its domination.	Akkumulation um der Akkumulation, Produktion um der Produktion willen, in dieser Formel sprach die klassische Ökonomie den historischen Beruf der Bourgeoisperiode aus.	ch24_clean.en-ch24_clean.de
Not for one instant did it deceive itself over the nature of wealth’s birth-pangs. But what use is it to lament a historical necessity?	Sie täuschte sich keinen Augenblick über die Geburtswehn des Reichtums , aber was nützt der Jammer über historische Notwendigkeit?	ch24_clean.en-ch24_clean.de
If, in the eyes of classical economics, the proletarian is merely a machine for the production of surplus-value, the capitalist too is merely a machine for the transformation of this surplus-value into surplus capital.	Wenn der klassischen Ökonomie der Proletarier nur als Maschine zur Produktion von Mehrwert, gilt ihr aber auch der Kapitalist nur als Maschine zur Verwandlung dieses Mehrwerts in Mehrkapital.	ch24_clean.en-ch24_clean.de
Classical economics takes the historical function of the capitalist in grim earnest.	Sie nimmt seine historische Funktion in bitterm Ernst.	ch24_clean.en-ch24_clean.de
In order to conjure away the awful conflict between the desire for enjoyment and the drive for self-enrichment, Malthus, around the beginning of the 1820s, advocated a division of labour which assigned the business of accumulating to the capitalist actually engaged in production, and the business of spending to the other sharers in surplus-value, the landed aristocracy, the place-men, the beneficed clergy and so on.	Um seinen Busen vor dem unheilvollen Konflikt zwischen Genußtrieb und Bereicherungstrieb zu feien, verteidigte Malthus, im Anfang der zwanziger Jahre dieses Jahrhunderts, eine Teilung der Arbeit, welche dem wirklich in der Produktion begriffenen Kapitalisten das Geschäft der Akkumulation, den andren Teilnehmern am Mehrwert, der Landaristokratie, Staats-, Kirchenpfründnern usw., das Geschäft der Verschwendung zuweist.	ch24_clean.en-ch24_clean.de
It is of the highest importance, he says, ‘to keep separate the passion for expenditure and the passion for accumulation’.	Es ist von der höchsten Wichtigkeit, sagt er, "die Leidenschaft für Ausgabe und die Leidenschaft für Akkumulation (the passion for expenditure and the passion for accumulation) getrennt zu halten" .	ch24_clean.en-ch24_clean.de
The capitalists, who had long since turned themselves into good livers and men of the world, complained loudly at this.	Die Herrn Kapitalisten, seit lange in Lebe- und Weltmänner verwandelt, schrien auf.	ch24_clean.en-ch24_clean.de
What, exclaimed one of their spokesmen, a follower of Ricardo, does Mr Malthus preach high rents, heavy taxation, etc. so that the industrious may constantly be kept up to the mark by the pressure of unproductive consumers?	Was, rief einer ihrer Wortführer, ein Ricardianer, Herr Malthus predigt hohe Grundrenten, hohe Steuern usw., um dem Industriellen einen fortwährenden Stachel durch unproduktive Konsumenten aufzudrücken!	ch24_clean.en-ch24_clean.de
By all means let there be production, production on a constantly increasing scale, runs the shibboleth, but ‘production will, by such a process, be far more curbed in than spurred on.	Allerdings Produktion, Produktion auf stets erweiterter Stufenleiter, lautet das Schibboleth, aber "Produktion wird durch einen solchen Prozeß weit mehr gehemmt als gefördert.	ch24_clean.en-ch24_clean.de
Nor is it quite fair thus to maintain in idleness a number of persons, only to pinch others, who are likely, from their characters, if you can force them to work, to work with success.’	Auch ist es nicht ganz billig (nor is it quite fair), eine Anzahl Personen so im Müßiggang zu erhalten, nur um andre zu kneipen, aus deren Charakter man schließen darf (who are likely, from their characters), daß, wenn ihr sie zu funktionieren zwingen könnt, sie mit Erfolg funktionieren."	ch24_clean.en-ch24_clean.de
Though he finds it unfair to spur on the industrial capitalist by depriving his bread of its butter, he still thinks it necessary to reduce the worker’s wages to a minimum, ‘to keep him industrious’.	So unbillig er es findet, den industriellen Kapitalisten zur Akkumulation zu stacheln, indem man ihm das Fett von der Suppe weggchöpft, so notwendig dünkt ihm, den Arbeiter möglichst auf den Minimallohn zu beschränken, "um ihn arbeitsam zu erhalten".	ch24_clean.en-ch24_clean.de
Nor does he for a moment conceal the fact that the appropriation of unpaid labour is the secret of making a profit.	Auch verheimlicht er keinen Augenblick, daß Aneignung unbezahlter Arbeit das Geheimnis der Plusmacherei ist.	ch24_clean.en-ch24_clean.de
‘Increased demand on the part of the labourers means nothing more than their disposition to take less of their own product for themselves, and leave a greater part of it to their employers; and if it be said, that this begets glut, by lessening consumption’ (on the part of the workers) ‘I can only reply that glut is synonymous with large profits.’	"Vermehrte Nachfrage von Seite der Arbeiter meint durchaus nichts als ihre Geneigtheit, weniger von ihrem eignen Produkt für sich selbst zu nehmen und einen größren Teil davon ihren Anwendern zu überlassen; und wenn man sagt, daß dies, durch Verminderung der Konsumtion" (auf seiten der Arbeiter) "glut" (Marktüberfüllung, Überproduktion) "erzeugt, so kann ich nur antworten, daß glut synonym mit hohem Profit ist."	ch24_clean.en-ch24_clean.de
The learned dispute between the industrial capitalist and the wealthy landowning idler as to how the booty pumped out of the workers may most advantageously be divided for the purposes of accumulation had to fall silent in the face of the July Revolution.	Der gelehrte Zank, wie die dem Arbeiter ausgepumpte Beute förderlichst für die Akkumulation zu verteilen sei zwischen industriellem Kapitalist und müßigem Grundeigentümer usw., verstummte vor der Julirevolution.	ch24_clean.en-ch24_clean.de
Shortly afterwards, the urban proletariat sounded the tocsin of revolution at Lyons, and the rural proletariat began to set fire to farmyards and hayricks in England.	Kurz nachher läutete das städtische Proletariat die Sturmglocke zu Lyon und ließ das Landproletariat den roten Hahn in England fliegen.	ch24_clean.en-ch24_clean.de
On this side of the Channel Owenism began to spread; on the other side, Saint-Simonism and Fourierism.	Diesseits des Kanals grassierte der Owenismus, jenseits St.-Simonismus und Fourierismus.	ch24_clean.en-ch24_clean.de
The hour of vulgar economics had arrived.	Die Stunde der Vulgärökonomie hatte geschlagen.	ch24_clean.en-ch24_clean.de
Exactly a year before Nassau W. Senior discovered at Manchester that the profit (including interest) of capital is the product of the unpaid ‘last hour of the twelve hours of labour’,* he had announced to the world another discovery.	Grade ein Jahr, bevor Nassau W. Senior zu Manchester ausfand, daß der Profit (inkl. Zins) des Kapitals das Produkt der unbezahlten "letzten zwölften Arbeitsstunde" ist, hatte er der Welt eine andre Entdeckung angekündigt.	ch24_clean.en-ch24_clean.de
‘I substitute,’ he proudly says, ‘for the word capital, considered as an instrument of production, the word abstinence.’	"Ich", sagte er feierlich, "ich ersetze das Wort Kapital, als Produktionsinstrument betrachtet, durch das Wort Abstinenz (Enthaltung)."	ch24_clean.en-ch24_clean.de
An unparalleled example of the ‘discoveries’ of vulgar economics!	Ein unübertroffenes Muster dies von den "Entdeckungen" der Vulgärökonomie!	ch24_clean.en-ch24_clean.de
It replaces an economic category with a sycophantic phrase, and that is all.	Sie ersetzt eine ökonomische Kategorie durch eine sykophantische Phrase.	ch24_clean.en-ch24_clean.de
‘When the savage,’ says Senior, ‘makes bows, he exercises an industry, but he does not practise abstinence.’	Voila tout. <Das ist alles.> "Wenn der Wilde", doziert Senior, "Bogen fabriziert, so übt er eine Industrie aus, aber er praktiziert nicht die Abstinenz."	ch24_clean.en-ch24_clean.de
This is supposed to explain how and why, in the earlier states of society, the implements of labour were constructed ‘without the abstinence’ of the capitalist.	Dies erklärt uns, wie und warum in früheren Gesellschaftszuständen "ohne die Abstinenz" des Kapitalisten Arbeitsmittel fabriziert wurden.	ch24_clean.en-ch24_clean.de
‘The more society progresses, the more abstinence is demanded,’ namely from those whose business it is to appropriate the industry and the products of others.	"Je mehr die Gesellschaft fortschreitet, um so mehr Abstinenz erfordert sie" , nämlich von denen, welche die Industrie ausüben, sich die fremde Industrie und ihr Produkt anzueignen.	ch24_clean.en-ch24_clean.de
All the conditions necessary for the labour process are now converted into acts of abstinence on the part of the capitalist If the corn is not all eaten, but in part also sown – abstinence of the capitalist.	Alle Bedingungen des Arbeitsprozesses verwandeln sich von nun in ebenso viele Abstinenzpraktiken des Kapitalisten. Daß Korn nicht nur gegessen, sondern auch gesät wird, Abstinenz des Kapitalisten!	ch24_clean.en-ch24_clean.de
If the wine gets time to mature – abstinence of the capitalist.	Daß der Wein die Zeit erhält, auszugären, Abstinenz des Kapitalisten!	ch24_clean.en-ch24_clean.de
The capitalist robs himself whenever he ‘lends (!) the instruments of production to the worker’, in other words, whenever he valorizes their value as capital by incorporating labour-power into them instead of eating them up, steam-engines, cotton, railways, manure, horses and all; or, as the vulgar economist childishly conceives, instead of dissipating ‘their value’ in luxuries and other articles of consumption.	Der Kapitalist beraubt seinen eignen Adam, wenn er die "Produk- tionsinstrumente dem Arbeiter leiht" (! ), alias sie durch Einverleibung der Arbeitskraft als Kapital verwertet, statt Dampfmaschinen, Baumwolle, Eisenbahnen, Dünger, Zugpferde usf. aufzuessen oder, wie der Vulgärökonom sich das kindlich vorstellt, "ihren Wert" in Luxus und andren Konsumtionsmitteln zu verprassen.	ch24_clean.en-ch24_clean.de
How the capitalist class can perform the latter feat is a secret which vulgar economics has so far obstinately refused to divulge.	Wie die Kapitalistenklasse das anstellen soll, ist ein von der Vulgärökonomie bisher hartnäckig bewahrtes Geheimnis.	ch24_clean.en-ch24_clean.de
Enough that the world continues to live solely through the self-chastisement of this modern penitent of Vishnu, the capitalist.	Genug, die Welt lebt nur noch von der Selbstkasteiung dieses modernen Büßers des Wischnu, des Kapitalisten.	ch24_clean.en-ch24_clean.de
Not only accumulation, but the simple ‘conservation of a capital requires a constant effort to resist the temptation of consuming it’.	Nicht nur die Akkumulation, die einfache "Erhaltung eines Kapitals erheischt beständige Kraftanstrengung, um der Versuchung zu widerstehn, es aufzuessen".	ch24_clean.en-ch24_clean.de
The simple dictates of humanity therefore plainly enjoin the release of the capitalist from his martyrdom and his temptation, in the same way as the slaveowners of Georgia, U.S.A., have recently been delivered by the abolition of slavery from the painful dilemma over whether they should squander the surplus product extracted by means of the whip from their Negro slaves entirely in champagne, or whether they should reconvert a part of it into more Negroes and more land.	Die einfache Humanität gebeut also offenbar, den Kapitalisten von Martyrtum und Versuchung zu erlösen, in derselben Weise, wie der georgische Sklavenhalter jüngst durch Abschaffung der Sklaverei von dem schmerzlichen Dilemma erlöst ward, ob das dem Negersklaven ausgepeitschte Mehrprodukt ganz in Champagner zu verjubeln oder auch teilweis in mehr Neger und mehr Land rückzuverwandeln.	ch24_clean.en-ch24_clean.de
In economic formations of society of the most diverse kinds, there occurs not only simple reproduction but also, though in varying degrees, reproduction on an increasing scale.	In den verschiedensten ökonomischen Gesellschaftsformationen findet nicht nur einfache Reproduktion statt, sondern, obgleich auf verschiednem Maßstab, Reproduktion auf erweiterter Stufenleiter.	ch24_clean.en-ch24_clean.de
Progressively more is produced and consumed, and therefore more products have to be converted into means of production.	Es wird progressiv mehr produziert und mehr konsumiert, also auch mehr Produkt in Produktionsmittel verwandelt.	ch24_clean.en-ch24_clean.de
However, this process does not appear as an accumulation of capital, and consequently it does not appear as the function of a capitalist, as long as the worker’s means of production, and with them his product and means of subsistence, do not confront him in the shape of capital.	Dieser Prozeß erscheint aber nicht als Akkumulation von Kapital und daher auch nicht als Funktion des Kapitalisten, solange dem Arbeiter seine Produktionsmittel, daher auch sein Produkt und seine Lebensmittel, noch nicht in der Form von Kapital gegenüberstehn.	ch24_clean.en-ch24_clean.de
Richard Jones, who died a few years ago, and was the successor of Malthus in the chair of Political Economy at Haileybury, the college that trains people for the Indian Civil Service, discusses this point well in the light of two important facts.	Der vor einigen Jahren verstorbene Richard Jones, Nachfolger von Malthus auf dem Lehrstuhl der politischen Ökonomie am ostindischen College zu Haileybury, erörtert dies gut an zwei großen Tatsachen.	ch24_clean.en-ch24_clean.de
Since the greater part of the Indian population are peasants cultivating their land themselves, their products, their instruments of labour and their means of subsistence never take ‘the shape of a fund saved from revenue, which fund has, therefore, gone through a previous process of accumulation’.	Da der zahlreichste Teil des indischen Volks selbstwirtschaftende Bauern, existiert ihr Produkt, ihre Arbeits- und Lebensmittel, auch nie "in der Form (in the shape) eines Fonds, der aus fremder Revenue erspart wird (saved from Revenue) und daher einen vorläufigen Prozeß der Akkumulation (a previous process of accumulation) durchlaufen hat" .	ch24_clean.en-ch24_clean.de
On the other hand, in those provinces where English rule has least disturbed the old system, the non-agricultural workers are directly employed by the magnates, to whom a portion of the agricultural surplus product is rendered in the shape of tribute or rent.	Andrerseits werden die nicht-agrikolen Arbeiter in den Provinzen, wo die englische Herrschaft das alte System am wenigsten aufgelöst hat, direkt von den Großen beschäftigt, denen eine Portion des ländlichen Mehrprodukts als Tribut oder Grundrente zufließt.	ch24_clean.en-ch24_clean.de
One part of this product is consumed by the magnates in its natural form, another part is converted by the workers into articles of luxury and other consumption goods for the use of the magnates, and the remainder forms the wage of the workers, who own their implements of labour.	Ein Teil dieses Produkts wird in Naturalform von den Großen verzehrt, ein andrer Teil für sie von den Arbeitern in Luxus- und sonstige Konsumtionsmittel verwandelt, während der Rest den Lohn der Arbeiter bildet, die Eigentümer ihrer Arbeitsinstrumente sind.	ch24_clean.en-ch24_clean.de
Here, production and reproduction on an increasing scale go on their way without any intervention from that peculiar saint, that knight of the woeful countenance, the ‘abstaining’ capitalist.	Produktion und Reproduktion auf erweiterter Stufenleiter gehn hier ihren Gang ohne alle Dazwischenkunft jenes wunderlichen Heiligen, jenes Ritters von der traurigen Gestalt, des "entsagenden" Kapitalisten.	ch24_clean.en-ch24_clean.de
4. THE CIRCUMSTANCES WHICH, INDEPENDENTLY OF THE PROPORTIONAL DIVISION OF SURPLUS-VALUE INTO CAPITAL AND REVENUE, DETERMINE THE EXTENT OF ACCUMULATION, NAMELY, THE DEGREE OF EXPLOITATION OF LABOUR-POWER, THE PRODUCTIVITY OF LABOUR, THE GROWING DIFFERENCE IN AMOUNT BETWEEN CAPITAL EMPLOYED AND CAPITAL CONSUMED, AND THE MAGNITUDE OF THE CAPITAL ADVANCED If we assume the proportion in which surplus-value breaks up into capital and revenue as a given factor, the magnitude of the capital accumulated clearly depends on the absolute magnitude of the surplus-value.	4. Umstände, welche unabhängig von der proportionellen Teilung des Mehrwerts in Kapital und Revenue den Umfang der Akkumulation bestimmen: Exploitationsgrad der Arbeitskraft - Produktivkraft der Arbeit - Wachsende Differenz zwischen angewandtem und konsumiertem Kapital - Größe des vorgeschoßnen Kapitals Das Verhältnis, wonach der Mehrwert sich in Kapital und Revenue spaltet, als gegeben vorausgesetzt, richtet sich die Größe des akkumulierten Kapitals offenbar nach der absoluten Größe des Mehrwerts.	ch24_clean.en-ch24_clean.de
Suppose that 80 per cent of the surplus-value is capitalized, and 20 per cent is eaten up, then the accumulated capital will be £2, or £1,200, according to whether the total amount of surplus-value was £3, or £1,500.	Angenommen 80% würden kapitalisiert und 20% aufgegessen, so wird das akkumulierte Kapital 2.400 Pfd.St. oder 1.200 Pfd.St. betragen, je nachdem der Gesamt- Mehrwert sich auf 3.000 oder auf 1.500 Pfd.St. belaufen hat.	ch24_clean.en-ch24_clean.de
Hence all the circumstances that determine the mass of surplus-value operate to determine the magnitude of the accumulation.	Demnach wirken bei Bestimmung der Größe der Akkumulation alle die Umstände mit, die die Masse des Mehrwerts bestimmen.	ch24_clean.en-ch24_clean.de
Here we shall summarize them once again, but only in so far as they offer fresh material which relates to accumulation.	Wir fassen sie hier nochmals zusammen, aber nur insofern sie mit Bezug auf die Akkumulation neue Gesichtspunkte bieten.	ch24_clean.en-ch24_clean.de
It will be remembered that the rate of surplus-value depends, in the first place, on the degree of exploitation of labour-power.	Man erinnert sich, daß die Rate des Mehrwerts in erster Instanz abhängt vom Exploitationsgrad der Arbeitskraft.	ch24_clean.en-ch24_clean.de
Political economy lays such great stress on this point that it occasionally identifies the acceleration of accumulation which results from an increase in the productivity of labour with the acceleration which arises from an increase in the exploitation of the worker.	Die politische Ökonomie würdigt diese Rolle so sehr, daß sie gelegentlich die Beschleunigung der Akkumulation durch erhöhte Produktionskraft der Arbeit identifiziert mit ihrer Beschleunigung durch erhöhte Exploitation des Arbeiters.	ch24_clean.en-ch24_clean.de
In the chapters on the production of surplus-value we constantly assumed that wages were at least equal to the value of labour-power.	In den Abschnitten über die Produktion des Mehrwerts ward beständig unterstellt, daß der Arbeitslohn wenigstens gleich dem Wert der Arbeitskraft ist.	ch24_clean.en-ch24_clean.de
But the forcible reduction of the wage of labour beneath its value plays too important a role in the practical movement of affairs for us not to stay with this phenomenon for a moment.	Die gewaltsame Herabsetzung des Arbeitslohns unter diesen Wert spielt jedoch in der praktischen Bewegung eine zu wichtige Rolle, um uns nicht einen Augenblick dabei aufzuhalten.	ch24_clean.en-ch24_clean.de
In fact, it transforms the worker’s necessary fund for consumption, within certain limits, into a fund for the accumulation of capital. ’Wages,’ says John Stuart Mill, ‘have no productive power; they are the price of a productive power.	Sie verwandelt faktisch, innerhalb gewisser Grenzen, den notwendigen Konsumtionsfonds des Arbeiters in einen Akkumulationsfonds von Kapital.	ch24_clean.en-ch24_clean.de
Wages do not contribute, along with labour, to the production of commodities, no more than the price of tools contributes along with the tools themselves.	"Arbeitslöhne", sagt J. St. Mill, "haben keine Produktivkraft; sie sind der Preis einer Produktivkraft; Arbeitslöhne tragen nicht, neben der Arbeit selbst, zur Warenproduktion bei, so wenig als der Preis der Maschinerie selbst.	ch24_clean.en-ch24_clean.de
If labour could be had without purchase, wages might be dispensed with.’	Könnte Arbeit ohne Kauf gehabt werden, so wären Arbeitslöhne überflüssig."	ch24_clean.en-ch24_clean.de
But if the workers could live on air, it would not be possible to buy them at any price.	Wenn aber die Arbeiter von der Luft leben könnten, so wären sie auch um keinen Preis zu kaufen.	ch24_clean.en-ch24_clean.de
This zero cost of labour is therefore a limit in a mathematical sense, always beyond reach, although we can always approximate more and more nearly to it.	Ihr Nichtkosten ist also eine Grenze im mathematischen Sinn, stets unerreichbar, obgleich stets annäherbar.	ch24_clean.en-ch24_clean.de
The constant tendency of capital is to force the cost of labour back towards this absolute zero.	Es ist die beständige Tendenz des Kapitals, sie auf diesen nihilistischen Standpunkt herabzudrücken.	ch24_clean.en-ch24_clean.de
An eighteenth-century writer we have often quoted already, the author of the ‘Essay on Trade and Commerce’, actually reveals the innermost secret of English capital when he declares that England’s historical mission is to force down English wages to the French and Dutch level.	Ein oft von mir zitierter Schriftsteller des 18. Jahrhunderts, der Verfasser des "Essay on Trade and Commerce", verrät nur das innerste Seelengeheimnis des englischen Kapitals, wenn er es für die historische Lebensaufgabe Englands erklärt, den englischen Arbeitslohn auf das französische und holländische Niveau herabzudrücken.	ch24_clean.en-ch24_clean.de
He says, naively: ‘But if our poor’ (a technical term for the workers) ‘will live luxuriously… then labour must, of course, be dear… One has only to consider what luxuries the manufacturing populace consume, such as brandy, gin, tea, sugar, foreign fruit, strong beer, printed linens, snuff, tobacco, etc.’	Er sagt u.a. naiv: "Wenn aber unsre Armen" (Kunstausdruck für Arbeiter) "luxuriös leben wollen ... muß ihre Arbeit natürlich teuer sein ...	ch24_clean.en-ch24_clean.de
He quotes the work of a Northamptonshire manufacturer, who, with one eye on heaven, laments: ‘Labour is one-third cheaper in France than in England; for their poor work hard, and fare hard, as to their food and clothing.	Man betrachte nur die haarsträubende Masse von Überflüssigkeiten (heap of superfluities), die unsre Manufakturarbeiter verzehren, als da sind Branntwein, Gin, Tee, Zucker, fremde Früchte, starkes Bier, gedruckte Leinwand, Schnupf- und Rauchtabak etc."	ch24_clean.en-ch24_clean.de
Their chief diet is bread, fruit, herbs, roots, and dried fish; for they very seldom eat flesh; and when wheat is dear, they eat very little bread.’	Er zitiert die Schrift eines Fabrikanten von Northamptonshire, der mit himmelwärts schielendem Blick jammert: "Arbeit ist ein ganzes Dritteil wohlfeiler in Frankreich als in England: denn die französischen Armen arbeiten hart und fahren hart an Nahrung und Kleidung, und ihr Hauptkonsum sind Brot, Früchte, Kräuter, Wurzeln und getrockneter Fisch; denn sie essen sehr selten Fleisch, und wenn der Weizen teuer ist, sehr wenig Brot."	ch24_clean.en-ch24_clean.de
‘To which may be added,’ our essayist continues, ‘that their drink is either water or other small liquors, so that they spend very little money… These things are very difficult to be brought about; but they are not impracticable, since they have been effected both in France and in Holland.’	"Wozu", fährt der Essayist fort, "wozu noch kommt, daß ihr Getränk aus Wasser besteht oder ähnlichen schwachen Likören, so daß sie in der Tat erstaunlich wenig Geld ausgeben ... Ein derartiger Zustand der Dinge ist sicherlich schwer herbeizuführen aber er ist nicht unerreichbar, wie seine Existenz sowohl in Frankreich als Holland schlagend beweist."	ch24_clean.en-ch24_clean.de
Twenty years later, an American humbug, the ennobled Yankee Benjamin Thompson (alias Count Rumford),* pursued the same line in philanthropy, to the great satisfaction of God and man.	Zwei Jahrzehnte später verfolgte ein amerikanischer Humbug, der baronisierte Yankee Benjamin Thompson (alias Graf Rumford), dieselbe Philanthropielinie mit großem Wohlgefallen vor Gott und den Menschen.	ch24_clean.en-ch24_clean.de
His Essays are a cookery book with recipes of all kinds for replacing the ordinary, but expensive food of the worker with various surrogates.	Seine "Essays" sind ein Kochbuch mit Rezepten aller Art, um Surrogate an die Stelle der teuren Normalspeisen des Arbeiters zu setzen.	ch24_clean.en-ch24_clean.de
The following is a particularly successful recipe issued by this remarkable ‘philosopher’: ‘ lb. of barley-meal, 7 1/2d. ; 5 lb. of Indian corn, 6 1/4d. ; 3d. worth of red herring, Id. salt, Id. vinegar, 2d. pepper and sweet herbs, in all 20 3/4d. ; make a soup for 64 men, and at the medium price of barley and of Indian corn… this soup may be provided at 1/4d. the portion of 20 ounces.’42With the advance of capitalist production, the adulteration of food has rendered Thompson’s ideal superfluous.	Ein besonders gelungnes Rezept dieses wunderlichen "Philosophen" ist folgendes: "Fünf Pfund Gerste, fünf Pfund Mais, für 3 d. Heringe, 1 d. Salz, 1 d. Essig, 2 d. Pfeffer und Kräuter - Summa von 20 3/4 d. gibt eine Suppe für 64 Menschen, ja mit den Durchschnittspreisen von Korn kann die Kost auf 1/4 d. per Kopf" (noch nicht 3 Pfennige) "herabgedrückt werden." Mit dem Fortschritt der kapitalistischen Produktion hat die Warenfälschung Thompsons Ideale überflüssig gemacht.	ch24_clean.en-ch24_clean.de
At the end of the eighteenth and during the first ten years of the nineteenth century, the English farmers and landlords enforced the absolute minimum of wages by paying the agricultural labourers less than the minimum in the actual form of wages, and the remainder in the form of parochial relief.	Ende des 18. und während der ersten Dezennien des 19. Jahrhunderts erzwangen die englischen Pächter und Landlords das absolute Minimalsalair, indem sie den Ackerbautaglöhnern weniger als das Minimum in der Form des Arbeitslohns, den Rest aber in der Form von Pfarreiunterstützung auszahlten.	ch24_clean.en-ch24_clean.de
Here is an example of the buffoonery of the English Dogberries, when they were ‘legally’ laying down a wage-tariff: ‘The squires of Norfolk had dined, says Mr Burke, when they fixed the rate of wages; the squires of Berks evidently thought the labourers ought not to do so, when they fixed the rate of wages at Speenhamland, 1795… There they decided that, “income (weekly) should be 3s., for a man”, when the gallon or half-peck loaf of 8 lb. oz. is at 1s., and increase regularly till bread is 1s.	Ein Beispiel der Possenreißerei, womit die englischen Dogberries in ihrer "legalen" Festsetzung des Lohntarifs verfuhren: "Als die Squires die Arbeitslöhne für Speenhamland 1795 festsetzten, hatten sie zu Mittag gespeist, dachten aber offenbar, daß die Arbeiter nicht desgleichen nötig hatten ... Sie entschieden, der Wochenlohn solle 3 sh. per Mann sein, wenn der Laib Brot von 8 Pfund 11 Unzen auf 1 sh. stünde, und er solle regelmäßig wachsen, bis der Laib 1 sh. 5 d. koste.	ch24_clean.en-ch24_clean.de
5d. ; when it is above that sum, decrease regularly till it be at 2s., and then his food should be 1/5th less.’	Sobald er über diesen Preis stiege, sollte der Lohn proportionell abnehmen, bis der Preis des Laibes 2 sh. erreicht hätte; und dann sollte die Nahrung des Mannes 1/5 weniger als vorher sein."	ch24_clean.en-ch24_clean.de
Before the Committee of Inquiry of the House of Lords (1814) a certain A. Bennett, a big farmer, magistrate, poor-law guardian and wage-regulator, was asked: ‘Has any proportion of the value of daily labour been made up to the labourers out of the poors’ rate?’	Vor dem Untersuchungskomitee des House of Lords, 1814, wird ein gewisser A. Bennett, großer Pächter, Magistrat, Armenhausverwalter und Lohnregulator, gefragt: "Wird irgendeine Proportion zwischen dem Wert der Tagesarbeit und der Pfarreiunterstützung der Arbeiter beobachtet?" Antwort: "Ja.	ch24_clean.en-ch24_clean.de
	Das wöchentliche Einkommen jeder Familie wird über ihren Nominallohn hinaus voll gemacht bis zum Gallonlaib Brot (8 Pf.	ch24_clean.en-ch24_clean.de
Answer: ‘Yes, it has; the weekly income of every family is made up to the gallon loaf ( lb. oz. ), and 3d. per head!… The gallon loaf per week is what we suppose sufficient for the maintenance of every person in the family for the week; and the 3d. is for clothes, and if the parish think proper to find clothes, the 3d. is deducted.	11 Unzen) und 3 d. per Kopf ... Wir unterstellen den Gallonlaib hinreichend für die Erhaltung jeder Person in der Familie während der Woche; und die 3 d. sind für Kleider; und wenn es der Pfarrei beliebt, die Kleider selbst zu stellen, werden die 3 d. abgezogen.	ch24_clean.en-ch24_clean.de
This practice goes through all the western part of Wiltshire, and, I believe, throughout the country.’	Diese Praxis herrscht nicht nur im ganzen Westen von Wiltshire, sondern, wie ich glaube, im ganzen Land."	ch24_clean.en-ch24_clean.de
‘For years’, exclaims a bourgeois writer of the time, ‘they (the farmers) have degraded a respectable class of their countrymen, by forcing them to have recourse to the workhouse… the farmer, while increasing his own gains, has prevented any accumulation on the part of his labouring dependants.’	"So", ruft ein Bourgeoisschriftsteller jener Zeit, "haben die Pächter jahrelang eine respektable Klasse ihrer Landsleute degradiert, indem sie dieselben zwangen, zum Workhouse ihre Zuflucht zu nehmen ... Der Pächter hat seine eignen Gewinne vermehrt, indem er selbst die Akkumulation des unentbehrlichsten Konsumfonds auf Seite der Arbeiter verhinderte."	ch24_clean.en-ch24_clean.de
The case of so-called ‘domestic industry’ shows the part played in our own time by direct robbery from the worker’s necessary consumption-fund in the formation of surplus-value, and therefore in the formation of the fund for the accumulation of capital. * We shall give further facts on this subject later.	Welche Rolle heutzutag der direkte Raub am notwendigen Konsumtionsfonds des Arbeiters in der Bildung des Mehrwerts und daher des Akkumulationsfonds des Kapitals spielt, hat beispielsweis die sog. Hausarbeit (s. Kap. XV, 8, c.) gezeigt. Weitere Tatsachen im Verlauf dieses Abschnitts.	ch24_clean.en-ch24_clean.de
Although that portion of the constant capital which consists of the instruments of labour must, in all branches of industry, be sufficient for a certain number of workers (this number being determined by the size of the enterprise), it by no means always necessarily increases in the same proportion as the quantity of labour employed.	Obschon in allen Industriezweigen der aus Arbeitsmitteln bestehende Teil des konstanten Kapitals genügen muß für eine gewisse, durch die Größe der Anlage bestimmte Anzahl Arbeiter, so braucht er doch keineswegs immer in demselben Verhältnis zu wachsen wie die beschäftigte Arbeitsmenge.	ch24_clean.en-ch24_clean.de
Let us suppose that 100 workers, working 8 hours a day in a given factory, yield 800 hours of labour.	In einer Fabrikanlage mögen hundert Arbeiter bei acht- stündiger Arbeit 800 Arbeitsstunden liefern.	ch24_clean.en-ch24_clean.de
If the capitalist wishes to raise this total by one half, he can employ 50 more workers; but then he must also advance more capital, not merely for wages, but for instruments of labour.	Will der Kapitalist diese Summe um die Hälfte steigern, so kann er 50 neue Arbeiter anstellen; dann muß er aber auch ein neues Kapital vorschießen, nicht nur für Löhne, sondern auch für Arbeitsmittel.	ch24_clean.en-ch24_clean.de
But he might also let the 100 workers work 12 hours instead of 8, and then the instruments of labour already to hand would suffice. They would merely be consumed more rapidly.	Er kann aber auch die alten 100 Arbeiter 12 Stunden arbeiten lassen statt 8, und dann genügen die schon vorhandnen Arbeitsmittel, die sich dann bloß rascher verschleißen.	ch24_clean.en-ch24_clean.de
Thus additional labour, arising from a greater exertion of labour-power, can augment the surplus product and surplus-value, which is the substance of accumulation, without a proportional augmentation in the constant part of capital.	So kann durch höhere Anspannung der Arbeitskraft erzeugte, zusätzliche Arbeit das Mehrprodukt und den Mehrwert, die Substanz der Akkumulation, steigern ohne verhältnismäßige Steigerung des konstanten Kapitalteils.	ch24_clean.en-ch24_clean.de
In the extractive industries, mines etc., the raw materials do not form part of the capital advanced.	In der extraktiven Industrie, den Bergwerken z.B., bilden die Rohstoffe keinen Bestandteil des Kapitalvorschusses.	ch24_clean.en-ch24_clean.de
The object of labour is in this case not a product of previous labour, but something provided by nature free of charge, as in the case of metals, minerals, coal, stone, etc.	Der Arbeitsgegenstand ist hier nicht Produkt vorhergegangner Arbeit, sondern von der Natur gratis geschenkt.	ch24_clean.en-ch24_clean.de
Here the constant capital consists almost exclusively of instruments of labour which can very easily absorb an increased quantity of labour (day and night shifts, for example).	So Metallerz, Minerale, Steinkohlen, Steine etc. Hier besteht das konstante Kapital fast ausschließlich in Arbeitsmitteln, die ein vermehrtes Arbeitsquantum sehr gut vertragen können (Tag- und Nachtschicht von Arbeitern z.B.).	ch24_clean.en-ch24_clean.de
All other things being equal, the mass and value of the product will rise in direct proportion to the labour expended.	Alle andern Umstände gleichgesetzt, wird aber Masse und Wert des Produkts steigen in direktem Verhältnis der angewandten Arbeit.	ch24_clean.en-ch24_clean.de
As on the first day of production, the two original agencies working to form the product, man and nature, continue to co-operate, and now, as creators of the products, they are also creators of the material elements of capital.	Wie am ersten Tag der Produktion, gehn hier die ursprünglichen Produktbildner, daher auch die Bildner der stofflichen Elemente des Kapitals, Mensch und Natur, zusammen.	ch24_clean.en-ch24_clean.de
Thanks to the elasticity of labour-power, the domain of accumulation has extended without any prior increase in the size of the constant capital.	Dank der Elastizität der Arbeitskraft hat sich das Gebiet der Akkumulation erweitert ohne vorherige Vergrößerung des konstanten Kapitals.	ch24_clean.en-ch24_clean.de
In agriculture, the amount of land under cultivation cannot be increased without laying out more seed and manure.	In der Agrikultur kann man das bebaute Land nicht ausdehnen ohne Vorschuß von zusätzlichem Samen und Dünger.	ch24_clean.en-ch24_clean.de
But once this has been done, the purely mechanical ploughing of the soil itself produces a marvellous effect on the size of the product.	Aber dieser Vorschuß einmal gemacht, übt selbst die rein mechanische Bearbeitung des Bodens eine wundertätige Wirkung auf die Massenhaftigkeit des Produkts.	ch24_clean.en-ch24_clean.de
A greater quantity of labour, performed by the same number of workers as before, thus increases the fertility of the land without requiring any new contribution in the form of instruments of labour.	Eine größere Arbeitsmenge, geleistet von der bisherigen Anzahl Arbeiter, steigert so die Fruchtbarkeit, ohne neuen Vorschuß an Arbeitsmitteln zu erfordern.	ch24_clean.en-ch24_clean.de
It is once again the direct action of man on nature which becomes an immediate source of greater accumulation, without the intervention of any new capital.	Es ist wieder direkte Wirkung des Menschen auf die Natur, welche zur unmittelbaren Quelle gesteigerter Akkumulation wird, ohne Dazwischenkunft eines neuen Kapitals.	ch24_clean.en-ch24_clean.de
Finally, in industry proper, every additional expenditure of labour presupposes a corresponding additional expenditure of raw materials, but not necessarily of instruments of labour.	Endlich in der eigentlichen Industrie setzt jede zusätzliche Ausgabe an Arbeit eine entsprechende Zusatzausgabe an Rohstoffen voraus, aber nicht notwendig auch an Arbeitsmitteln.	ch24_clean.en-ch24_clean.de
And as extractive industry and agriculture supply manufacturing industry both with its own raw materials and with those for its instruments of labour, the additional product provided by extractive industry and agriculture without any additional advance of capital also redounds to the advantage of manufacturing industry.	Und da die extraktive Industrie und Agrikultur der fabrizierenden Industrie ihre eignen Rohstoffe und die ihrer Arbeitsmittel liefern, kommt dieser auch der Produktenzuschuß zugute, den jene ohne zusätzlichen Kapitalzuschuß erzeugt haben.	ch24_clean.en-ch24_clean.de
We arrive, therefore, at this general result: by incorporating with itself the two primary creators of wealth, labour-power and land, capital acquires a power of expansion that permits it to augment the elements of its accumulation beyond the limits apparently fixed by its own magnitude, or by the value and the mass of the means of production which have already been produced, and in which it has its being.	Allgemeines Resultat: Indem das Kapital sich die beiden Urbildner des Reichtums, Arbeitskraft und Erde, einverleibt, erwirbt es eine Expansions- -kraft, die ihm erlaubt, die Elemente seiner Akkumulation auszudehnen jenseits der scheinbar durch seine eigne Größe gesteckten Grenzen, gesteckt durch den Wert und die Masse der bereits produzierten Produktionsmittel, in denen es sein Dasein hat.	ch24_clean.en-ch24_clean.de
Another important factor in the accumulation of capital is the degree of productivity of social labour.	Ein andrer wichtiger Faktor in der Akkumulation des Kapitals ist der Produktivitätsgrad der gesellschaftlichen Arbeit.	ch24_clean.en-ch24_clean.de
The mass of the products in which a certain value, and therefore a surplus-value of a given magnitude is embodied, increases along with the productivity of labour.	Mit der Produktivkraft der Arbeit wächst die Produktenmasse, worin sich ein bestimmter Wert, also auch Mehrwert von gegebner Größe, darstellt.	ch24_clean.en-ch24_clean.de
If the rate of surplus-value remains the same (or even if it falls, provided that it falls more slowly than the productivity of labour rises), the mass of the surplus pro-due. increases.	Bei gleichbleibender und selbst bei fallender Rate des Mehrwerts, sofern sie nur langsamer fällt, als die Produktivkraft der Arbeit steigt, wächst die Masse des Mehrprodukts.	ch24_clean.en-ch24_clean.de
If the division of this product into revenue and additional capital remains the same, the consumption of the capitalist may accordingly increase without any decrease in the fund for accumulation.	Bei gleichbleibender Teilung desselben in Revenue und Zusatzkapital kann daher die Konsumtion des Kapitalisten wachsen ohne Abnahme des Akkumulationsfonds.	ch24_clean.en-ch24_clean.de
The relative magnitude of the accumulation-fund may even increase at the expense of the consumption-fund, while the cheapening of commodities places at the disposal of the capitalist as many means of enjoyment as formerly, or even more.	Die proportionelle Größe des Akkumulationsfonds kann selbst auf Kosten des Konsumtionsfonds wachsen, während die Verwohlfeilerung der Waren dem Kapitalisten ebenso viele oder mehr Genußmittel als vorher zur Verfügung stellt.	ch24_clean.en-ch24_clean.de
But the increasing productivity of labour is accompanied by a cheapening of the worker, as we have seen, and it is therefore accompanied by a higher rate of surplus-value, even when real wages are rising.	Aber mit der wachsenden Produktivität der Arbeit geht, wie man gesehn, die Verwohlfeilerung des Arbeiters, also wachsende Rate des Mehrwerts, Hand in Hand, selbst wenn der reelle Arbeitslohn steigt.	ch24_clean.en-ch24_clean.de
The latter never rise in proportion to the productivity of labour.	Er steigt nie verhältnismäßig mit der Produktivität der Arbeit.	ch24_clean.en-ch24_clean.de
The same value in variable capital therefore sets in motion more labour-power and, consequently, more labour.		ch24_clean.en-ch24_clean.de
The same value in constant capital is embodied in more means of production, i.e. in more instruments of labour, materials of labour and auxiliary materials.	Derselbe variable Kapitalwert setzt also mehr Arbeitskraft und daher mehr Arbeit in Bewegung.	ch24_clean.en-ch24_clean.de
It therefore supplies both more product-creating agencies and more value-creating agencies, in other words absorbers of labour.	Derselbe konstante Kapitalwert stellt sich in mehr Produktionsmitteln, d.h. mehr Arbeitsmitteln, Arbeitsmaterial und Hilfsstoffen dar, liefert also sowohl mehr Produktbildner als Wertbildner oder Arbeitseinsauger.	ch24_clean.en-ch24_clean.de
Therefore, even if the value of the additional capital remains the same or diminishes, accelerated accumulation still takes place.	Bei gleichbleibendem und selbst abnehmendem Wert des Zusatzkapitals findet daher beschleunigte Akkumulation statt.	ch24_clean.en-ch24_clean.de
Not only does the scale of reproduction materially extend, but the production of surplus-value increases more rapidly than the value of the additional capital.	Nicht nur erweitert sich die Stufenleiter der Reproduktion stofflich, sondern die Produktion des Mehrwerts wächst schneller als der Wert des Zusatzkapitals.	ch24_clean.en-ch24_clean.de
The growth of the productivity of labour also has an impact on the original capital, i.e. the capital which is already engaged in the production process.	Die Entwicklung der Produktivkraft der Arbeit reagiert auch auf das Originalkapital oder das bereits im Produktionsprozeß befindliche Kapital.	ch24_clean.en-ch24_clean.de
A part of the functioning constant capital consists of instruments of labour such as machinery, etc., which are not consumed, and therefore not reproduced or replaced, until long periods of time have elapsed.	Ein Teil des funktionierenden konstanten Kapitals besteht aus Arbeitsmitteln, wie Maschinerie usw., die nur in längeren Perioden konsumiert und daher reproduziert oder durch neue Exemplare derselben Art ersetzt werden.	ch24_clean.en-ch24_clean.de
However, every year some of these instruments of labour perish, or reach the ultimate limit of their productive function.	Aber jedes Jahr stirbt ein Teil dieser Arbeitsmittel ab oder erreicht das Endziel seiner produktiven Funktion.	ch24_clean.en-ch24_clean.de
At this point, then, they reach the time for their periodic reproduction, for their replacement with other, similar machines. If the productivity of labour has increased in the place where these instruments of labour are constructed (and it does develop continually, owing to the uninterrupted advance of science and technology), the old machines, tools, apparatus, etc. will be replaced by more efficient and (considering their increased efficiency) cheaper ones.	Er befindet sich daher jedes Jahr im Stadium seiner periodischen Reproduktion oder seines Ersatzes durch neue Exemplare derselben Art. Hat die Produktivkraft der Arbeit sich in der Geburtsstätte dieser Arbeitsmittel erweitert, und sie entwickelt sich fortwährend mit dem ununterbrochenen Fluß der Wissen- schaft und der Technik, so tritt wirkungsvollere und, ihren Leistungsumfang betrachtet, wohlfeilere Maschine, Werkzeug, Apparat usw. an die Stelle der alten.	ch24_clean.en-ch24_clean.de
The old capital is replaced in a more productive form, not to mention continual improvements in the details of the instruments of labour actually in operation.	Das alte Kapital wird in einer produktiveren Form reproduziert, abgesehn von der fortwährenden Detailveränderung an den vorhandnen Arbeitsmitteln.	ch24_clean.en-ch24_clean.de
The other part of the constant capital, raw material and auxiliary substances, is reproduced over and over again within the space of a year; the part of constant capital produced by agriculture is reproduced annually, by and large.	Der andre Teil des konstanten Kapitals, Rohmaterial und Hilfsstoffe, wird fortwährend innerhalb des Jahrs, der der Agrikultur entstammende meist jährlich reproduziert.	ch24_clean.en-ch24_clean.de
Every time improved methods are introduced, therefore, this has an almost simultaneous impact on the new capital and the capital already engaged in its function.	Jede Einführung beßrer Methoden usw. wirkt hier also fast gleichzeitig auf Zuschußkapital und bereits in Funktion begriffnes Kapital.	ch24_clean.en-ch24_clean.de
Every advance in chemistry not only multiplies the number of useful materials, and the useful applications of those already known, thus extending capital’s sphere of investment along with its growth; it also teaches capital how to throw back the waste from the processes of production and consumption into the cycle of the process of reproduction, and thus, without any previous outlay of capital, it creates fresh materials for it.	Jeder Fortschritt der Chemie vermannigfacht nicht nur die Zahl der nützlichen Stoffe und die Nutzanwendungen der schon bekannten, und dehnt daher mit dem Wachstum des Kapitals seine Anlagesphären aus. Er lehrt zugleich die Exkremente des Produktions- und Konsumtionsprozesses in den Kreislauf des Reproduktionsprozesses zurückschleudern, schafft also ohne vorherige Kapitalauslage neuen Kapitalstoff.	ch24_clean.en-ch24_clean.de
Like the increased exploitation of natural wealth resulting from the simple act of increasing the pressure under which labour-power has to operate, science and technology give capital a power of expansion which is independent of the given magnitude of the capital actually functioning.	Gleich vermehrter Ausbeutung des Naturreichtums durch bloß höhere Spannung der Arbeitskraft, bilden Wissenschaft und Technik eine von der gegebnen Größe des funktionierenden Kapitals unabhängige Potenz seiner Expansion.	ch24_clean.en-ch24_clean.de
They react at the same time on that part of the original capital which has entered the stage of its renewal.	Sie reagiert zugleich auf den in sein Erneuerungsstadium eingetretenen Teil des Originalkapitals.	ch24_clean.en-ch24_clean.de
This, in passing into its new shape, incorporates, free of charge, the social advances made while its old shape was being used up.	In seine neue Form einverleibt es gratis den hinter dem Rücken seiner alten Form vollzogenen gesellschaftlichen Fortschritt.	ch24_clean.en-ch24_clean.de
Of course, this development of productivity is accompanied by a partial depreciation of the functioning capital; but in so far as this depreciation makes itself acutely felt in competition, the main burden falls on the worker, in whose increased exploitation the capitalist seeks compensation for his loss.	Allerdings ist diese Entwicklung der Produktivkraft zugleich begleitet von teilweiser Depreziation funktionierender Kapitale. Soweit diese Depreziation sich durch die Konkurrenz akut fühlbar macht, fällt die Hauptwucht auf den Arbeiter, in dessen gesteigerter Exploitation der Kapitalist Schadenersatz sucht.	ch24_clean.en-ch24_clean.de
Labour transmits to the product the value of the means of production consumed by it.	Die Arbeit überträgt auf das Produkt den Wert der von ihr konsumierten Produktionsmittel.	ch24_clean.en-ch24_clean.de
On the other hand, the value and mass of the means of production set in motion by a given quantity of labour increase as the labour becomes more productive.	Andrerseits wächst Wert und Masse der durch gegebne Arbeitsmenge in Bewegung gesetzten Produktionsmittel im Verhältnis, wie die Arbeit produktiver wird.	ch24_clean.en-ch24_clean.de
Although the same quantity of labour adds to its products only the same sum of new value, the old capital-value, transmitted by the labour to the products, nevertheless continues to increase in line with the growth in productivity.	Setzt also auch dieselbe Arbeitsmenge ihren Produkten immer nur dieselbe Summe Neuwert zu, so wächst doch der alte Kapitalwert, den sie ihnen gleichzeitig überträgt, mit steigender Produktivität der Arbeit.	ch24_clean.en-ch24_clean.de
An English spinner and a Chinese spinner, for example, may work the same number of hours with the same intensity; they will then both create equal values in the course of a week.	Ein englischer und ein chinesischer Spinner z.B. mögen dieselbe Stundenzahl mit derselben Intensität arbeiten, so werden beide in einer Woche gleiche Werte erzeugen.	ch24_clean.en-ch24_clean.de
But in spite of this equality, an immense difference exists between the value of the weekly product of the Englishman, who works with a mighty automatic machine, and that of the Chinese, who only has a spinning-wheel.	Trotz dieser Gleichheit besteht ein ungeheurer Unterschied zwischen dem Wert des Wochenprodukts des Engländers, der mit einem gewaltigen Automaten arbeitet, und des Chinesen, der nur ein Spinnrad hat.	ch24_clean.en-ch24_clean.de
In the same time as the Chinese spins one pound of cotton, the Englishman spins several hundreds of pounds.	In derselben Zeit, wo der Chinese ein Pfund Baumwolle, verspinnt der Engländer mehrere hundert Pfund.	ch24_clean.en-ch24_clean.de
A sum of old values, many hundred times as great, swells the value of his product, for in that product the old values re-appear in a new useful form, and can thus function anew as capital.	Eine um mehrere hundert Mal größere Summe alter Werte schwellt den Wert seines Produkts an, in welchem sie in neuer nutzbarer Form erhalten werden und so von neuem als Kapital funktionieren können.	ch24_clean.en-ch24_clean.de
‘In 1782,’ as Friedrich Engels informs us, ‘the whole wool crop of the preceding three years’ (in England) ‘lay unused for want of workers, and would have continued so to lie if the newly invented machinery had not come to its assistance and spun it.’	"1782", belehrt uns F. Engels, "lag die ganze Wollernte der vorhergehenden drei Jahre" (in England) "aus Mangel an Arbeitern noch unverarbeitet da und hätte liegenbleiben müssen, wenn nicht die neuerfundne Maschinerie zu Hilfe gekommen wäre und sie versponnen hätte."	ch24_clean.en-ch24_clean.de
The labour which was objectified in the form of machinery did not of course directly cause men to spring out of the earth, but it made it possible for a smaller number of workers, adding relatively less living labour, not only to consume the wool productively, and put into it new value, but also to preserve its old value, in the form of yarn, etc.	Die in der Form von Maschinerie vergegenständlichte Arbeit stampfte natürlich unmittelbar keinen Menschen aus dem Boden, aber sie erlaubte einer geringen Arbeiteranzahl durch Zusatz von relativ wenig lebendiger Arbeit nicht nur die Wolle produktiv zu konsumieren und ihr Neuwert zuzusetzen, sondern in der Form von Garn usw. ihren alten Wert zu erhalten.	ch24_clean.en-ch24_clean.de
At the same time, it provided the means and the incentive for an increased reproduction of wool.	Sie lieferte damit zugleich Mittel und Sporn zur erweiterten Reproduktion von Wolle.	ch24_clean.en-ch24_clean.de
It is the natural property of living labour to keep old value in existence while it creates new.	Es ist die Naturgabe der lebendigen Arbeit, alten Wert zu erhalten, während sie Neuwert schafft.	ch24_clean.en-ch24_clean.de
Hence, with the increase in efficacy, extent and value of its means of production and therefore with the accumulation which accompanies the development of its productivity, labour maintains and perpetuates an always increasing capital-value in an ever-renewed form.	Mit dem Wachstum von Wirksamkeit, Umfang und Wert ihrer Produktionsmittel, also mit der die Entwicklung ihrer Produktivkraft begleitenden Akkumulation erhält und verewigt die Arbeit daher in stets neuer Form einen stets schwellenden Kapitalwert.	ch24_clean.en-ch24_clean.de
This natural power of labour appears as a power incorporated into capital for the latter’s own self-preservation, just as the productive forces of social labour appear as inherent characteristics of capital, and just as the constant appropriation of surplus labour by the capitalists appears as the constant self-valorization of capital.	Diese Naturkraft der Arbeit erscheint als Selbsterhaltungskraft des Kapitals, dem sie einverleibt ist, ganz wie ihre gesellschaftlichen Produktivkräfte als seine Eigenschaften, und wie die beständige Aneignung der Mehrarbeit durch den Kapitalisten als beständige Selbstverwertung des Kapitals.	ch24_clean.en-ch24_clean.de
All the powers of labour project themselves as powers of capital, just as all the value-forms of the commodity do as forms of money.	Alle Kräfte der Arbeit projektieren sich als Kräfte des Kapitals, wie alle Wertformen der Ware als Formen des Geldes.	ch24_clean.en-ch24_clean.de
With the growth of capital, the difference between the capital employed and the capital consumed increases.	Mit dem Wachstum des Kapitals wächst die Differenz zwischen angewandtem und konsumiertem Kapital.	ch24_clean.en-ch24_clean.de
In other words, there is an increase in the value and the material mass of the instruments of labour, such as buildings, machinery, drain-pipes, ploughing oxen, apparatus of every kind that functions for a longer or shorter time in constantly repeated processes of production, or serves for the attainment of particular useful effects, while the instruments of labour themselves only gradually wear out, therefore only lose their value piecemeal, and transfer that value to the product only bit by bit.	In andren Worten: Es wächst die Wert- und Stoffmasse der Arbeitsmittel, wie Baulichkeiten, Maschinerie, Drainierungsröhren, Arbeitsvieh, Apparate jeder Art, die während längerer oder kürzerer Perioden, in beständig wiederholten Produktionsprozessen, ihrem ganzen Umfang nach funktionieren oder zur Erzielung bestimmter Nutzeffekte dienen, während sie nur allmählich verschleißen, daher ihren Wert nur stückweis verlieren, also auch nur stückweis auf das Produkt übertragen.	ch24_clean.en-ch24_clean.de
In the same proportion as these instruments of labour serve as agencies in the formation of products without adding value to those products, i.e. in the same proportion as they are wholly employed but only partly consumed, to that degree do they perform, as we saw earlier, the same free service as the forces of nature, such as water, steam, air and electricity. This free service of past labour, when it is seized on and filled with vitality by living labour, accumulates progressively as accumulation takes place on a larger and larger scale.	Im Verhältnis, worin diese Arbeitsmittel als Produktbildner dienen, ohne dem Produkt Wert zuzusetzen, also ganz angewandt, aber nur teilweis konsumiert werden, leisten sie, wie früher erwähnt, denselben Gratisdienst wie Naturkräfte, Wasser, Dampf, Luft, Elektrizität usw. Dieser Gratisdienst der vergangnen Arbeit, wenn ergriffen und beseelt von der lebendigen Arbeit, akkumuliert mit der wachsenden Stufenleiter der Akkumulation.	ch24_clean.en-ch24_clean.de
Since past labour always disguises itself as capital, i.e. since the debts owed to the labour of A, B, C etc. are disguised as the assets of the non-worker X, bourgeois citizens and political economists are full of praise for the services performed by past labour, which, according to that Scottish genius MacCulloch, ought indeed to receive a special remuneration in the shape of interest, profit, etc.	Da die vergangne Arbeit sich stets in Kapital verkleidet, d.h. das Passivum der Arbeit von A, B, C usw. in das Aktivum des Nichtarbeiters X, sind Bürger und politische Ökonomen voll des Lobes für die Verdienste der vergangnen Arbeit, welche nach dem schottischen Genie MacCulloch sogar einen eignen Sold (Zins, Profit usw.) beziehn muß.	ch24_clean.en-ch24_clean.de
The ever-growing weight of the assistance given by past labour to the living labour process in the form of means of production is therefore attributed to that form of past labour in which it is alienated [entfremdet], as unpaid labour, from the worker himself, i.e. it is attributed to its form as capital.	Das stets wachsende Gewicht der im lebendigen Arbeitsprozeß unter der Form von Produktionsmitteln mitwirkenden vergangnen Arbeit wird also ihrer dem Arbeiter selbst, dessen vergangne und unbezahlte Arbeit sie ist, entfremdeten Gestalt zugeschrieben, ihrer Kapitalgestalt.	ch24_clean.en-ch24_clean.de
The practical agents of capitalist production and their ideological word-spinners are as incapable of thinking of the means of production separately from the antagonistic social mask they wear at present as a slaveowner is of thinking of the worker himself as distinct from his character as a slave.	Die praktischen Agenten der kapitalistischen Produktion und ihre ideologischen Zungendrescher sind ebenso unfähig, das Produktionsmittel von der antagonistischen gesellschaftlichen Charaktermaske, die ihm heutzutag anklebt, getrennt zu denken, als ein Sklavenhalter den Arbeiter selbst von seinem Charakter als Sklave.	ch24_clean.en-ch24_clean.de
With a given degree of exploitation of labour-power, the mass of surplus-value produced is determined by the number of workers simultaneously exploited; this corresponds, although in varying proportions, with the magnitude of the capital.	Bei gegebnem Exploitationsgrad der Arbeitskraft ist die Masse des Mehrwerts bestimmt durch die Anzahl der gleichzeitig ausgebeuteten Arbeiter, und diese entspricht, obgleich in wechselndem Verhältnis, der Größe des Kapitals.	ch24_clean.en-ch24_clean.de
Thus the more that capital increases by means of successive accumulations, the more does the sum of value increase that is divided into a fund for consumption and a fund for accumulation.	Je mehr also das Kapital vermittelst sukzessiver Akkumulationen wächst, desto mehr wächst auch die Wertsumme, die sich in Konsumtionsfonds und Akkumulationsfonds spaltet.	ch24_clean.en-ch24_clean.de
The capitalist can therefore live a more pleasant life, and at the same time ‘renounce’ more.	Der Kapitalist kann daher flotter leben und zugleich mehr "entsagen".	ch24_clean.en-ch24_clean.de
And, finally, the more the scale of production extends, along with the mass of the capital advanced, the greater the expansive capacity of its driving forces.	Und schließlich spielen alle Springfedern der Produktion um so energischer, je mehr ihre Stufenleiter sich erweitert mit der Masse des vorgeschossenen Kapitals.	ch24_clean.en-ch24_clean.de
5. THE SO-CALLED LABOUR FUND It has been shown in the course of this inquiry that capital is not a fixed magnitude, but a part of social wealth which is elastic, and constantly fluctuates with the division of surplus-value into revenue and additional capital.	5. Der sogenannte Arbeitsfonds Es ergab sich im Verlauf dieser Untersuchung, daß das Kapital keine fixe Größe ist, sondern ein elastischer und mit der Teilung des Mehrwerts in Revenue und Zusatzkapital beständig fluktuierender Teil des gesellschaftlichen Reichtums.	ch24_clean.en-ch24_clean.de
It has been seen further that, even with a given magnitude of functioning capital, the labour-power, science and land (which means, economically speaking, all the objects of labour furnished by nature without human intervention) incorporated in it form elastic powers of capital, allowing it, within certain limits, a field of action independent of its own magnitude.	Man sah ferner, daß selbst bei gegebner Größe des funktionierenden Kapitals die ihm einverleibte Arbeitskraft, Wissenschaft und Erde (worunter ökonomisch alle ohne Zutat des Menschen von Natur vorhandnen Arbeitsgegenstände zu verstehn sind) elastische Potenzen desselben bilden, die ihm innerhalb gewisser Grenzen einen von seiner eignen Größe unabhängigen Spielraum gestatten.	ch24_clean.en-ch24_clean.de
In this inquiry we have ignored all relations arising from the process of circulation, which may produce very different degrees of efficiency in the same mass of capital.	Es wurde dabei von allen Verhältnissen des Zirkulationsprozesses abgesehn, die sehr verschiedne Wirkungsgrade derselben Kapitalmasse verursachen.	ch24_clean.en-ch24_clean.de
And since we presupposed the limits set by capitalist production, i.e. we presupposed the social process of production in a form developed by purely spontaneous growth, we disregarded any more rational combination which could be effected directly and in a planned way with the means of production and the labour-power at present available.	Es wurde, da wir die Schranken der kapitalistischen Produktion voraussetzen, also eine rein naturwüchsige Gestalt des gesellschaftlichen Produktionsprozesses, abgesehn von jeder mit den vorhandnen Produktionsmitteln und Arbeitskräften unmittelbar und planmäßig bewirkbaren rationelleren Kombination.	ch24_clean.en-ch24_clean.de
Classical political economy has always liked to conceive social capital as a fixed magnitude of a fixed degree of efficiency.	Die klassische Ökonomie liebte es von jeher, das gesellschaftliche Kapital als eine fixe Größe von fixem Wirkungsgrad aufzufassen.	ch24_clean.en-ch24_clean.de
But this prejudice was first established as a dogma by the arch-philistine, Jeremy Bentham, that soberly pedantic and heavy-footed oracle of the ‘common sense’ of the nineteenth-century bourgeoisie.	Aber das Vorurteil ward erst zum Dogma befestigt durch den Urphilister Jeremias Bentham, dies nüchtern pedantische, schwatzlederne Orakel des gemeinen Bürgerverstandes des 19. Jahrhunderts.	ch24_clean.en-ch24_clean.de
Bentham is among philosophers what Martin Tupper* is among poets.	Bentham ist unter den Philosophen, was Martin Tupper unter den Dichtern.	ch24_clean.en-ch24_clean.de
Both could only have been manufactured in England.51This dogma in fact renders the commonest phenomena of the production process, for instance its sudden expansions and contractions, and even accumulation itself, absolutely incomprehensible.	Beide waren nur in England fabrizierbar. Mit seinem Dogma werden die gewöhnlichsten Erscheinungen des Produktionsprozesses, wie z.B. dessen plötzliche Expansionen und Kontraktionen, ja sogar die Akkumulation, völlig unbegreif- bar.	ch24_clean.en-ch24_clean.de
It was used by Bentham himself, as well as by Malthus, James Mill, MacCulloch, etc., for apologetic purposes, and in particular so as to represent one part of capital, namely variable capital, or that part convertible into labour-power, as being of fixed size.	Das Dogma wurde sowohl von Bentham selbst als von Malthus, James Mill, MacCulloch usw. zu apologetischen Zwecken vernutzt, namentlich um einen Teil des Kapitals, das variable oder in Arbeitskraft umsetzbare Kapital als eine fixe Größe darzustellen.	ch24_clean.en-ch24_clean.de
Variable capital in its material existence, i.e. the mass of the means of subsistence it represents for the worker, or the so-called labour fund, was turned by this fable into a separate part of social wealth, confined by natural chains and unable to cross the boundary to the other parts.	Die stoffliche Existenz des variablen Kapitals, d.h. die Masse der Lebensmittel, die es für den Arbeiter repräsentiert, oder der sog. Arbeitsfonds, wurde in einem durch Naturketten abgeringten und unüberschreitbaren Sonderteil des gesellschaftlichen Reichtums verfabelt.	ch24_clean.en-ch24_clean.de
To set in motion the part of social wealth which is to function as constant capital, or, to express it in a material form, as means of production, a definite mass of living labour is required.	Um den Teil des gesellschaftlichen Reichtums, der als konstantes Kapital oder, stofflich ausgedrückt, als Produktionsmittel funktionieren soll, in Bewegung zu setzen, ist eine bestimmte Masse lebendiger Arbeit erheischt.	ch24_clean.en-ch24_clean.de
This mass is given by technology.	Diese ist technologisch gegeben.	ch24_clean.en-ch24_clean.de
But the number of workers required to put this mass of labour-power in a fluid state is not given, for it changes with the degree of exploitation of the individual labour-power. Nor is the price of this labour-power given, but only its minimum limit, which is moreover very elastic.	Aber weder ist die Anzahl der Arbeiter gegeben, erheischt, um diese Arbeitsmasse flüssig zu machen, denn das wechselt mit dem Exploitationsgrad der individuellen Arbeitskraft, noch der Preis dieser Arbeitskraft, sondern nur seine zudem sehr elastische Minimalschranke.	ch24_clean.en-ch24_clean.de
The facts on which the dogma is based are these: on the one hand, the worker has no right to interfere in the division of social wealth into means of enjoyment for the non-worker and means of production.	Die Tatsachen, die dem Dogma zu Grund liegen, sind die: Einerseits hat der Arbeiter nicht mitzusprechen bei der Teilung des gesellschaftlichen Reichtums in Genußmittel der Nichtarbeiter und in Produktionsmittel.	ch24_clean.en-ch24_clean.de
On the other hand, it is only in favourable and exceptional cases that he can enlarge the so-called ‘labour fund’ at the expense of the ‘revenue’ of the rich.	Andrerseits kann er nur in günstigen Ausnahmsfällen den sog. "Arbeitsfonds" auf Kosten der "Revenue" des Reichen erweitern.	ch24_clean.en-ch24_clean.de
How absurd a tautology results from the attempt to represent the capitalist limits of the labour fund as social barriers imposed by its very nature may be seen, for example, in Professor Fawcett.54‘The circulating capital of a country,’ he says, ‘is its wage-fund.	Zu welch abgeschmackter Tautologie es führt, die kapitalistische Schranke des Arbeitsfonds in seine gesellschaftliche Naturschranke umzudichten, zeige u.a. Professor Fawcett: "Das zirkulierende Kapital eines Landes", sagt er, "ist sein Arbeitsfonds.	ch24_clean.en-ch24_clean.de
Hence, if we desire to calculate the average money wages received by each labourer, we have simply to divide the amount of this capital by the number of the labouring population.’	Um daher den durchschnittlichen Geldlohn, den jeder Arbeiter erhält, zu berechnen, haben wir nur einfach dies Kapital durch die Anzahl der Arbeiterbevölkerung zu dividieren."	ch24_clean.en-ch24_clean.de
That is to say, we first add together the individual wages actually paid, and then we assert that the sum thus obtained forms the total value of the ‘labour fund’ handed down to us by the grace of God and Nature.	D.h. also, erst rechnen wir die wirklich gezahlten individuellen Arbeitslöhne in eine Summe zusammen, dann behaupten wir, daß diese Addition die Wertsumme des von Gott und Natur oktroyierten "Arbeitsfonds" bildet.	ch24_clean.en-ch24_clean.de
Lastly, we divide the sum thus obtained by the number of workers, in order to find out how much each is permitted to receive on the average.	Endlich dividieren wir die so erhaltne Summe durch die Kopfzahl der Arbeiter, um hinwiederum zu entdecken, wieviel jedem Arbeiter individuell im Durchschnitt zufallen kann.	ch24_clean.en-ch24_clean.de
A very shrewd way of proceeding, this is.	Eine ungemein pfiffige Prozedur dies.	ch24_clean.en-ch24_clean.de
It does not prevent Mr Fawcett from saying, in the same breath: ‘The aggregate wealth which is annually saved in England, is divided into two portions; one portion is employed as capital to maintain our industry, and the other portion is exported to foreign countries… Only a portion, and perhaps, not a large portion of the wealth which is annually saved in this country, is invested in our own industry.’	Sie verhindert Herrn Fawcett nicht, im selben Atemzug zu sagen: "Der in England jährlich akkumulierte Gesamtreichtum wird in zwei Teile geteilt. Ein Teil wird in England zur Erhaltung unsrer eignen Industrie verwandt. Ein andrer Teil wird in andre Länder exportiert ... Der in unsrer Industrie angewandte Teil bildet keine bedeutende Portion des jährlich in diesem Land akkumulierten Reichtums."	ch24_clean.en-ch24_clean.de
The greater part of the yearly accruing surplus product, which is embezzled from the English workers without any equivalent being given in return, is thus used as capital, not in England, but in foreign countries.	Der größere Teil des jährlich zuwachsenden Mehrprodukts, dem englischen Arbeiter ohne Äquivalent entwandt, wird also nicht in England, sondern in fremden Länder verkapitalisiert.	ch24_clean.en-ch24_clean.de
But with the additional capital thus exported, a part of the ‘labour fund’ invented by God and Bentham naturally also flows out of the country.57	Aber mit dem so exportierten Zusatzkapital wird ja auch ein Teil des von Gott und Bentham erfundnen "Arbeitsfonds" exportiert.	ch24_clean.en-ch24_clean.de

