Chapter 26: The Secret of Primitive Accumulation We have seen how money is transformed into capital; how surplus-value is made through capital, and how more capital is made from surplus-value.	VIERUNDZWANZIGSTES KAPITEL Die sogenannte ursprüngliche Akkumulation 1. Das Geheimnis der ursprünglichen Akkumulation Man hat gesehn, wie Geld in Kapital verwandelt, durch Kapital Mehrwert und aus Mehrwert mehr Kapital gemacht wird.	ch26_clean.en-ch26_clean.de
But the accumulation of capital presupposes surplus-value; surplus-value presuppersis capitalist production; capitalist production presupposes the availability of considerable masses of capital and labour-power in the hands of commodity producers.	Indes setzt die Akkumulation des Kapitals den Mehrwert, der Mehrwert die kapitalistische Produktion, dieser aber das Vorhandensein größerer Massen von Kapital und Arbeitskraft in den Händen von Warenproduzenten voraus.	ch26_clean.en-ch26_clean.de
The whole movement, therefore, seems to turn around in a never-ending circle, which we can only get out of by assuming a primitive accumulation (the ‘previous accumulation’ of Adam Smith*) which precedes capitalist accumulation; an accumulation which is not the result of the capitalist mode of production but its point of departure.	Diese ganze Bewegung scheint sich also in einem fehlerhaften Kreislauf herumzudrehn, aus dem wir nur hinauskommen, indem wir eine der kapitalistischen Akkumulation vorausgehende "ursprüngliche" Akkumulation ("previous accumulation" bei Adam Smith) unterstellen, eine Akkumulation, welche nicht das Resultat der kapitalistischen Produktionsweise ist, sondern ihr Ausgangspunkt.	ch26_clean.en-ch26_clean.de
This primitive accumulation plays approximately the same role in political economy as original sin does in theology.	Diese ursprüngliche Akkumulation spielt in der politischen Ökonomie ungefähr dieselbe Rolle wie der Sündenfall in der Theologie.	ch26_clean.en-ch26_clean.de
Adam bit the apple, and thereupon sin fell on the human race.	Adam biß in den Apfel, und damit kam über das Menschengeschlecht die Sünde.	ch26_clean.en-ch26_clean.de
Its origin is supposed to be explained when it is told as an anecdote about the past.	Ihr Ursprung wird erklärt, indem er als Anekdote der Vergangenheit erzählt wird.	ch26_clean.en-ch26_clean.de
Long, long ago there were two sorts of people; one, the diligent, intelligent and above all frugal élite; the other, lazy rascals, spending their substance, and more, in riotous living.	In einer längst verfloßnen Zeit gab es auf der einen Seite eine fleißige, intelligente und vor allem sparsame Elite und auf der andren faulenzende, ihr alles und mehr verjubelnde Lumpen.	ch26_clean.en-ch26_clean.de
The legend of theological original sin tells us certainly how man came to be condemned to eat his bread in the sweat of his brow; but the history of economic original sin reveals to us that there are people to whom this is by no means essential.	Die Legende vom theologischen Sündenfall erzählt uns allerdings, wie der Mensch dazu verdammt worden sei, sein Brot im Schweiß seines Angesichts zu essen; die Historie vom ökonomischen Sündenfall aber enthüllt uns, wieso es Leute gibt, die das keineswegs nötig haben.	ch26_clean.en-ch26_clean.de
Never mind!	Einerlei.	ch26_clean.en-ch26_clean.de
Thus it came to pass that the former sort accumulated wealth, and the latter sort finally had nothing to sell except their own skins.	So kam es, daß die ersten Reichtum akkumulierten und die letztren schließlich nichts zu verkaufen hatten als ihre eigne Haut.	ch26_clean.en-ch26_clean.de
And from this original sin dates the poverty of the great majority who, despite all their labour, have up to now nothing to sell but themselves, and the wealth of the few that increases constantly, although they have long ceased to work.	Und von diesem Sündenfall datiert die Armut der großen Masse, die immer noch, aller Arbeit zum Trotz, nichts zu verkaufen hat als sich selbst, und der Reichtum der wenigen, der fortwährend wächst, obgleich sie längst aufgehört haben zu arbeiten.	ch26_clean.en-ch26_clean.de
Such insipid childishness is every day preached to us in the defence of property. M. Thiers, for example, still repeats it with all the solemnity of a statesman to the French people, who were once so full of wit and ingenuity.	Solche fade Kinderei kaut Herr Thiers z.B. noch mit staatsfeierlichem Ernst, zur Verteidigung der propriété <des Eigentums>, den einst so geistreichen Franzosen vor.	ch26_clean.en-ch26_clean.de
But as soon as the question of property is at stake, it becomes a sacred duty to proclaim the standpoint of the nursery tale as the one thing fit for all age-groups and all stages of development.	Aber sobald die Eigentumsfrage ins Spiel kommt, wird es heilige Pflicht, den Standpunkt der Kinderfibel als den allen Altersklassen und Entwicklungsstufen allein gerechten festzuhalten.	ch26_clean.en-ch26_clean.de
In actual history, it is a notorious fact that conquest, enslavement, robbery, murder, in short, force, play the greatest part.	In der wirklichen Geschichte spielen bekanntlich Eroberung, Unterjochung, Raubmord, kurz Gewalt die große Rolle.	ch26_clean.en-ch26_clean.de
In the tender annals of political economy, the idyllic reigns from time immemorial.	In der sanften politischen Ökonomie herrschte von jeher die Idylle.	ch26_clean.en-ch26_clean.de
Right and ‘labour’ were from the beginning of time the sole means of enrichment, ‘this year’ of course always excepted.	Recht und "Arbeit" waren von jeher die einzigen Bereicherungsmittel, natürlich mit jedesmaliger Ausnahme von "diesem Jahr".	ch26_clean.en-ch26_clean.de
As a matter of fact, the methods of primitive accumulation are anything but idyllic.	In der Tat sind die Methoden der ursprünglichen Akkumulation alles andre, nur nicht idyllisch.	ch26_clean.en-ch26_clean.de
In themselves, money and commodities are no more capital than the means of production and subsistence are.	Geld und Ware sind nicht von vornherein Kapital, sowenig wie Produktions- und Lebensmittel.	ch26_clean.en-ch26_clean.de
They need to be transformed into capital.	Sie bedürfen der Verwandlung in Kapital.	ch26_clean.en-ch26_clean.de
But this transformation can itself only take place under particular circumstances, which meet together at this point: the confrontation of, and the contact between, two very different kinds of commodity owners; on the one hand, the owners of money, means of production, means of subsistence, who are eager to valorize the sum of values they have appropriated by buying the labour-power of others; on the other hand, free workers, the sellers of their own labour-power, and therefore the sellers of labour.	Diese Verwandlung selbst aber kann nur unter bestimmten Umständen vorgehn, die sich dahin zusammenspitzen: Zweierlei sehr verschiedne Sorten von Warenbesitzern müssen sich gegenüber und in Kontakt treten, einerseits Eigner von Geld, Produktions- und Lebensmitteln, denen es gilt, die von ihnen geeignete Wertsumme zu verwerten durch Ankauf fremder Arbeitskraft; andrerseits freie Arbeiter, Verkäufer der eignen Arbeitskraft und daher Verkäufer von Arbeit.	ch26_clean.en-ch26_clean.de
Free workers, in the double sense that they neither form part of the means of production themselves, as would be the case with slaves, serfs, etc., nor do they own the means of production, as would be the case with self-employed peasant proprietors.	Freie Arbeiter in dem Doppelsinn, daß weder sie selbst unmittelbar zu den Produktionsmitteln gehören, wie Sklaven, Leibeigne usw., noch auch die Produktionsmittel ihnen gehören, wie beim selbstwirtschaftenden Bauer usw., sie davon vielmehr frei, los und ledig sind.	ch26_clean.en-ch26_clean.de
The free workers are therefore free from, unencumbered by, any means of production of their own.	Mit dieser Polarisation des Warenmarkts sind die Grundbedingungen der kapitalistischen Produktion gegeben.	ch26_clean.en-ch26_clean.de
With the polarization of the commodity-market into these two classes, the fundamental conditions of capitalist production are present.		ch26_clean.en-ch26_clean.de
The capital-relation presupposes a complete separation between the workers and the ownership of the conditions for the realization of their labour.	Das Kapitalverhältnis setzt die Scheidung zwischen den Arbeitern und dem Eigentum an den Verwirklichungsbedingungen der Arbeit voraus.	ch26_clean.en-ch26_clean.de
As soon as capitalist production stands on its own feet, it not only maintains this separation, but reproduces it on a constantly extending scale.	Sobald die kapitalistische Produktion einmal auf eignen Füßen steht, erhält sie nicht nur jene Scheidung, sondern reproduziert sie auf stets wachsender Stufenleiter.	ch26_clean.en-ch26_clean.de
The process, therefore, which creates the capital-relation can be nothing other than the process which divorces the worker from the ownership of the conditions of his own labour; it is a process which operates two transformations, whereby the social means of subsistence and production are turned into capital, and the immediate producers are turned into wage-labourers.	Der Prozeß, der das Kapitalverhältnis schafft, kann also nichts andres sein als der Scheidungsprozeß des Arbeiters vom Eigentum an seinen Arbeitsbedingungen, ein Prozeß, der einerseits die gesellschaftlichen Lebens- und Produktionsmittel in Kapital verwandelt, andrerseits die unmittelbaren Produzenten in Lohnarbeiter.	ch26_clean.en-ch26_clean.de
So-called primitive accumulation, therefore, is nothing else than the historical process of divorcing the producer from the means of production.	Die sog. ursprüngliche Akkumulation ist also nichts als der historische Scheidungsprozeß von Produzent und Produktionsmittel.	ch26_clean.en-ch26_clean.de
It appears as ‘primitive’ because it forms the pre-history of capital, and of the mode of production corresponding to capital.	Er erscheint als "ursprünglich", weil er die Vorgeschichte des Kapitals und der ihm entsprechenden Produktionsweise bildet.	ch26_clean.en-ch26_clean.de
The economic structure of capitalist society has grown out of the economic structure of feudal society.	Die ökonomische Struktur der kapitalistischen Gesellschaft ist hervorgegangen aus der ökonomischen Struktur der feudalen Gesellschaft.	ch26_clean.en-ch26_clean.de
The dissolution of the latter set free the elements of the former.	Die Auflösung dieser hat die Elemente jener freigesetzt.	ch26_clean.en-ch26_clean.de
The immediate producer, the worker, could dispose of his own person only after he had ceased to be bound to the soil, and ceased to be the slave or serf of another person.	Der unmittelbare Produzent, der Arbeiter, konnte erst dann über seine Person verfügen, nachdem er aufgehört hatte, an die Scholle gefesselt und einer andern Person leibeigen oder hörig zu sein.	ch26_clean.en-ch26_clean.de
To become a free seller of labour-power, who carries his commodity wherever he can find a market for it, he must further have escaped from the regime of the guilds, their rules for apprentices and journeymen, and their restrictive labour regulations.	Um freier Verkäufer von Arbeitskraft zu werden, der seine Ware überall hinträgt, wo sie einen Markt findet, mußte er ferner der Herrschaft der Zünfte, ihren Lehrlings- und Gesellenordnungen und hemmenden Arbeitsvorschriften entronnen sein.	ch26_clean.en-ch26_clean.de
Hence the historical movement which changes the producers into wage-labourers appears, on the one hand, as their emancipation from serfdom and from the fetters of the guilds, and it is this aspect of the movement which alone exists for our bourgeois historians.	Somit erscheint die geschichtliche Bewegung, die die Produzenten in Lohnarbeiter verwandelt, einerseits als ihre Befreiung von Dienstbarkeit und Zunftzwang; und diese Seite allein existiert für unsre bürgerlichen Geschichtschreiber.	ch26_clean.en-ch26_clean.de
But, on the other hand, these newly freed men became sellers of themselves only after they had been robbed of all their own means of production, and all the guarantees of existence afforded by the old feudal arrangements.	Andrerseits aber werden diese Neubefreiten erst Verkäufer ihrer selbst, nachdem ihnen alle ihre Produktionsmittel und alle durch die alten feudalen Einrichtungen gebotnen Garantien ihrer Existenz geraubt sind.	ch26_clean.en-ch26_clean.de
And this history, the history of their expropriation, is written in the annals of mankind in letters of blood and fire.	Und die Geschichte dieser ihrer Expropriation ist in die Annalen der Menschheit eingeschrieben mit Zügen von Blut und Feuer.	ch26_clean.en-ch26_clean.de
The industrial capitalists, these new potentates, had on their part not only to displace the guild masters of handicrafts, but also the feudal lords, who were in possession of the sources of wealth.	Die industriellen Kapitalisten, diese neuen Potentaten, mußten ihrerseits nicht nur die zünftigen Handwerksmeister verdrängen, sondern auch die im Besitz der Reichtumsquellen befindlichen Feudalherren.	ch26_clean.en-ch26_clean.de
In this respect, the rise of the industrial capitalists appears as the fruit of a victorious struggle both against feudal power and its disgusting prerogatives, and against the guilds, and the fetters by which the latter restricted the free development of production and the free exploitation of man by man.	Von dieser Seite stellt sich ihr Emporkommen dar als Frucht eines siegreichen Kampfes gegen die Feudalmacht und ihre empörenden Vorrechte sowie gegen die Zünfte und die Fesseln, die diese der freien Entwicklung der Produktion und der freien Ausbeutung des Menschen durch den Menschen angelegt.	ch26_clean.en-ch26_clean.de
The knights of industry, however, only succeeded in supplanting the knights of the sword by making use of events in which they had played no part whatsoever.	Die Ritter von der Industrie brachten es jedoch nur fertig, die Ritter vom Degen zu verdrängen, dadurch, daß sie Ereignisse ausbeuteten, an denen sie ganz unschuldig waren.	ch26_clean.en-ch26_clean.de
They rose by means as base as those once used by the Roman freedman to make himself the master of his patronus.	Sie haben sich emporgeschwungen durch Mittel, ebenso gemein wie die, wodurch der römische Freigelassene sich einst zum Herrn seines patronus gemacht hat.	ch26_clean.en-ch26_clean.de
The starting-point of the development that gave rise both to the wage-labourer and to the capitalist was the enslavement of the worker.	Der Ausgangspunkt der Entwicklung, die sowohl den Lohnarbeiter wie den Kapitalisten erzeugt, war die Knechtschaft des Arbeiters.	ch26_clean.en-ch26_clean.de
The advance made consisted in a change in the form of this servitude, in the transformation of feudal exploitation into capitalist exploitation.	Der Fortgang bestand in einem Formwechsel dieser Knechtung, in der Verwandlung der feudalen in kapitalistische Exploitation.	ch26_clean.en-ch26_clean.de
To understand the course taken by this change, we do not need to go back very far at all.	Um ihren Gang zu verstehn, brauchen wir gar nicht so weit zurückzugreifen.	ch26_clean.en-ch26_clean.de
Although we come across the first sporadic traces of capitalist production as early as the fourteenth or fifteenth centuries in certain towns of the Mediterranean, the capitalist era dates from the sixteenth century.	Obgleich die ersten Anfänge kapitalistischer Produktion uns schon im 14. und 15. Jahrhundert in einigen Städten am Mittelmeer sporadisch entgegentreten, datiert die kapitalistische Ära erst vom 16. Jahrhundert.	ch26_clean.en-ch26_clean.de
Wherever it appears, the abolition of serfdom has long since been completed, and the most brilliant achievement of the Middle Ages, the existence of independent city-states, has already been on the wane for a considerable length of time.	Dort, wo sie auftritt, ist die Aufhebung der Leibeigenschaft längst vollbracht und der Glanzpunkt des Mittelalters, der Bestand souveräner Städte, seit geraumer Zeit im Erbleichen.	ch26_clean.en-ch26_clean.de
In the history of primitive accumulation, all revolutions are epoch-making that act as levers for the capitalist class in the course of its formation; but this is true above all for those moments when great masses of men are suddenly and forcibly torn from their means of subsistence, and hurled onto the labour-market as free, unprotected and rightless proletarians.	Historisch epochemachend in der Geschichte der ursprünglichen Akkumulation sind alle Umwälzungen, die der sich bildenden Kapitalistenklasse als Hebel dienen; vor allem aber die Momente, worin große Menschenmassen plötzlich und gewaltsam von ihren Subsistenzmitteln losgerissen und als vogelfreie Proletarier auf den Arbeitsmarkt geschleudert werden.	ch26_clean.en-ch26_clean.de
The expropriation of the agricultural producer, of the peasant, from the soil is the basis of the whole process.	Die Expropriation des ländlichen Produzenten, des Bauern, von Grund und Boden bildet die Grundlage des ganzen Prozesses.	ch26_clean.en-ch26_clean.de
The history of this expropriation assumes different aspects in different countries, and runs through its various phases in different orders of succession, and at different historical epochs.	Ihre Geschichte nimmt in verschiedenen Ländern verschiedene Färbung an und durchläuft die verschiedenen Phasen in verschiedener Reihenfolge und in verschiedenen Geschichtsepochen.	ch26_clean.en-ch26_clean.de
Only in England, which we therefore take as our example, has it the classic form.1	Nur in England, das wir daher als Beispiel nehmen, besitzt sie klassische Form.	ch26_clean.en-ch26_clean.de

