Chapter 27: The Expropriation of the Agricultural Population from the Land In England, serfdom had disappeared in practice by the last part of the fourteenth century.	2. Expropriation des Landvolks von Grund und Boden In England war die Leibeigenschaft im letzten Teil des 14. Jahrhunderts faktisch verschwunden.	ch27_clean.en-ch27_clean.de
The immense majority of the population consisted then, and to a still larger extent in the fifteenth century, of free peasant proprietors, however much the feudal trappings might disguise their absolute ownership.	Die ungeheure Mehrzahl der Bevölkerung bestand damals und noch mehr im 15. Jahrhundert aus freien, selbstwirtschaf- tenden Bauern, durch welch feudales Aushängeschild ihr Eigentum immer versteckt sein mochte.	ch27_clean.en-ch27_clean.de
In the larger seigniorial domains, the old bailiff, himself a serf, was displaced by the free farmer.	Auf den größeren herrschaftlichen Gütern war der früher selbst leibeigne bailiff (Vogt) durch den freien Pächter verdrängt.	ch27_clean.en-ch27_clean.de
The wage-labourers of agriculture were partly peasants, who made use of their leisure time by working on the large estates, and partly an independent, special class of wage-labourer, relatively and absolutely few in numbers.	Die Lohnarbeiter der Agrikultur bestanden teils aus Bauern, die ihre Mußezeit durch Arbeit bei großen Grundeigentümern verwerteten, teils aus einer selbständigen, relativ und absolut wenig zahlreichen Klasse eigentlicher Lohnarbeiter.	ch27_clean.en-ch27_clean.de
The latter were also in practice peasants, farming independently for themselves, since, in addition to their wages, they were provided with arable land to the extent of four or more acres, together with their cottages.	Auch letztre waren faktisch zugleich selbstwirtschaftende Bauern, indem sie außer ihrem Lohn Ackerland zum Belauf von 4 und mehr Acres nebst Cottages angewiesen erhielten.	ch27_clean.en-ch27_clean.de
Moreover, like the other peasants, they enjoyed the right to exploit the common land, which gave pasture to their cattle, and furnished them with timber, fire-wood, turf, etc.	Sie genossen zudem mit den eigentlichen Bauern die Nutznießung des Gemeindelandes, worauf ihr Vieh weidete und das ihnen zugleich die Mittel der Feuerung, Holz, Torf usw. bot.	ch27_clean.en-ch27_clean.de
In all countries of Europe, feudal production is characterized by division of the soil amongst the greatest possible number of sub-feudatories.	In allen Ländern Europas ist die feudale Produktion durch Teilung des Bodens unter möglichst viele Untersassen charakterisiert.	ch27_clean.en-ch27_clean.de
The might of the feudal lord, like that of the sovereign, depended not on the length of his rent-roll, but on the number of his subjects, and the latter depended on the number of peasant proprietors.	Die Macht des Feudalherrn, wie die jedes Souveräns, beruhte nicht auf der Länge seiner Rentrolle, sondern auf der Zahl seiner Untertanen, und letzre hing von der Zahl selbstwirtschaftender Bauern ab.	ch27_clean.en-ch27_clean.de
Thus although the soil of England, after the Norman conquest, was divided up into gigantic baronies, one of which often included some 900 of the old Anglo-Saxon lordships, it was strewn with small peasant properties, only interspersed here and there with great seigniorial domains.	Obgleich der englische Boden daher nach der normännischen Eroberung in riesenhafte Baronien verteilt ward, wovon eine einzige oft 900 alte angelsächsische Lordschaften einschloß, war er besät von kleinen Bauernwirtschaften, nur hier und da durchbrochen von größeren herrschaftlichen Gütern.	ch27_clean.en-ch27_clean.de
Such conditions, together with the urban prosperity so characteristic of the fifteenth century, permitted the development of that popular wealth Chancellor Fortescue depicted so eloquently in his De laudibus legum Angliae, but they ruled out wealth in the form of capital.	Solche Verhältnisse, bei gleichzeitiger Blüte des Städtewesens, wie sie das 15. Jahrhundert auszeichnet, erlaubten jenen Volksreichtum, den der Kanzler Fortescue so beredt in seinen "Laudibus Legum Angliae" schildert, aber sie schlossen den Kapitalreichtum aus.	ch27_clean.en-ch27_clean.de
The prelude to the revolution that laid the foundation of the capitalist mode of production was played out in the last third of the fifteenth century and the first few decades of the sixteenth.	Das Vorspiel der Umwälzung, welche die Grundlage der kapitalistischen Produktionsweise schuf, ereignet sich im letzten Dritteil des 15. und den ersten Dezennien des 16. Jahrhunderts.	ch27_clean.en-ch27_clean.de
A mass of ‘free’ and unattached proletarians was hurled onto the labour-market by the dissolution of the bands of feudal retainers, who, as Sir James Steuart correctly remarked, ‘everywhere uselessly filled house and castle’. * Although the royal power, itself a product of bourgeois development, forcibly hastened the dissolution of these bands of retainers in its striving for absolute sovereignty, it was by no means the sole cause of it.	Eine Masse vogelfreier Proletarier ward auf den Arbeitsmarkt geschleudert durch die Auflösung der feudalen Gefolgschaften, die, wie Sir James Steuart richtig bemerkt, "überall nutzlos Haus und Hof füllten". Obgleich die königliche Macht, selbst ein Produkt der bürgerlichen Entwicklung, in ihrem Streben nach absoluter Souveränität die Auflösung dieser Gefolgschaften gewaltsam beschleunigte, war sie keineswegs deren einzige Ursache.	ch27_clean.en-ch27_clean.de
It was rather that the great feudal lords, in their defiant opposition to the king and Parliament, created an incomparably larger proletariat by forcibly driving the peasantry from the land, to which the latter had the same feudal title as the lords themselves, and by usurpation of the common lands.	Vielmehr im trotzigsten Gegensatz zu Königtum und Parlament schuf der große Feudalherr ein ungleich größeres Proletariat durch gewaltsame Verjagung der Bauernschaft von dem Grund und Boden, worauf sie denselben feudalen Rechtstitel besaß wie er selbst, und durch Usurpation ihres Gemeindelandes.	ch27_clean.en-ch27_clean.de
The rapid expansion of wool manufacture in Flanders and the corresponding rise in the price of wool in England provided the direct impulse for these eevictions.	Den unmittelbaren Anstoß dazu gab in England namentlich das Aufblühn der flandrischen Wollmanufaktur und das entsprechende Steigen der Wollpreise.	ch27_clean.en-ch27_clean.de
The old nobility had been devoured by the great feudal wars. The new nobility was the child of its time, for which money was the power of all powers.	Den alten Feudaladel hatten die großen Feudalkriege verschlungen, der neue war ein Kind seiner Zeit, für welche Geld die Macht aller Mächte.	ch27_clean.en-ch27_clean.de
Transformation of arable land into sheep-walks was therefore its slogan.	Verwandlung von Ackerland in Schafweide ward also sein Lösungswort.	ch27_clean.en-ch27_clean.de
Harrison, in his Description of England, prefixed to Holinshed’s Chronicles, describes how the expropriation of small peasants is ruining the country.	Harrison, in seiner "Description of England. Prefxed to Holinshed's Chronicles", beschreibt, wie die Expropriation der kleinen Bauern das Land ruiniert.	ch27_clean.en-ch27_clean.de
‘What care our great incroachers?’	"What care our great incroachers!"	ch27_clean.en-ch27_clean.de
	(Was fragen unsre großen Usurpatoren danach?)	ch27_clean.en-ch27_clean.de
The dwellings of the peasants and the cottages of the labourers were razed to the ground or doomed to decay.	Die Wohnungen der Bauern und die Cottages der Arbeiter wurden gewaltsam niedergerissen oder dem Verfall geweiht.	ch27_clean.en-ch27_clean.de
‘If,’ says Harrison, ‘the old records of euerie manour be sought… it will soon appear that in some manour seventeene, eighteene, or twentie houses are shrunk… that England was never less furnished with people than at the present… Of cities and townes either utterly decaied or more than a quarter or half diminished, though some one be a little increased here or there; of townes pulled downe for sheepe-walks, and no more but the lordships now standing in them… I could saie somewhat.’* The complaints of these old chroniclers are always exaggerated, but they faithfully reflect the impression made on contemporaries by the revolution in the relations of production.	"Wenn man", sagt Harrison, "die älteren Inventarien jedes Ritterguts vergleichen will, so wird man finden, daß unzählige Häuser und kleine Bauernwirtschaften verschwunden sind, daß das Land viel weniger Leute nährt, daß viele Städte verfallen sind, obgleich einige neue aufblühn ... Von Städten und Dörfern, die man für Schaftriften zerstört hat und worin nur noch die Herrschaftshäuser stehn, könnte ich etwas erzählen." Die Klagen jener alten Chroniken sind immer übertrieben, aber sie zeichnen genau den Eindruck der Revolution in den Produktionsverhältnissen auf die Zeitgenossen selbst.	ch27_clean.en-ch27_clean.de
A comparison between the writings of Chancellor Fortescue and Thomas More reveals the gulf between the fifteenth and the sixteenth centuries.	Ein Vergleich zwischen den Schriften der Kanzler Fortescue und Thomas Morus veranschaulicht die Kluft zwischen dem 15. und 16. Jahrhundert.	ch27_clean.en-ch27_clean.de
As Thornton rightly says, the English working class was precipitated without any transitional stages from its golden age to its iron age.† Legislation shrunk back in the face of this immense change.	Aus ihrem goldnen Zeitalter, wie Thornton richtig sagt, stürzte die englische Arbeiterklasse ohne alle Zwischenübergänge in das eiserne. Die Gesetzgebung erschrak vor dieser Umwälzung.	ch27_clean.en-ch27_clean.de
It did not yet stand at that high level of civilization where the ‘wealth of the nation’ (i.e. the formation of capital and the reckless exploitation and impoverishment of the mass of the people) figures as the ultima Thule‡ of all statecraft.	Sie stand noch nicht auf der Zivilisationshöhe, wo "Wealth of the Nation" <"Reichtum der Nation">, d.h. Kapitalbildung und rücksichtslose Exploitation und Verarmung der Volksmasse als ultima Thule aller Staatsweisheit gelten.	ch27_clean.en-ch27_clean.de
In his history of Henry VII Bacon says this: ‘Inclosures at that time’ (1489) ‘began to be more frequent, whereby arable land, which could not be manured§ without people-and families, was turned into pasture, which was easily rid by a few herdsmen; and tenancies for years, lives, and at will, whereupon much of the yeomanry lived, were turned into demesnes.	In seiner Geschichte Heinrichs VII. sagt Baco: "Um diese Zeit" "mehrten sich die Klagen über Verwandlung von Ackerland in Weide" (zur Schaftrift usw.), "leicht zu versehn durch wenige Hirten; und Pachtungen auf Zeit, auf Lebzeit und auf jährliche Kündigung (wovon ein großer Teil der Yeomen lebte) wurden in Dominialgüter verwandelt.	ch27_clean.en-ch27_clean.de
This bred a decay of people, and, by consequence, a decay of towns, churches, tithes, and the like… In remedying of this inconvenience the king’s wisdom was admirable, and the parliament’s at that time… They took a course to take away depopulating inclosures, and depopulating pasturage.’* An Act of Henry VII, 1489, c.	Dies brachte einen Verfall des Volks hervor und infolgedessen einen Verfall von Städten, Kirchen, Zehnten ... In der Kur dieses Mißstandes war die Weisheit des Königs und des Parlaments zu dieser Zeit bewundernswert ... Sie ergriffen Maßregeln wider diese entvölkernde Usurpation der Gemeindeländereien (depopulating inclosures) und die ihr auf dem Fuß folgende entvölkernde Weidewirtschaft (depopulating pasture)."	ch27_clean.en-ch27_clean.de
19, forbade the destruction of all ‘houses of husbandry’ possessing 20 acres of land.	Ein Akt Heinrich des Siebenten, 1489, c. 19, verbot die Zerstörung aller Bauernhäuser, zu denen wenigstens 20 Acres Land gehörten.	ch27_clean.en-ch27_clean.de
By another Act, 25 Henry VIII [c. 13], this law was renewed.	In einem Akt 25, Heinrich VIII., wird dasselbe Gesetz erneuert.	ch27_clean.en-ch27_clean.de
It recites, among other things, that ‘many farms and large flocks of cattle, especially of sheep, are concentrated in the hands of a few men, whereby the rent of land has much risen, and tillage has fallen off, churches and houses have been pulled down, and marvellous numbers of people have been deprived of the means wherewith to maintain themselves and their families.’	Es heißt u.a., daß "viele Pachtungen und große Viehherden, besonders Schafe, sich in wenigen Händen aufhäufen, wodurch die Grundrenten sehr gewachsen und der Ackerbau (tillage) sehr verfallen, Kirchen und Häuser niedergerissen, wunderbare Volksmassen verunfähigt seien, sich selbst und Familien zu erhalten".	ch27_clean.en-ch27_clean.de
The Act therefore ordains the rebuilding of the decayed farmsteads, and fixes a proportion between corn land and pasture land, etc. The same Act recites that some owners possess 24, sheep, and limits the number to be owned to 2,000.	Das Gesetz verordnet daher den Wiederbau der verfallnen Hofstätten, bestimmt das Verhältnis zwischen Kornland und Weideland usw. Ein Akt von 1533 klagt, daß manche Eigentümer 24.000 Schafe besitzen, und beschränkt deren Zahl auf 2.000.	ch27_clean.en-ch27_clean.de
The cries of the people and the legislation directed, for 150 years after Henry VII, against the expropriation of the small farmers and peasants, were both equally fruitless.	Die Volksklage und die seit Heinrich dem VII. an 150 Jahre fortdauernde Gesetzgebung wider die Expropriation der kleinen Pächter und Bauern waren gleich fruchtlos.	ch27_clean.en-ch27_clean.de
Bacon, without knowing it, reveals to us the secret of their lack of success.	Das Geheimnis ihrer Erfolglosigkeit verrät uns Baco wider Wissen.	ch27_clean.en-ch27_clean.de
‘The device of King Henry VII,’ says Bacon, in the twenty-ninth of his Essays, Civil and Moral,’was profound and admirable, in making farms and houses of husbandry of a standard; that is, maintained with such a proportion of land unto them as may breed a subject to live in convenient plenty and no servile condition, and to keep the plough in the hands of the owners and not mere hirelings.’	"Der Akt Heinrichs des Siebenten", sagt er in seinen "Essays, civil and moral", Sect. 29, "war tief und bewunderungswürdig, indem er Landwirtschaften und Ackerbauhäuser von bestimmtem Normalmaß schuf, d.h. eine Proportion von Land für sie erhielt, die sie befähigte, Untertanen von genügendem Reichtum und ohne servile Lage auf die Welt zu setzen und den Pflug in der Hand von Eigentümern, nicht von Mietlingen zu halten (to keep the plough in the hand of the owners and not hirelings).	ch27_clean.en-ch27_clean.de
What the capitalist system demanded was the reverse of this: a degraded and almost servile condition of the mass of the people, their transformation into mercenaries, and the transformation of their means of labour into capital.	"(193a) Was das kapitalistische System erheischte, war umgekehrt servile Lage der Volksmasse, ihre eigne Verwandlung in Mietlinge und Verwandlung ihrer Arbeitsmittel in Kapital.	ch27_clean.en-ch27_clean.de
During this transitional period, legislation also strove to retain the four acres of land by the cottage of the agricultural wage-labourer, and forbade him to take lodgers into his cottage.	Während dieser Übergangsperiode suchte die Gesetzgebung auch die 4 Acres Land bei der Cottage des ländlichen Lohnarbeiters zu erhalten und verbot ihm die Aufnahme von Mietsleuten in seine Cottage.	ch27_clean.en-ch27_clean.de
In the reign of Charles I, in 1627, Roger Crocker of Fontmill was condemned for having built a cottage on the manor of Fontmill without four acres of land attached to the same in perpetuity. As late as 1638, in the same reign, a royal commission was appointed to enforce the implementation of the old laws, especially the law referring to the four acres of land.	Noch 1627, unter Karl I., wurde Roger Crocker von Fontmill verurteilt wegen Baus einer Cottage im Manor von Fontmill ohne 4 Acres Land als beständiges Annex an dieselbe; noch 1638, unter Karl I., wurde eine königliche Kommission ernannt, um die Durchführung der alten Gesetze, namentlich auch über die 4 Acres Land, zu erzwingen; noch Cromwell verbot Erbauung eines Hauses in 4 Meilen weitem Umkreis von London ohne Ausstattung desselben mit 4 Acres Land.	ch27_clean.en-ch27_clean.de
Even Cromwell forbade the building of a house within four miles of London unless it was endowed with four acres of land.	Noch in der ersten Hälfte des 18. Jahrhunderts wird geklagt, wenn die Cottage des Landarbeiters kein Zubehör von l bis 2 Acres hat.	ch27_clean.en-ch27_clean.de
As late as the first half of the eighteenth century, complaint is made if the cottage of the agricultural labourer does not possess an adjunct of one or two acres of land.		ch27_clean.en-ch27_clean.de
Nowadays the labourer is lucky if it is furnished with a small garden, or if he may rent a few roods of land at a great distance from his cottage.	Heutzutag ist er glücklich, wenn sie mit einem Gärtchen ausgestattet ist oder wenn er weitab von ihr ein Paar Ruten Land mieten kann.	ch27_clean.en-ch27_clean.de
‘Landlords and farmers,’ says Dr Hunter, ‘work here hand in hand.	"Grundherren und Pächter", sagt Dr. Hunter, "handeln hier Hand in. Hand.	ch27_clean.en-ch27_clean.de
A few acres to the cottage would make the labourers too independent.’	Wenige Acres zur Cottage würden den Arbeiter zu unabhängig machen."	ch27_clean.en-ch27_clean.de
The process of forcible expropriation of the people received a new and terrible impulse in the sixteenth century from the Reformation, and the consequent colossal spoliation of church property.	Einen neuen furchtbaren Anstoß erhielt der gewaltsame Expropriationsprozeß der Volksmasse im 16. Jahrhundert durch die Reformation und, in ihrem Gefolge, den kolossalen Diebstahl der Kirchengüter.	ch27_clean.en-ch27_clean.de
The Catholic church was, at the time of the Reformation, the feudal proprietor of a great part of the soil of England.	Die katholische Kirche war zur Zeit der Reformation Feudaleigentümerin eines großen Teils des englischen Grund und Bodens.	ch27_clean.en-ch27_clean.de
The dissolution of the monasteries, etc., hurled their inmates into the proletariat.	Die Unterdrückung der Klöster usw. schleuderte deren Einwohner ins Proletariat.	ch27_clean.en-ch27_clean.de
The estates of the church were to a large extent given away to rapacious royal favourites, or sold at a nominal price to speculating farmers and townsmen, who drove out the old-established hereditary sub-tenants in great numbers, and threw their holdings together.	Die Kirchengüter selbst wurden großenteils an raubsüchtige königliche Günstlinge verschenkt oder zu einem Spottpreis an spekulierende Pächter und Stadtbürger verkauft, welche die alten erblichen Untersassen massenhaft verjagten und ihre Wirtschaften zusammenwarfen.	ch27_clean.en-ch27_clean.de
The legally guaranteed property of the poorer folk in a part of the church’s tithes was quietly confiscated.7‘Pauper ubique jacet’* cried Queen Elizabeth, after a journey through England.	Das gesetzlich garantierte Eigentum verarmter Landleute an einem Teil der Kirchenzehnten ward stillschweigend konfisziert. "Pauper ubique jacet" <"der Arme ist überall unterjocht">, rief Königin Elisabeth nach einer Rundreise durch England.	ch27_clean.en-ch27_clean.de
In the forty-third year of her reign it finally proved necessary to recognize pauperism officially by the introduction of the poor-rate.	Im 43. Jahre ihrer Regierung war man endlich gezwungen, den Pauperismus offiziell anzuerkennen durch Einführung der Armensteuer.	ch27_clean.en-ch27_clean.de
‘The authors of this law seem to have been ashamed to state the grounds of it, for’ (contrary to traditional usage) ‘it has no preamble whatever.’	"Die Urheber dieses Gesetzes schämten sich, seine Gründe auszusprechen, und schickten es daher, wider alles Herkommen, ohne irgendein preamble (Eingangsmotivierung) in die Welt."	ch27_clean.en-ch27_clean.de
The poor-rate was declared perpetual by 16 Charles I, c.	Durch 16. Car.	ch27_clean.en-ch27_clean.de
4, and in fact only in 1834 did it take a new and severer form.	I., 4 <4. Gesetz aus dem 16. Regierungsjahr Karl I.> wurde es perpetuell erklärt und erhielt in der Tat erst 1834 eine neue härtere Form.	ch27_clean.en-ch27_clean.de
These immediate results of the Reformation were not its most lasting ones.	Diese unmittelbaren Wirkungen der Reformation waren nicht ihre nachhaltigsten.	ch27_clean.en-ch27_clean.de
The property of the church formed the religious bulwark of the old conditions of landed property.	Das Kircheneigentum bildete das religiöse Bollwerk der altertümlichen Grundeigentumsverhältnisse.	ch27_clean.en-ch27_clean.de
With its fall, these conditions could no longer maintain their existence.	Mit seinem Fall waren sie nicht länger haltbar.	ch27_clean.en-ch27_clean.de
Even in the last few decades of the seventeenth century, the yeomanry, the class of independent peasants, were more numerous than the class of farmers.	Noch in den letzten Dezennien des 17. Jahrhunderts war die Yeomanry, eine unabhängige Bauerschaft, zahlreicher als die Klasse der Pächter.	ch27_clean.en-ch27_clean.de
They had formed the backbone of Cromwell’s strength, and, on the admission of Macaulay himself, stood in favourable contrast to the drunken squires and their servants, the country clergy, who had to marry their masters’ cast-off mistresses.	Sie hatte die Hauptstärke Cromwells gebildet und stand, selbst nach Macaulays Geständnis, in vorteilhaftem Gegensatz zu den versoffen Mistjunkern und ihren Bedienten, den Landpfaffen, welche die herrschaftliche "Lieblingsmagd" unter die Haube bringen mußten.	ch27_clean.en-ch27_clean.de
	Noch waren selbst die ländlichen Lohnarbeiter Mitbesitzer am Gemeindeeigentum.	ch27_clean.en-ch27_clean.de
By about 1750 the yeomanry had disappeared, and so, by the last decade of the eighteenth century, had the last trace of the common land of the agricultural labourer.	1750 ungefähr war die Yeomanry verschwunden , und in den letzten Dezennien des 18. Jahr- hunderts die letzte Spur von Gemeindeeigentum der Ackerbauer.	ch27_clean.en-ch27_clean.de
We leave on one side here the purely economic driving forces behind the agricultural revolution.	Wir sehn hier ab von den rein ökonomischen Triebfedern der Agrikulturrevolution.	ch27_clean.en-ch27_clean.de
We deal only with the violent means employed.	Wir fragen nach ihren gewaltsamen Hebeln.	ch27_clean.en-ch27_clean.de
After the restoration of the Stuarts, the landed proprietors carried out, by legal means, an act of usurpation which was effected everywhere on the Continent without any legal formality.	Unter der Restauration der Stuarts setzten die Grundeigentümer eine Usurpation gesetzlich durch, die sich überall auf dem Kontinent auch ohne gesetzliche Weitläufigkeit vollzog.	ch27_clean.en-ch27_clean.de
They abolished the feudal tenure of land, i.e. they got rid of all its obligations to the state, ‘indemnified’ the state by imposing taxes on the peasantry and the rest of the people, established for themselves the rights of modern private property in estates to which they had only a feudal title, and, finally, passed those laws of settlement which had the same effect on the English agricultural labourer, mutatis mutandis, as the edict of the Tartar Boris Godunov had on the Russian peasantry. * The ‘glorious Revolution’ brought into power, along with William of Orange, the landed and capitalist profit-grubbers.	Sie hoben die Feudalverfassung des Bodens auf, d.h., sie schüttelten seine Leistungspflichten an den Staat ab, "entschädigten" den Staat durch Steuern auf die Bauerschaft und übrige Volksmasse, vindizierten modernes Privateigentum an Gütern, worauf sie nur Feudaltitel besaßen, und oktroyierten schließlich jene Niederlassungsgesetze (laws of settlement), die, mutatis mutandis, auf die englischen Ackerbauer wirkten wie des Tataren Boris Godunow Edikt auf die russische Bauerschaft. Die "glorious Revolution" (glorreiche Revolution) brachte mit dem Oranier Wilhelm III. die grundherrlichen und kapitalistischen Plusmacher zur Herrschaft.	ch27_clean.en-ch27_clean.de
They inaugurated the new era by practising on a colossal scale the thefts of state lands which had hitherto been managed more modestly.	Sie weihten die neue Ära ein, indem sie den bisher nur bescheiden betriebenen Diebstahl an den Staatsdomänen auf kolossaler Stufenleiter ausübten.	ch27_clean.en-ch27_clean.de
These estates were given away, sold at ridiculous prices, or even annexed to private estates by direct seizure.	Diese Ländereien wurden verschenkt, zu Spottpreisen verkauft oder auch durch direkte Usurpation an Privatgüter annexiert.	ch27_clean.en-ch27_clean.de
All this happened without the slightest observance of legal etiquette.	Alles das geschah ohne die geringste Beobachtung gesetzlicher Etikette.	ch27_clean.en-ch27_clean.de
The Crown lands thus fraudulently appropriated, together with the stolen Church estates, in so far as these were not lost again during the republican revolution, form the basis of the present princely domains of the English oligarchy.	Das so fraudulent angeeignete Staatsgut samt dem Kirchenraub, soweit er während der republikanischen Revolution nicht abhanden gekommen, bildet die Grundlage der heutigen fürstlichen Domänen der englischen Oligarchie.	ch27_clean.en-ch27_clean.de
The bourgeois capitalists favoured the operation, with the intention, among other things, of converting the land into a merely commercial commodity, extending the area of large-scale agricultural production, and increasing the supply of free and rightless proletarians driven from their land. Apart from this, the new landed aristocracy was the natural ally of the new bankocracy, of newly hatched high finance, and of the large manufacturers, at that time dependent on protective duties.	Die bürgerlichen Kapitalisten begünstigten die Operation, u.a. um den Grund und Boden in einen reinen Handelsartikel zu verwandeln, das Gebiet des agrikolen Großbetriebs auszudehnen, ihre Zufuhr vogelfreier Proletarier vom Lande zu vermehren usw. Zudem war die neue Grundaristokratie die natürliche Bundesgenossin der neuen Bankokratie, der eben aus dem Ei gekrochnen hohen Finanz und der damals auf Schutzzölle sich stützenden großen Manufakturisten.	ch27_clean.en-ch27_clean.de
The English bourgeoisie acted quite as wisely in its own interest as the Swedish burghers, who did the opposite: hand in hand with the bulwark of their economic strength, the peasantry, they helped the kings in their forcible resumption of crown lands from the oligarchy, in the years after 1604 and later on under Charles X and Charles XI.	Die englische Bourgeoisie handelte für ihr Interesse ganz so richtig wie die schwedischen Stadtbürger, die umgekehrt, Hand in Hand mit ihrem ökonomischen Bollwerk, der Bauerschaft, die Könige in der gewaltsamen Resumption der Kronländereien von der Oligarchie (seit 1604, später unter Karl X. und Karl XI.) unterstützten.	ch27_clean.en-ch27_clean.de
Communal property – which is entirely distinct from the state property we have just been considering – was an old Teutonic institution which lived on under the cover of feudalism.	Das Gemeindeeigentum - durchaus verschieden von dem eben betrachteten Staatseigentum - war eine altgermanische Einrichtung, die unter der Decke der Feudalität fortlebte.	ch27_clean.en-ch27_clean.de
We have seen how its forcible usurpation, generally accompanied by the turning of arable into pasture land, begins at the end of the fifteenth century and extends into the sixteenth.	Man hat gesehn, wie die gewaltsame Usurpation desselben, meist begleitet von Verwandlung des Ackerlands in Viehweide, Ende des 15. Jahrhunderts beginnt und im 16. Jahrhundert fortdauert.	ch27_clean.en-ch27_clean.de
But at that time the process was carried on by means of individual acts of violence against which legislation, for a hundred and fifty years, fought in vain.	Aber damals vollzog sich der Prozeß als individuelle Gewalttat, wogegen die Gesetzgebung 150 Jahre lang vergeblich ankämpft.	ch27_clean.en-ch27_clean.de
The advance made by the eighteenth century shows itself in this, that the law itself now becomes the instrument by which the people’s land is stolen, although the big farmers made use of their little independent methods as well.	Der Fortschritt des 18. Jahrhunderts offenbart sich darin, daß das Gesetz selbst jetzt zum Vehikel des Raubs am Volksland wird, obgleich die großen Pächter nebenbei auch ihre kleinen unabhängigen Privatmethoden anwenden.	ch27_clean.en-ch27_clean.de
The Parliamentary form of the robbery is that of ‘Bills for Inclosure of Commons’, in other words decrees by which the landowners grant themselves the people’s land as private property, decrees of expropriation of the people.	Die parlamentarische Form des Raubs ist die der "Bills for Inclosures of Commons" (Gesetze für Einhegung des Gemeindelandes), in andren Worten Dekrete, wodurch die Grundherrn Volksland sich selbst als Privateigentum schenken, Dekrete der Volksexpropriation.	ch27_clean.en-ch27_clean.de
Sir F. M. Eden refutes his own crafty special pleading, in which he tries to represent communal property as the private property of the great landlords who have taken the place of the feudal lords, when he himself demands a ‘general Act of Parliament for the enclosure of Commons’ (thereby admitting that a parliamentary coup d’état is necessary for their transformation into private property), and moreover calls on the legislature to indemnify the expropriated poor.	Sir F. M. Eden widerlegt sein pfiffiges Advokatenplädoyer, worin er das Gemeindeeigentum als Privateigentum der an die Stelle der Feudalen getretenen großen Grundeigentümer darzustellen sucht, indem er selbst einen "allgemeinen Parlamentsakt für Einhegung der Gemeindeländereien" verlangt, also zugibt, daß ein parlamentarischer Staatsstreich zu ihrer Verwandlung in Privateigentum nötig ist, andrerseits aber von der Legislatur "Schadensersatz" für die expropriierten Armen fordert.	ch27_clean.en-ch27_clean.de
While the place of the independent yeoman was taken by tenants at will, small farmers on yearly leases, a servile rabble dependent on the arbitrary will of the landlords, the systematic theft of communal property was of great assistance, alongside the theft of the state domains, in swelling those large farms which were called in the eighteenth century capital farms, or merchant farms, and in ‘setting free’ the agricultural population as a proletariat for the needs of industry.	Während an die Stelle der unabhängigen Yeomen tenants-at-will traten, kleinere Pächter auf einjährige Kündigung, eine servile und von der Willkür der Landlords abhängige Rotte, half, neben dem Raub der Staatsdomänen, namentlich der systematisch betriebne Diebstahl des Gemeindeeigentums jene großen Pachten anschwellen, die man im 18. Jahrhundert Kapital-Pachten oder Kaufmanns-Pachten nannte, und das Landvolk als Proletariat für die Industrie "freisetzen".	ch27_clean.en-ch27_clean.de
The eighteenth century, however, did not yet recognize as fully as the nineteenth the identity between the wealth of the nation and the poverty of the people.	Das 18. Jahrhundert begriff jedoch noch nicht in demselben Maß wie das 19. die Identität zwischen Nationalreichtum und Volksarmut.	ch27_clean.en-ch27_clean.de
Hence the very vigorous polemic, in the economic literature of that time, on the ‘enclosure of commons’.	Daher heftigste Polemik in der ökonomischen Literatur jener Zeit über die "inclosure of commons".	ch27_clean.en-ch27_clean.de
From the mass of material that lies before me, I give a few extracts chosen for the strong light they throw on the circumstances of the time.	Ich gebe aus dem massenhaften Material, das mir vorliegt, einige wenige Stellen, weil dadurch lebhaft die Zustände veranschaulicht werden.	ch27_clean.en-ch27_clean.de
‘In several parishes of Hertfordshire,’ writes one indignant person, ‘twenty-four farms, numbering on the average 50 to 150 acres, have been melted up into three farms.’	"In vielen Pfarreien von Hertfordshire", schreibt eine entrüstete Feder, "sind 24 im Durchschnitt 50-150 Acres zählende Pachten in 3 Pachten zusammengeschmolzen."	ch27_clean.en-ch27_clean.de
‘In Northamptonshire and Leicestershire the enclosure of common lands has taken place on a very large scale, and most of the new lordships, resulting from the enclosure, have been turned into pasturage, in consequence of which many lordships have not now 50 acres ploughed yearly, in which 1, were ploughed formerly.	"In Northamptonshire und Lincolnshire hat die Einhegung der Gemeindeländereien sehr vorgeherrscht und die meisten aus den Einhegungen entsprungnen neuen Lordschaften sind in Weide verwandelt; infolge davon haben viele Lordschaften jetzt nicht 50 Acres unter dem Pflug, wo früher 1.500 gepflügt wurden ...	ch27_clean.en-ch27_clean.de
The ruins of former dwelling-houses, barns, stables, etc.’ are the sole traces of the former inhabitants.	Ruinen früherer Wohnhäuser, Scheunen, Ställe usw." sind die einzigen Spuren der früheren Einwohner.	ch27_clean.en-ch27_clean.de
‘An hundred houses and families have in some open field villages… dwindled to eight or ten… The landholders in most parishes that have been enclosed only fifteen or twenty years, are very few in comparison of the numbers who occupied them in their open-field state.	"Hundert Häuser und Familien sind an manchen Plätzen zusammengeschrumpft ... auf 8 oder 10 ... Der Grundeigentümer in den meisten Pfarreien, wo die Einhegung erst seit 15 oder 20 Jahren vorging, sind sehr wenige in Vergleich zu den Zahlen, von denen das Land im offnen Feldzustand bebaut wurde.	ch27_clean.en-ch27_clean.de
It is no uncommon thing for four or five wealthy graziers to engross a large enclosed lordship which was before in the hands of twenty or thirty farmers, and as many smaller tenants and proprietors.	Es ist nichts Ungewöhnliches, 4 oder 5 reiche Viehmäster große, jüngst eingehegte Lordschaften usurpieren zu sehn, die sich früher in der Hand von 20-30 Pächtern und von ebenso vielen kleineren Eigentümern und Insassen befanden.	ch27_clean.en-ch27_clean.de
All these are hereby thrown out of their livings with their families and many other families who were chiefly employed and supported by them.’	Alle diese sind mit ihren Familien aus ihrem Besitztum herausgeworfen nebst vielen andren Familien, die durch sie beschäftigt und erhalten wurden."	ch27_clean.en-ch27_clean.de
It was not only land that lay waste, but often also land that was still under cultivation, being cultivated either in common or held under a definite rent paid to the community, that was annexed by the neighbouring landowners under pretext of enclosure.	Es war nicht nur brachliegendes, sondern oft, unter bestimmter Zahlung an die Gemeinde, oder gemeinschaftlich, bebautes Land, das unter dem Vorwand der Einhegung vom angrenzenden Landlord annexiert wurde.	ch27_clean.en-ch27_clean.de
‘I have here in view enclosures of open fields and lands already improved.	"Ich spreche hier vom Einschluß offner Felder und Ländereien, die bereits bebaut sind.	ch27_clean.en-ch27_clean.de
It is acknowledged by even the writers in defence of enclosures that these diminished villages increase the monopolies of farms, raise the prices of provisions, and produce depopulation… and even the enclosure of waste lands (as now carried on) bears hard on the poor, by depriving them of a part of their subsistence, and only goes towards increasing farms already too large.’	Selbst die Schriftsteller, welche die Inclosures verteidigen, geben zu, daß letztre das Monopol großer Pachtungen vermehren, die Preise der Lebensmittel erhöhen und Entvölkerung produzieren ... und selbst die Einhegung wüster Ländereien, wie jetzt betrieben, raubt dem Armen einen Teil seiner Subsistenzmittel und schwellt Pachtungen auf, die bereits zu groß sind."	ch27_clean.en-ch27_clean.de
‘When,’ says Dr Price, ‘this land gets into the hands of a few great farmers, the consequence must be that the little farmers’ (previously described by him as ‘a multitude of little proprietors and tenants, who maintain themselves and families by the produce of the ground they occupy by sheep kept on a common, by poultry, hogs, etc., and who therefore have little occasion to purchase any of the means of subsistence’) ‘will be converted into a body of men who earn their subsistence by working for others, and who will be under a necessity of going to market for all they want… There will, perhaps, be more labour, because there will be more compulsion to it… Towns and manufactures will increase, because more will be driven to them in quest of places and employment.	"Wenn", sagt Dr. Price, "das Land in die Hände einiger weniger großen Pächter gerät, werden die kleinen Pächter" (früher von ihm bezeichnet als "eine Menge kleiner Eigentümer und Pächter, die sich selbst und Familien erhalten durch das Produkt des von ihnen bestellten Landes, durch Schafe, Geflügel, Schweine usw., die sie auf das Gemeindeland schicken, so daß sie wenig Anlaß zum Kauf von Subsistenzmitteln haben") "verwandelt in Leute, die ihre Subsistenz durch Arbeit für andre gewinnen müssen und gezwungen sind, für alles, was sie brauchen, zu Markt zu gehen ...	ch27_clean.en-ch27_clean.de
This is the way in which the engrossing of farms actually operates.	Es wird vielleicht mehr Arbeit verrichtet, weil mehr Zwang dazu herrscht ...	ch27_clean.en-ch27_clean.de
And this is the way in which, for many years, it has been actually operating in this kingdom.’	Städte und Manufakturen werden wachsen, weil mehr Leute zu ihnen verjagt werden, welche Beschäftigung suchen.	ch27_clean.en-ch27_clean.de
He sums up the effect of the enclosures in this way: ‘Upon the whole, the circumstances of the lower ranks of men are altered in almost every respect for the worse.	Dies ist der Weg, worin die Konzentration der Pachtungen naturgemäß wirkt und worin sie, seit vielen Jahren, in diesem Königreich tatsächlich gewirkt hat."	ch27_clean.en-ch27_clean.de
From little occupiers of land, they are reduced to the state of day-labourers and hirelings; and, at the same time, their subsistence in that state has become more difficult.’	Er faßt die Gesamtwirkung der inclosures so zusammen: "Im ganzen hat sich die Lage der niederen Volksklassen fast in jeder Hinsicht verschlechtert, die kleineren Grundbesitzer und Pächter sind herabgedrückt auf den Stand von Taglöhnern und Mietlingen; und zur selben Zeit ist der Lebensgewinn in diesem Zustand schwieriger geworden."	ch27_clean.en-ch27_clean.de
In fact, the usurpation of the common lands and the accompanying revolution in agriculture had such an acute effect on the agricultural labourers that, even according to Eden, their wages began to fall below the minimum between 1765 and 1780, and to be supplemented by official Poor Law relief.	In der Tat wirkten Usurpation des Gemeindelands und die sie begleitende Revolution der Agrikultur so akut auf die Ackerbauarbeiter, daß, nach Eden selbst, zwischen 1765 und 1780 ihr Lohn anfing, unter das Minimum zu fallen und durch offizielle Armenunterstützung ergänzt zu werden.	ch27_clean.en-ch27_clean.de
Their wages, he says, ‘were not more than enough for the absolute necessaries of life’.	Ihr Arbeitslohn, sagt er, "genügte nur noch eben für die absoluten Lebensbedürfnisse".	ch27_clean.en-ch27_clean.de
Let us hear for a moment a defender of enclosures and an opponent of Dr Price.	Hören wir noch einen Augenblick einen Verteidiger der enclosures und Gegner des Dr. Price.	ch27_clean.en-ch27_clean.de
‘Nor is it a consequence that there must be depopulation, because men are not seen wasting their labour in the open field… If, by converting the little farmers into a body of men who must work for others, more labour is produced, it is an advantage which the nation’ (to which, of course, the people who have been ‘converted’ do not belong) ‘should wish for… the produce being greater when their joint labours are employed on one farm, there will be a surplus for manufactures, and by this means manufactures, one of the mines of the nation, will increase, in proportion to the quantity of corn produced.’	"Es ist kein richtiger Schluß, daß Entvölkerung vorhanden, weil man Leute nicht länger ihre Arbeit im offnen Feld verschwenden sieht ... Wenn nach Verwandlung kleiner Bauern in Leute, die für andre arbeiten müssen, mehr Arbeit flüssig gemacht wird, so ist das ja ein Vorteil, den die Nation" (wozu die Verwandelten natürlich nicht gehören) "wünschen muß ... Das Produkt wird größer sein, wenn ihre kombinierte Arbeit auf einer Pachtung angewandt wird: so wird Surplusprodukt für die Manufakturen gebildet, und dadurch werden Manufakturen, eine der Goldgruben dieser Nation, im Verhältnis zum produzierten Kornquantum vermehrt."	ch27_clean.en-ch27_clean.de
The stoical peace of mind with which the political economist regards the most shameless violation of the ‘sacred rights of property’ and the grossest acts of violence against persons, as soon as they are necessary in order to lay the foundations of the capitalist mode of production, is shown by Sir F. M. Eden, who is, moreover, Tory and ‘philanthropic’ in his political colouring.	Die stoische Seelenruhe, womit der politische Ökonom frechste Schändung des "heiligen Rechts des Eigentums" und gröbste Gewalttat wider Personen betrachtet, sobald sie erheischt sind, um die Grundlage der kapitalistischen Produktionsweise herzustellen, zeigt uns u.a. der überdem noch torystisch gefärbte und "philanthropische" Sir F. M. Eden.	ch27_clean.en-ch27_clean.de
The whole series of thefts, outrages and popular misery that accompanied the forcible expropriation of the people, from the last third of the fifteenth to the end of the eighteenth century, leads him merely to this ‘comfortable’ concluding reflection: ‘The due proportion between arable land and pasture had to be established.	Die ganze Reihe von Raubtaten, Greueln und Volksdrangsalen, welche die gewaltsame Volksexpropriation vom letzten Drittel des 15. bis zum Ende des 18. Jahrhunderts begleiten, treibt ihn nur zur "komfortablen" Schlußreflexion: "Die richtige (due) Proportion zwischen Acker- und Viehland mußte hergestellt werden.	ch27_clean.en-ch27_clean.de
During the whole of the fourteenth and the greater part of the fifteenth century, there was 1 acre of pasture to 2, 3, and even 4 of arable land.	Noch im ganzen 14. und größten Teil des 15. Jahrhunderts kam 1 Acre Viehweide auf 2, 3 und selbst 4 Acres Ackerland.	ch27_clean.en-ch27_clean.de
About the middle of the sixteenth century the proportion was changed to 2 acres of pasture to 2, later on, to 2 acres of pasture to 1 of arable, until at last the just proportion of 3 acres of pasture to 1 of arable land was attained.’	In Mitte des 16. Jahrhunderts verwandelte sich die Proportion in 2 Acres Viehland auf 2, später von 2 Acres Viehweide auf 1 Acre Ackerland, bis endlich die richtige Proportion von 3 Acres Viehland auf 1 Acre Ackerland herauskam."	ch27_clean.en-ch27_clean.de
By the nineteenth century, the very memory of the connection between the agricultural labourer and communal property had, of course, vanished.	Im 19. Jahrhundert verlor sich natürlich selbst die Erinnerung des Zusammenhangs zwischen Ackerbauer und Gemeindeeigentum.	ch27_clean.en-ch27_clean.de
To say nothing of more recent times – have the agricultural population received a farthing’s compensation for the 3,511, acres of common land which between 1801 and 1831 were stolen from them and presented to the landlords by the landlords, through the agency of Parliament?	Von späterer Zeit gar nicht zu reden, welchen Farthing Ersatz erhielt das Landvolk jemals für die 3.511.770 Acres Gemeindeland, die ihm zwischen 1810 und 1831 geraubt und parlamentarisch den Landlords von den Landlords geschenkt wurden?	ch27_clean.en-ch27_clean.de
The last great process of expropriation of the agricultural population from the soil is, finally, the so-called ‘clearing of estates’, i.e. the sweeping of human beings off them.	Der letzte große Expropriationsprozeß der Ackerbauer von Grund und Boden endlich ist das sog. Clearing of Estates (Lichten der Güter, in der Tat Wegfegung der Menschen von denselben).	ch27_clean.en-ch27_clean.de
All the English methods hitherto considered culminated in ‘clearing’.	Alle bisher betrachteten englischen Methoden kulminierten im "Lichten".	ch27_clean.en-ch27_clean.de
As we saw in the description of modern conditions given in a previous chapter, when there are no more independent peasants to get rid of, the ‘clearing’ of cottages begins; so that the agricultural labourers no longer find on the soil they cultivate even the necessary space for their own housing.	Wie man bei der Schilderung des modernen Zustands im vorigen Abschnitt sah, geht es jetzt, wo keine unabhängigen Bauern mehr wegzufegen sind, bis zum "Lichten" der Cottages fort, so daß die Ackerbauarbeiter auf dem von ihnen bestellten Boden selbst nicht mehr den nötigen Raum zur eignen Behausung finden.	ch27_clean.en-ch27_clean.de
But what ‘clearing of estates’ really and properly signifies, we learn only in the Highlands of Scotland, the promised land of modern romantic novels.	Was aber "Clearing of Estates" im eigentlichen Sinne bedeutet, das lernen wir nur kennen im gelobten Lande der modernen Romanliteratur, in Hochschottland.	ch27_clean.en-ch27_clean.de
There the process is distinguished by its systematic character, by the magnitude of the scale on which it is carried out at one blow (in Ireland landlords have gone as far as sweeping away several villages at once; but in the Highlands areas as large as German principalities are dealt with), and finally by the peculiar form of property under which the embezzled lands were held.	Dort zeichnet sich der Vorgang aus durch seinen systematischen Charakter, durch die Größe der Stufenleiter, worauf er mit einem Schlag vollzogen wird (in Irland haben Grundherrn es dahin gebracht, mehrere Dörfer gleichzeitig wegzufegen; in Hochschottland handelt es sich um Bodenflächen von der Größe deutscher Herzogtümer) - und endlich durch die besondre Form des unterschlagenen Grundeigentums.	ch27_clean.en-ch27_clean.de
The Highland Celts were organized in clans, each of which was the owner of the land on which it was settled.	Die Kelten Hochschottlands bestanden aus Clans, deren jeder Eigentümer des von ihm besiedelten Bodens war.	ch27_clean.en-ch27_clean.de
The representative of the clan, its chief or ‘great man’, was only the titular owner of this property, just as the Queen of England is the titular owner of all the national soil.	Der Repräsentant des Clans, sein Chef oder "großer Mann", war nur Titulareigentümer dieses Bodens, ganz wie die Königin von England Titulareigentümerin des nationalen Gesamtbodens ist.	ch27_clean.en-ch27_clean.de
When the English government succeeded in suppressing the intestine wars of these ‘great men’, and their constant incursions into the Lowland plains, the chiefs of the clans by no means gave up their time-honoured trade as robbers; they merely changed its form.	Als der englischen Regierung gelungen war, die inneren Kriege dieser "großen Männer" und ihre fortwährenden Einfälle in die niederschottischen Ebenen zu unterdrücken, gaben die Clanchefs ihr altes Räuberhandwerk keineswegs auf; sie änderten nur die Form.	ch27_clean.en-ch27_clean.de
On their own authority, they transformed their nominal right to the land into a right of private property, and as this came up against resistance on the part of their clansmen, they resolved to drive them out openly and by force.	Aus eigner Autorität verwandelten sie ihr Titular-Eigentumsrecht in Privateigentumsrecht, und da sie bei den Clanleuten auf Widerstand stießen, beschlossen sie, diese mit offner Gewalt zu vertreiben.	ch27_clean.en-ch27_clean.de
‘A king of England might as well claim to drive his subjects into the sea,’ says Professor Newman.	"Ein König von England könnte mit demselben Recht sich anmaßen, seine Untertanen in die See zu jagen", sagt Professor Newman.	ch27_clean.en-ch27_clean.de
This revolution, which began in Scotland after the last rising of the followers of the Pretender,* can be followed through its first phases in the writings of Sir James Steuart 26 and James Anderson.	Diese Revolution, welche in Schottland nach der letzten Schilderhebung des Prätendenten begann, kann man in ihren ersten Phasen verfolgen bei Sir James Steuart und James Anderson .	ch27_clean.en-ch27_clean.de
In the eighteenth century the Gaels were both driven from the land and forbidden to emigrate, with a view to driving them forcibly to Glasgow and other manufacturing towns.	Im 18. Jahrhundert wurde zugleich den vom Land verjagten Gaelen die Auswanderung verboten, um sie gewaltsam nach Glasgow und andren Fabrikstädten zu treiben.	ch27_clean.en-ch27_clean.de
As an example of the method used in the nineteenth century, the ‘clearings’ made by the Duchess of Sutherland will suffice here.	Als Beispiel der im 19. Jahrhundert herrschenden Methode genügen hier die "Lichtungen" der Herzogin von Suther- land.	ch27_clean.en-ch27_clean.de
This person, who had been well instructed in economics, resolved, when she succeeded to the headship of the clan, to undertake a radical economic cure, and to turn the whole county of Sutherland, the population of which had already been reduced to 15, by similar processes, into a sheep-walk.	Diese ökonomisch geschulte Person beschloß gleich bei ihrem Regierungsantritt eine ökonomische Radikalkur vorzunehmen und die ganze Grafschaft, deren Einwohnerschaft durch frühere, ähnliche Prozesse bereits auf 15.000 zusammengeschmolzen war, in Schaftrift zu verwandeln.	ch27_clean.en-ch27_clean.de
Between 1814 and 1820 these 15, inhabitants, about 3, families, were systematically hunted and rooted out.	Von 1814 bis 1820 wurden diese 15.000 Einwohner, ungefähr 3.000 Familien, systematisch verjagt und ausgerottet.	ch27_clean.en-ch27_clean.de
All their villages were destroyed and burnt, all their fields turned into pasturage.	Alle ihre Dörfer wurden zerstört und niedergebrannt, alle ihre Felder in Weide verwandelt.	ch27_clean.en-ch27_clean.de
British soldiers enforced this mass of evictions, and came to blows with the inhabitants.	Britische Soldaten wurden zur Exekution kommandiert und kamen zu Schlägen mit den Eingebornen.	ch27_clean.en-ch27_clean.de
One old woman was burnt to death in the flames of the hut she refused to leave.	Eine alte Frau verbrannte in den Flammen der Hütte, die sie zu verlassen sich weigerte.	ch27_clean.en-ch27_clean.de
It was in this manner that this fine lady appropriated 794, acres of land which had belonged to the clan from time immemorial.	So eignete sich diese Madame 794.000 Acres Land an, das seit undenklichen Zeiten dem Clan gehörte.	ch27_clean.en-ch27_clean.de
She assigned to the expelled inhabitants some 6, acres on the sea-shore – 2 acres per family.	Den vertriebnen Eingebornen wies sie am Seegestad ungefähr 6.000 Acres zu, 2 Acres per Familie.	ch27_clean.en-ch27_clean.de
The 6, acres had until this time lain waste, and brought in no income to their owners.	Die 6.000 Acres hatten bisher wüst gelegen und den Eigentümern kein Einkommen abgeworfen.	ch27_clean.en-ch27_clean.de
The Duchess, in the nobility of her heart, actually went so far as to let these waste lands at an average rent of 2s.	Die Herzogin ging in ihrem Nobelgefühl so weit, den Acre im Durchschnitt zu 2 sh.	ch27_clean.en-ch27_clean.de
6d. per acre to the clansmen, who for centuries had shed their blood for her family.	6 d. Rente zu verpachten an die Clanleute, die seit Jahrhunderten ihr Blut für die Familie vergossen hatten.	ch27_clean.en-ch27_clean.de
She divided the whole of the stolen land of the clan into twenty-nine huge sheep farms, each inhabited by a single family, for the most part imported English farm-servants.	Das ganze geraubte Clanland teilte sie in 29 große Schafpachtungen, jede bewohnt von einer einzigen Familie, meist englische Pächterknechte.	ch27_clean.en-ch27_clean.de
By 1825 the 15, Gaels had already been replaced by 131, sheep.	Im Jahre 1825 waren die 15.000 Gaelen bereits ersetzt durch 131.000 Schafe.	ch27_clean.en-ch27_clean.de
The remnant of the original inhabitants, who had been flung onto the sea-shore, tried to live by catching fish.	Der an das Seegestad geworfne Teil der Aborigines <Eingeborenen> suchte vom Fischfang zu leben.	ch27_clean.en-ch27_clean.de
They became amphibious, and lived, as an English writer says, half on land and half on water, and withal only half on both.	Sie wurden Amphibien und lebten, wie ein englischer Schriftsteller sagt, halb auf dem Land und halb auf dem Wasser und lebten mit alledem nur halb von beiden.	ch27_clean.en-ch27_clean.de
But the splendid Gaels had now to suffer still more bitterly for their romantic mountain idolization of the ‘great men’ of the clan.	Aber die braven Gaelen sollten noch schwerer ihre bergromantische Idolatrie für die "großen Männer" des Clans abbüßen.	ch27_clean.en-ch27_clean.de
The smell of their fish rose to the noses of the great men.	Der Fischgeruch stieg den großen Männern in die Nase.	ch27_clean.en-ch27_clean.de
They scented some profit in it, and let the sea-shore to the big London fishmongers.	Sie witterten etwas Profitliches dahinter und verpachteten das Seegestade den großen Fischhändlern von London.	ch27_clean.en-ch27_clean.de
For the second time the Gaels were driven out.	Die Gaelen wurden zum zweitenmal verjagt.	ch27_clean.en-ch27_clean.de
Finally, however, part of the sheep-walks were turned into deer preserves.	Endlich aber wird ein Teil der Schaftriften rückverwandelt in Jagdrevier.	ch27_clean.en-ch27_clean.de
Everyone knows that there are no true forests in England.	Man weiß, daß es keine eigentlichen Wälder in England gibt.	ch27_clean.en-ch27_clean.de
The deer in the parks of the great are demure domestic cattle, as fat as London aldermen.	Das Wild in den Parks der Großen ist konstitutionelles Hausvieh, fett wie Londoner Aldermen.	ch27_clean.en-ch27_clean.de
Scotland is therefore the last refuge of the ‘noble passion’.	Schottland ist daher das letzte Asyl der "noblen Passion".	ch27_clean.en-ch27_clean.de
‘In the Highlands,’ reports Somers in 1848, ‘new forests are springing up like mushrooms.	"In den Hochlanden", sagt Somers 1848, "sind die Waldungen sehr ausgedehnt worden.	ch27_clean.en-ch27_clean.de
Here, on one side of Gaick, you have the new forest of Glenfeshie; and there on the other you have the new forest of Ardverikie.	Hier auf der einen Seite von Gaick habt ihr den neuen Wald von Glenfeshie und dort auf der andren Seite den neuen Wald von Ardverikie.	ch27_clean.en-ch27_clean.de
In the same line you have the Black Mount, an immense waste also recently erected.	In derselben Linie habt ihr den Bleak-Mount, eine ungeheure Wüste, neulich errichtet.	ch27_clean.en-ch27_clean.de
From east to west – from the neighbourhood of Aberdeen to the crags of Oban – you have now a continuous line of forests; while in other parts of the Highlands there are the new forests of Loch Archaig, Glengarry, Glenmoriston, etc.	Von Ost zu West, von der Nachbarschaft von Aberdeen bis zu den Klippen von Oban, habt ihr jetzt eine fortlaufende Waldlinie, während sich in andren Teilen der Hochlande die neuen Wälder von Loch Archaig, Glengarry, Glenmoriston etc. befinden ...	ch27_clean.en-ch27_clean.de
Sheep were introduced into glens which had been the seats of communities of small farmers; and the latter were driven to seek subsistence on coarser and more sterile tracts of soil.	Die Verwandlung ihres Landes in Schafweide ... trieb die Gaelen auf unfruchtbarern Boden.	ch27_clean.en-ch27_clean.de
Now deer are supplanting sheep; and these are once more dispossessing the small tenants, who will necessarily be driven down upon still coarser land and to more grinding penury.	Jetzt fängt Rotwild an, das Schaf zu ersetzen, und treibt jene in noch zermalmenderes Elend ...	ch27_clean.en-ch27_clean.de
Deer-forests and the people cannot co-exist.	Die Wildwaldungen (219a) und das Volk können nicht nebeneinander existieren.	ch27_clean.en-ch27_clean.de
One or other of the two must yield.	Eins oder das andre muß jedenfalls den Platz räumen.	ch27_clean.en-ch27_clean.de
Let the forests be increased in number and extent during the next quarter of a century, as they have been in the last, and the Gaels will perish from their native soil… This movement among the Highland proprietors is with some a matter of ambition… with some love of sport… while others, of a more practical cast, follow the trade in deer with an eye solely to profit.	Laßt die Jagden in Zahl und Umfang im nächsten Vierteljahrhundert wachsen wie im vergangenen, und ihr werdet keinen Gaelen mehr auf seiner heimischen Erde finden. Diese Bewegung unter den Hochlands-Eigentümern ist teils der Mode geschuldet, aristokratischem Kitzel, Jagdliebhaberei usw., teils aber betreiben sie den Wildhandel ausschließlich mit einem Auge auf den Profit.	ch27_clean.en-ch27_clean.de
For it is a fact, that a mountain range laid out in forest is, in many cases, more profitable to the proprietor than when let as a sheep-walk… The huntsman who wants a deer-forest limits his offers by no other calculation than the extent of his purse… Sufferings have been inflicted in the Highlands scarcely less severe than those occasioned by the policy of the Norman kings.	Denn es ist Tatsache, daß ein Stuck Bergland, in Jagdung angelegt, in vielen Fällen ungleich profitabler ist denn als Schaftrift ... Der Liebhaber, der ein Jagdrevier sucht, beschränkt sein Angebot nur durch die Weite seiner Börse ... Leiden sind über die Hochlande verhängt worden nicht minder grausam, als die Politik normännischer Könige sie über England verhing.	ch27_clean.en-ch27_clean.de
	Rotwild hat freieren Spielraum erhalten, während die Menschen in engen und engem Zirkel gehetzt wurden ...	ch27_clean.en-ch27_clean.de
	Eine Freiheit des Volks nach der andren ward ihm geraubt ...	ch27_clean.en-ch27_clean.de
Deer have received extended ranges, while men have been hunted within a narrower and still narrower circle… One after one the liberties of the people have been cloven down… And the oppressions are daily on the increase… The clearance and dispersion of the people is pursued by the proprietors as a settled principle, as an agricultural necessity, just as trees and brushwood are cleared from the wastes of America or Australia; and the operation goes on in a quiet, business-like way, etc.’	Und die Unterdrückung wächst noch täglich. Lichtung und Vertreibung des Volks werden von den Eigentümern als festes Prinzip verfolgt, als eine agrikole Notwendigkeit, ganz wie Bäume und Gesträuch in den Wildnissen Amerikas und Australiens weggefegt werden, und die Operation geht ihren ruhigen, geschäftsmäßigen Gang."	ch27_clean.en-ch27_clean.de
The spoliation of the Church’s property, the fraudulent alienation of the state domains, the theft of the common lands, the usurpation of feudal and clan property and its transformation into modern private property under circumstances of ruthless terrorism, all these things were just so many idyllic methods of primitive accumulation.	Der Raub der Kirchengüter, die fraudulente Veräußerung der Staatsdomänen, der Diebstahl des Gemeindeeigentums, die usurpatorische und mit rücksichtslosem Terrorismus vollzogne Verwandlung von feudalem und Claneigentum in modernes Privateigentum, es waren ebenso viele idyllische Methoden der ursprünglichen Akkumulation.	ch27_clean.en-ch27_clean.de
They conquered the field for capitalist agriculture, incorporated the soil into capital, and created for the urban industries the necessary supplies of free and rightless proletarians.	Sie eroberten das Feld für die kapitalistische Agrikultur, einverleibten den Grund und Boden dem Kapital und schufen der städtischen Industrie die nötige Zufuhr von vogelfreiem Proletariat.	ch27_clean.en-ch27_clean.de

