Chapter 29: The Genesis of the Capitalist Farmer Now that we have considered the forcible creation of a class of free and rightless proletarians, the bloody discipline that turned them into wage-labourers, the disgraceful proceedings of the state which employed police methods to accelerate the accumulation of capital by increasing the degree of exploitation of labour, the question remains: where did the capitalists originally spring from?	4. Genesis der kapitalistischen Produktion Nachdem wir die gewaltsame Schöpfung vogelfreier Proletarier betrachtet, die blutige Disziplin, welche sie in Lohnarbeiter verwandelt, die schmutzige Haupt- und Staatsaktion, die mit dem Exploitationsgrad der Arbeit die Akkumulation des Kapitals polizeilich steigert, fragt sich, wo kommen die Kapitalisten ursprünglich her?	ch29_clean.en-ch29_clean.de
For the only class created directly by the expropriation of the agricultural population is that of the great landed proprietors.	Denn die Expropriation des Landvolks schafft unmittelbar nur große Grundeigentümer.	ch29_clean.en-ch29_clean.de
As far as the genesis of the farmers is concerned, however, we can so to speak put our finger on it, because it is a slow process evolving through many centuries.	Was die Genesis des Pächters betrifft, so können wir sie sozusagen mit der Hand betappen, weil sie ein langsamer, über viele Jahrhunderte sich fortwälzender Prozeß ist.	ch29_clean.en-ch29_clean.de
The serfs, as well as the free small-scale proprietors, held land under very different tenures, and were therefore emancipated under very different economic conditions.	Die Leibeignen selbst, woneben auch freie kleine Landeigner, befanden sich in sehr verschiednen Besitzverhältnissen und wurden daher auch unter sehr verschiednen ökonomischen Bedingungen emanzipiert.	ch29_clean.en-ch29_clean.de
In England, the first form of the farmer is the bailiff, himself a serf.	In England ist die erste Form des Pächters der selbst leibeigne Bailiff.	ch29_clean.en-ch29_clean.de
His position is similar to that of the villicus in ancient Rome, only in a more limited sphere of action.	Seine Stellung ist ähnlich der des altrömischen Villicus, nur in engerer Wirkungssphäre.	ch29_clean.en-ch29_clean.de
During the second half of the fourteenth century he is replaced by a farmer, whom the landlord provides with seed, cattle and farm implements.	Während der zweiten Hälfte des 14. Jahrhunderts wird er ersetzt durch einen Pächter, den der Landlord mit Samen, Vieh und Ackerwerkzeug versieht.	ch29_clean.en-ch29_clean.de
The farmer’s condition is not very different from that of the peasant, but he exploits more wage-labour.	Seine Lage ist nicht sehr verschieden von der des Bauern.	ch29_clean.en-ch29_clean.de
Soon he becomes a métayer, a share-cropper.	Nur beutet er mehr Lohnarbeit aus.	ch29_clean.en-ch29_clean.de
	Er wird bald Metayer, Halbpächter.	ch29_clean.en-ch29_clean.de
He advances one part of the agricultural stock, the landlord the other.	Er stellt einen Teil des Ackerbaukapitals, der Landlord den andren.	ch29_clean.en-ch29_clean.de
The two divide the total product in proportions determined by contract.	Beide teilen das Gesamtprodukt in kontraktlich bestimmter Proportion.	ch29_clean.en-ch29_clean.de
This form disappears quickly in England, and gives place to the form of the farmer properly so called, who valorizes his own capital by employing wage-labourers, and pays a part of the surplus product, in money or in kind, to the landlord as ground rent.	Diese Form verschwindet in England rasch, um der des eigentlichen Pächters Platz zu machen, welcher sein eignes Kapital durch Anwendung von Lohnarbeitern verwertet und einen Teil des Mehrprodukts, in Geld oder in natura, dem Landlord als Grundrente zahlt.	ch29_clean.en-ch29_clean.de
During the fifteenth century the independent peasant, and the farm-labourer working for himself as well as for wages, enriched themselves by their own labour; and as long as this was the case, both the farmer’s circumstances and his field of production remained mediocre.	Solange, während des 15. Jahrhunderts, der unabhängige Bauer und der neben dem Lohndienst zugleich selbstwirtschaftende Ackerknecht sich selbst durch ihre Arbeit bereichern, bleiben die Umstände des Pächters und sein Produktionsfeld gleich mittelmäßig.	ch29_clean.en-ch29_clean.de
But the agricultural revolution which began in the last third of the fifteenth century, and continued during the bulk of the sixteenth (excepting, however, its last few decades), enriched him just as quickly as it impoverished the mass of the agricultural folk.	Die Agrikulturrevolution im letzten Dritteil des 15. Jahrhunderts, die fast während des ganzen 16. Jahrhunderts (jedoch mit Ausnahme seiner letzten Dezennien) fortwährt, bereichert ihn ebenso rasch, als sie das Landvolk verarmt.	ch29_clean.en-ch29_clean.de
The usurpation of the common lands allowed the farmer to augment greatly his stock of cattle, almost without cost, while the cattle themselves yielded a richer supply of manure for the cultivation of the soil.	Die Usurpation von Gemeindeweiden usw. erlaubt ihm große Vermehrung seines Viehstands fast ohne Kosten, während ihm das Vieh reichlichere Düngungsmittel zur Bestellung des Bodens liefert.	ch29_clean.en-ch29_clean.de
A further factor, of decisive importance, was added in the sixteenth century.	Im 16. Jahrhundert kommt ein entscheidend wichtiges Moment hinzu.	ch29_clean.en-ch29_clean.de
At that time the contracts for farms ran for a long time, often for ninety-nine years.	Damals waren die Pachtkontrakte lang, oft für 99 Jahre laufend.	ch29_clean.en-ch29_clean.de
The progressive fall in the value of the precious metals, and therefore of money, brought golden fruit to the farmers.	Der fortdauernde Fall im Wert der edlen Metalle und daher des Geldes trug den Pächtern goldne Früchte.	ch29_clean.en-ch29_clean.de
Apart from all the other circumstances discussed above, it lowered wages.	Er senkte, von allen andren, früher erörterten Umständen abgesehn, den Arbeitslohn.	ch29_clean.en-ch29_clean.de
A portion of the latter was now added to the profits of the farm.	Ein Bruchstück desselben wurde zum Pachtprofit geschlagen.	ch29_clean.en-ch29_clean.de
The continuous rise in the prices of corn, wool, meat, in short of all agricultural products, swelled the money capital of the farmer without any action on his part, while the ground rent he had to pay diminished, since it had been contracted for on the basis of the old money values.	Das fortwährende Steigen der Preise von Korn, Wolle, Fleisch, kurz sämtlicher Agrikulturprodukte, schwellte das Geldkapital des Pächters ohne sein Zutun, während die Grundrente, die er zu zahlen hatte, im veralteten Geldwert kontrahiert war.	ch29_clean.en-ch29_clean.de
Thus he grew rich at the expense both of his labourers and his landlords.	So bereicherte er sich gleichzeitig auf Kosten seiner Lohnarbeiter und seines Landlords.	ch29_clean.en-ch29_clean.de
No wonder, therefore, that England, at the end of the sixteenth century, had a class of capitalist farmers who were rich men in relation to the circumstances of the time.3	Kein Wunder also, wenn England Ende des 16. Jahrhunderts eine Klasse für die damaligen Verhältnisse reicher "Kapitalpächter" besaß.	ch29_clean.en-ch29_clean.de

