Chapter 31: The Genesis of the Industrial Capitalist The genesis of the industrial capitalist did not proceed in such a gradual way as that of the farmer.	6. Genesis des industriellen Kapitalisten Die Genesis des industriellen Kapitalisten ging nicht in derselben allmählichen Weise vor wie die des Pächters.	ch31_clean.en-ch31_clean.de
Doubtless many small guild-masters, and a still greater number of independent small artisans, or even wage-labourers, transformed themselves into small capitalists, and, by gradually extending their exploitation of wage-labour and the corresponding accumulation, into ‘capitalists’ without qualification.	Zweifelsohne verwandelten sich manche kleine Zunftmeister und noch mehr selbständige kleine Handwerker oder auch Lohnarbeiter in kleine Kapitalisten und durch allmählich ausgedehntere Exploitation von Lohnarbeit und entsprechende Akkumulation in Kapitalisten sans phrase <hier: schlechthin>.	ch31_clean.en-ch31_clean.de
In the period when capitalist production was in its infancy things often happened as they had done in the period of infancy of the medieval town, where the question as to which of the escaped serfs should be master and which servant was in great part decided by the earlier or later date of their flight.	In der Kindheitsperiode der kapitalistischen Produktion ging's vielfach zu wie in der Kindheitsperiode des mittelaltrigen Städtewesens, wo die Frage, wer von den entlaufnen Leibeignen soll Meister sein und wer Diener, großenteils durch das frühere oder spätere Datum ihrer Flucht entschieden wurde.	ch31_clean.en-ch31_clean.de
The snail’s pace of advance under this method by no means corresponded with the commercial requirements of the new world market, which had been created by the great discoveries of the end of the fifteenth century.	Indes entsprach der Schneckengang dieser Methode in keiner Weise den Handelsbedürfnissen des neuen Weltmarkts, welchen die großen Entdeckungen Ende des 15. Jahrhunderts geschaffen hatten.	ch31_clean.en-ch31_clean.de
But the Middle Ages had handed down two distinct forms of capital, which ripened in the most varied economic formations of society, and which, before the era of the capitalist mode of production, nevertheless functioned as capital -usurer’s capital and merchant’s capital.	Aber das Mittelalter hatte zwei verschiedne Formen des Kapitals überliefert, die in den verschiedensten ökonomischen Gesellschaftsformationen reifen und, vor der Ära der kapitalistischen Produktionsweise, als Kapital quand meme <überhaupt> gelten - das Wucherkapital und das Kaufmannskapital.	ch31_clean.en-ch31_clean.de
‘At present, all the wealth of society goes first into the possession of the capitalist… he pays the landowner his rent, the labourer his wages, the tax and tithe gatherer their claims, and keeps a large, indeed the largest, and a continually augmenting share, of the annual produce of labour for himself.	"Gegenwärtig geht aller Reichtum der Gesellschaft erst in die Hand des Kapitalisten ... er zahlt dem Grundeigentümer die Rente, dem Arbeiter den Lohn, dem Steuer- und Zehntenkollektor ihre Ansprüche und behält einen großen, in der Tat den größten und täglich anwachsenden Teil des jährlichen Produkts der Arbeit für sich selbst.	ch31_clean.en-ch31_clean.de
The capitalist may now be said to be the first owner of all the wealth of the community, though no law has conferred on him the right to this property… this change has been effected by the taking of interest on capital… and it is not a little curious that all the law-givers of Europe endeavoured to prevent this by statutes, viz., statutes against usury… The power of the capitalist over all the wealth of the country is a complete change in the right of property, and by what law, or series of laws, was it effected?’	Der Kapitalist kann jetzt als der Eigner des ganzen gesellschaftlichen Reichtums in erster Hand betrachtet werden, obgleich kein Gesetz ihm das Recht auf dies Eigentum übertragen hat ... Dieser Wechsel im Eigentum wurde durch das Zinsnehmen auf Kapital bewirkt ... und es ist nicht wenig merkwürdig, daß die Gesetzgeber von ganz Europa dies durch Gesetze wider den Wucher verhindern wollten ... Die Macht des Kapitalisten über allen Reichtum des Landes ist eine vollständige Revolution im Eigentumsrecht, und durch welches Gesetz oder welche Reihe von Gesetzen wurde sie bewirkt?"	ch31_clean.en-ch31_clean.de
The author should have reminded himself that revolutions are not made with laws.	Der Verfasser hätte sich sagen sollen, daß Revolutionen nicht durch Gesetze gemacht werden.	ch31_clean.en-ch31_clean.de
The money capital formed by means of usury and commerce was prevented from turning into industrial capital by the feudal organization of the countryside and the guild organization of the towns.	Das durch Wucher und Handel gebildete Geldkapital wurde durch die Feudalverfassung auf dem Land, durch die Zunftverfassung in den Städten an seiner Verwandlung in industrielles Kapital behindert.	ch31_clean.en-ch31_clean.de
These fetters vanished with the dissolution of the feudal bands of retainers, and the expropriation and partial eviction of the rural population.	Diese Schranken fielen mit der Auflösung der feudalen Gefolgschaften, mit der Expropriation und teilweisen Verjagung des Landvolks.	ch31_clean.en-ch31_clean.de
The new manufactures were established at sea-ports, or at points in the countryside which were beyond the control of the old municipalities and their guilds.	Die neue Manufaktur ward in See-Exporthäfen errichtet oder auf Punkten des flachen Landes, außerhalb der Kontrolle des alten Städtewesens und seiner Zunftverfassung.	ch31_clean.en-ch31_clean.de
Hence, in England, the bitter struggle of the corporate towns against these new seed-beds of industry.	In England daher erbitterter Kampf der corporate towns gegen diese neuen industriellen Pflanzschulen.	ch31_clean.en-ch31_clean.de
The discovery of gold and silver in America, the extirpation, enslavement and entombment in mines of the indigenous population of that continent, the beginnings of the conquest and plunder of India, and the conversion of Africa into a preserve for the commercial hunting of blackskins, are all things which characterize the dawn of the era of capitalist production.	Die Entdeckung der Gold- und Silberländer in Amerika, die Ausrottung, Versklavung und Vergrabung der eingebornen Bevölkerung in die Bergwerke, die beginnende Eroberung und Ausplünderung von Ostindien, die Verwandlung von Afrika in ein Geheg zur Handelsjagd auf Schwarzhäute, bezeichnen die Morgenröte der kapitalistischen Produktionsära.	ch31_clean.en-ch31_clean.de
These idyllic proceedings are the chief moments of primitive accumulation.	Diese idyllischen Prozesse sind Hauptmomente der ursprünglichen Akkumulation.	ch31_clean.en-ch31_clean.de
Hard on their heels follows the commercial war of the European nations, which has the globe as its battlefield.	Auf dem Fuß folgt der Handelskrieg der europäischen Nationen, mit dem Erdrund als Schauplatz.	ch31_clean.en-ch31_clean.de
It begins with the revolt of the Netherlands from Spain, assumes gigantic dimensions in England’s Anti-Jacobin War, and is still going on in the shape of the Opium Wars against China, etc. The different moments of primitive accumulation can be assigned in particular to Spain, Portugal, Holland, France and England, in more or less chronological order.	Er wird eröffnet durch den Abfall der Niederlande von Spanien, nimmt Riesenumfang an in Englands Antijakobinerkrieg, spielt noch fort in den Opiumkriegen gegen China usw. Die verschiednen Momente der ursprünglichen Akkumulation verteilen sich nun, mehr oder minder in zeitlicher Reihenfolge, namentlich auf Spanien, Portugal, Holland, Frankreich und England.	ch31_clean.en-ch31_clean.de
These different moments are systematically combined together at the end of the seventeenth century in England; the combination embraces the colonies, the national debt, the modern tax system, and the system of protection.	In England werden sie Ende des 17. Jahrhunderts systematisch zusammengefaßt im Kolonialsystem, Staatsschuldensystem, modernen Steuersystem und Protektionssystem.	ch31_clean.en-ch31_clean.de
These methods depend in part on brute force, for instance the colonial system.	Diese Methoden beruhn zum Teil auf brutalster Gewalt, z.B. das Kolonialsystem.	ch31_clean.en-ch31_clean.de
But they all employ the power of the state, the concentrated and organized force of society, to hasten, as in a hothouse, the process of transformation of the feudal mode of production into the capitalist mode, and to shorten the transition.	Alle aber benutzten die Staatsmacht, die konzentrierte und organisierte Gewalt der Gesellschaft, um den Verwandlungsprozeß der feudalen in die kapitalistische Produktionsweise treibhausmäßig zu fördern und die Übergänge abzukürzen.	ch31_clean.en-ch31_clean.de
Force is the midwife of every old society which is pregnant with a new one.	Die Gewalt ist der Geburtshelfer jeder alten Gesellschaft, die mit einer neuen schwanger geht.	ch31_clean.en-ch31_clean.de
It is itself an economic power.	Sie selbst ist eine ökonomische Potenz.	ch31_clean.en-ch31_clean.de
W. Howitt, a man who specializes in being a Christian,* says of the Christian colonial system, ‘The barbarities and desperate outrages of the so-called Christian race, throughout every region of the world, and upon every people they have been able to subdue, are not to be paralleled by those of any other race, however fierce, however untaught, and however reckless of mercy and of shame, in any age of the earth.’	Von dem christlichen Kolonialsystem sagt ein Mann, der aus dem Christentum eine Spezialität macht, W. Howitt: "Die Barbareien und ruchlosen Greueltaten der sog. christlichen Racen, in jeder Region der Welt und gegen jedes Volk, das sie unterjochen konnten, finden keine Parallele in irgendeiner Ära der Weltgeschichte, bei irgendeiner Race, ob noch so wild und ungebildet, mitleidlos und schamlos."	ch31_clean.en-ch31_clean.de
The history of Dutch colonial administration – and Holland was the model capitalist nation of the seventeenth century – ‘is one of the most extraordinary relations of treachery, bribery, massacre, and meanness’.	Die Geschichte der holländischen Kolonialwirtschaft - und Holland war die kapitalistische Musternation des 17. Jahrhunderts - "entrollt ein unübertreffbares Gemälde von Verrat, Bestechung, Meuchelmord und Nieder- tracht" .	ch31_clean.en-ch31_clean.de
Nothing is more characteristic than their system of stealing men in Celebes, in order to get slaves for Java.	Nichts charakteristischer als ihr System des Menschendiebstahls in Celebes, um Sklaven für Java zu erhalten.	ch31_clean.en-ch31_clean.de
Man-stealers were trained for this purpose.	Die Menschenstehler wurden zu diesem Zweck abgerichtet.	ch31_clean.en-ch31_clean.de
The thief, the interpreter and the seller were the chief agents in this trade, the native princes were the chief sellers.	Der Dieb, der Dolmetscher und der Verkäufer waren die Hauptagenten in diesem Handel, eingeborne Prinzen die Hauptverkäufer.	ch31_clean.en-ch31_clean.de
The young people thus stolen were hidden in secret dungeons on Celebes, until they were ready for sending to the slave-ships.	Die weggestohlne Jugend wurde in den Geheimgefängnissen von Celebes versteckt, bis reif zur Verschickung auf die Sklavenschiffe.	ch31_clean.en-ch31_clean.de
An official report says: ‘This one town of Macassar, for example, is full of secret prisons, one more horrible than the other, crammed with unfortunates, victims of greed and tyranny fettered in chains, forcibly torn from their families.’	Ein offizieller Bericht sagt: "Diese eine Stadt von Makassar z.B. ist voll von geheimen Gefängnissen, eins schauderhafter als das andre, gepfropft mit Elenden, Opfern der Habsucht und Tyrannei, in Ketten gefesselt, ihren Familien gewaltsam entrissen."	ch31_clean.en-ch31_clean.de
In order to get possession of Malacca, the Dutch bribed the Portuguese governor.	Um sich Malakkas zu bemächtigen, bestachen die Holländer den portugiesischen Gouverneur.	ch31_clean.en-ch31_clean.de
He let them into the town in 1641.	Er ließ sie 1641 in die Stadt ein.	ch31_clean.en-ch31_clean.de
They went straight to his house and assassinated him, so as to be able to ‘abstain’ from paying the £21, which was the amount of his bribe.	Sie eilten sofort zu seinem Hause und meuchelmordeten ihn, um auf die Zahlung der Bestechungssumme von 21.875 Pfd. St. zu "entsagen".	ch31_clean.en-ch31_clean.de
Wherever they set foot, devastation and depopulation followed.	Wo sie die Füße hinsetzten, folgte Verödung und Entvölkerung.	ch31_clean.en-ch31_clean.de
Banjuwangi, a province of Java, numbered over 80, inhabitants in 1750 and only 18, in 1811.	Banjuwangi, eine Provinz von Java, zählte 1750 über 80.000 Einwohner, 1811 nur noch 8.000.	ch31_clean.en-ch31_clean.de
That is peaceful commerce!	Das ist der doux commerce <sanfte Handel>!	ch31_clean.en-ch31_clean.de
The English East India Company, as is well known, received, apart from political control of India, the exclusive monopoly of the tea trade, as well as of the Chinese trade in general, and the transport of goods to and from Europe.	Die Englisch-Ostindische Kompanie erhielt bekanntlich, außer der politischen Herrschaft in Ostindien, das ausschließliche Monopol des Teehandels wie des chinesischen Handels überhaupt und des Gütertransports von und nach Europa.	ch31_clean.en-ch31_clean.de
But the coasting trade round India and between the islands,* as well as the internal trade of India, was the monopoly of the higher officials of the Company.	Aber die Küstenschiffahrt von Indien und zwischen den Inseln wie der Handel im Innern Indiens wurden Monopol der höhern Beamten der Kompanie.	ch31_clean.en-ch31_clean.de
The monopolies of salt, opium, betel and other commodities were inexhaustible mines of wealth.	Die Monopole von Salz, Opium, Betel und andren Waren waren unerschöpfliche Minen des Reichtums.	ch31_clean.en-ch31_clean.de
The officials themselves fixed the price and plundered the unfortunate Hindus at will.	Die Beamten selbst setzten die Preise fest und schanden nach Belieben den unglücklichen Hindu.	ch31_clean.en-ch31_clean.de
The Governor-General took part in this private traffic.	Der Generalgouverneur nahm teil an diesem Privathandel.	ch31_clean.en-ch31_clean.de
His favourites received contracts under conditions whereby they, cleverer than the alchemists, made gold out of nothing.	Seine Günstlinge erhielten Kontrakte unter Bedingungen, wodurch sie, klüger als die Alchimisten, aus nichts Gold machten.	ch31_clean.en-ch31_clean.de
Great fortunes sprang up like mushrooms in a day; primitive accumulation proceeded without the advance of even a shilling.	Große Vermögen sprangen wie die Pilze an einem Tage auf, die ursprüngliche Akkumulation ging vonstatten ohne Vorschuß eines Schillings.	ch31_clean.en-ch31_clean.de
The trial of Warren Hastings swarms with such cases.	Die gerichtliche Verfolgung des Warren Hastings wimmelt von solchen Beispielen.	ch31_clean.en-ch31_clean.de
Here is an instance.	Hier ein Fall.	ch31_clean.en-ch31_clean.de
A contract for opium was given to a certain Sullivan at the moment of his departure on an official mission to a part of India far removed from the opium district.	Ein Opiumkontrakt wird einem gewissen Sullivan zugeteilt, im Augenblick seiner Abreise - in öffentlichem Auftrage - nach einem von den Opiumdistrikten ganz entlegnen Teil Indiens.	ch31_clean.en-ch31_clean.de
Sullivan sold his contract to one Binn for £40,000; Binn sold it the same day for £60,000, and the ultimate purchaser who carried out the contract declared that he still extracted a tremendous profit from it.	Sullivan verkauft seinen Kontrakt für 40 000 Pfd.St. an einen ge- wissen Binn, Binn verkauft ihn denselben Tag für 60.000 Pfd.St., und der schließliche Käufer und Ausführer des Kontrakts erklärt, daß er hinterher noch einen ungeheuren Gewinn herausschlug.	ch31_clean.en-ch31_clean.de
According to one of the lists laid before Parliament, the Company and its officials obtained £6,000, between 1757 and 1766 from the Indians in the form of gifts.	Nach einer dem Parlament vorgelegten Liste ließen sich die Kompanie und ihre Beamten von 1757 bis 1766 von den Indiern 6 Millionen Pfd.St. schenken!	ch31_clean.en-ch31_clean.de
Between 1769 and 1770, the English created a famine by buying up all the rice and refusing to sell it again, except at fabulous prices.	Zwischen 1769 und 1770 fabrizierten die Engländer eine Hungersnot durch den Aufkauf von allem Reis und durch Weigerung des Wiederverkaufs außer zu fabelhaften Preisen.	ch31_clean.en-ch31_clean.de
The treatment of the indigenous population was, of course, at its most frightful in plantation-colonies set up exclusively for the export trade, such as the West Indies, and in rich and well-populated countries, such as Mexico and India, that were given over to plunder.	Die Behandlung der Eingebornen war natürlich am tollsten in den nur zum Exporthandel bestimmten Pflanzungen, wie Westindien, und in den dem Raubmord preisgegebenen reichen und dichtbevölkerten Ländern, wie Mexiko und Ostindien.	ch31_clean.en-ch31_clean.de
But even in the colonies properly so called, the Christian character of primitive accumulation was not belied.	Jedoch auch in den eigentlichen Kolonien verleugnete sich der christliche Charakter der ursprünglichen Akkumulation nicht.	ch31_clean.en-ch31_clean.de
In 1703 those sober exponents of Protestantism, the Puritans of New England, by decrees of their assembly set a premium of £ on every Indian scalp and every captured redskin; in 1720, a premium of £ was set on every scalp; in 1744, after Massachusetts Bay had proclaimed a certain tribe as rebels, the following prices were laid down: for a male scalp of 12 years and upwards, £ in new currency, for a male prisoner £105, for women and children prisoners £50, for the scalps of women and children £50.	Jene nüchternen Virtuosen des Protestantismus, die Puritaner Neu-Englands, setzten 1703 durch Beschlüsse ihrer Assembly eine Prämie von 40 Pfd.St. auf jedes indianische Skalp und jede gefangne Rothaut, 1720 Prämie von 100 Pfd.St. auf jedes Skalp, 1744, nachdem Massachusetts-Bay einen gewissen Stamm zum Rebellen erklärt hatte, folgende Preise: für männliches Skalp, 12 Jahre und darüber, 100 Pfd.St. neuer Währung, für männliche Gefangne 105 Pfd.St., für gefangne Weiber und Kinder 50 Pfd.St., für Skalps von Weibern und Kindern 50 Pfd. St.!	ch31_clean.en-ch31_clean.de
Some decades later, the colonial system took its revenge on the descendants of the pious pilgrim fathers, who had grown seditious in the meantime.	Einige Dezennien später rächte sich das Kolonialsystem an der unterdes aufrührerisch gewordnen Nachkommenschaft der frommen pilgrim fathers.	ch31_clean.en-ch31_clean.de
At English instigation, and for English money, they were tomahawked by the redskins.	Unter englischem Antrieb und Sold wurden sie tomahawked.	ch31_clean.en-ch31_clean.de
The British Parliament proclaimed bloodhounds and scalping as ‘means that God and Nature had given into its hand’.	Das britische Parlament erklärte Bluthunde und Skalpieren für "Mittel, welche Gott und die Natur in seine Hand gegeben".	ch31_clean.en-ch31_clean.de
The colonial system ripened trade and navigation as in a hothouse.	Das Kolonialsystem reifte treibhausmäßig Handel und Schiffahrt.	ch31_clean.en-ch31_clean.de
The ‘companies called Monopolia’ (Luther)* were powerful levers for the concentration of capital.	Die "Gesellschaften Monopolia" (Luther) waren gewaltige Hebel der Kapital-Konzentration.	ch31_clean.en-ch31_clean.de
The colonies provided a market for the budding manufactures, and a vast increase in accumulation which was guaranteed by the mother country’s monopoly of the market.	Den aufschießenden Manufakturen sicherte die Kolonie Absatzmarkt und eine durch das Marktmonopol potenzierte Akkumulation.	ch31_clean.en-ch31_clean.de
The treasures captured outside Europe by undisguised looting, enslavement and murder flowed back to the mother-country and were turned into capital there.	Der außerhalb Europa direkt durch Plünderung, Versklavung und Raubmord erbeutete Schatz floß ins Mutterland zurück und verwandelte sich hier in Kapital.	ch31_clean.en-ch31_clean.de
Holland, which first brought the colonial system to its full development, already stood at the zenith of its commercial greatness in 1648.	Holland, welches das Kolonialsystem zuerst völlig entwickelte, stand schon 1648 im Brennpunkt seiner Handelsgröße.	ch31_clean.en-ch31_clean.de
It was ‘in almost exclusive possession of the East Indian trade and the commerce between the south-east and the north-west of Europe.	Es war "in fast ausschließlichem Besitz des ostindischen Handels und des Verkehrs zwischen dem europäischen Südwesten und Nordosten.	ch31_clean.en-ch31_clean.de
	Seine Fischereien, Seewesen, Manufak- turen übertrafen die eines jeden andren Landes.	ch31_clean.en-ch31_clean.de
Its fisheries, its shipping and its manufactures surpassed those of any other country.	Die Kapitalien der Republik waren vielleicht bedeutender als die des übrigen Europa insgesamt."	ch31_clean.en-ch31_clean.de
The total capital of the Republic was probably greater than that of all the rest of Europe put together’.† Giilich forgets to add that by 1648 the people of Holland were more over-worked, poorer and more brutally oppressed than those of all the rest of Europe put together.	Gülich vergißt hinzuzusetzen: Hollands Volksmasse war schon 1648 mehr überarbeitet, verarmter und brutaler unterdrückt als die des übrigen Europas insgesamt.	ch31_clean.en-ch31_clean.de
Today, industrial supremacy brings with it commercial supremacy.	Heutzutage führt industrielle Suprematie die Handelssuprematie mit sich.	ch31_clean.en-ch31_clean.de
In the period of manufacture it is the reverse: commercial supremacy produces industrial predominance.	In der eigentlichen Manufakturperiode dagegen ist es die Handelssuprematie, die die industrielle Vorherrschaft gibt.	ch31_clean.en-ch31_clean.de
Hence the preponderant role played by the colonial system at that time.	Daher die vorwiegende Rolle, die das Kolonialsystem damals spielte.	ch31_clean.en-ch31_clean.de
It was the ‘strange God’ who perched himself side by side with the old divinities of Europe on the altar, and one fine day threw them all overboard with a shove and a kick.	Es war "der fremde Gott", der sich neben die alten Götzen Europas auf den Altar stellte und sie eines schönen Tages mit einem Schub und Bautz sämtlich über den Haufen warf.	ch31_clean.en-ch31_clean.de
It proclaimed the making of profit as the ultimate and the sole purpose of mankind.	Es proklamierte die Plusmacherei als letzten und einzigen Zweck der Menschheit.	ch31_clean.en-ch31_clean.de
The system of public credit, i.e. of national debts, the origins of which are to be found in Genoa and Venice as early as the Middle Ages, took possession of Europe as a whole during the period of manufacture.	Das System des öffentlichen Kredits, d.h. der Staatsschulden, dessen Ursprünge wir in Genua und Venedig schon im Mittelalter entdecken, nahm Besitz von ganz Europa während der Manufakturperiode.	ch31_clean.en-ch31_clean.de
The colonial system, with its maritime trade and its commercial wars, served as a forcing-house for the credit system.	Das Kolonialsystem mit seinem Seehandel und seinen Handelskriegen diente ihm als Treibhaus.	ch31_clean.en-ch31_clean.de
Thus it first took root in Holland.	So setzte es sich zuerst in Holland fest.	ch31_clean.en-ch31_clean.de
The national debt, i.e. the alienation [Veräusserung]* of the state – whether that state is despotic, constitutional or republican – marked the capitalist era with its stamp.	Die Staatsschuld, d.h. die Veräußerung des Staats - ob despotisch, konstitutionell oder republikanisch - drückt der kapitalistischen Ära ihren Stempel auf.	ch31_clean.en-ch31_clean.de
The only part of the so-called national wealth that actually enters into the collective possession of a modern nation is – the national debt.	Der einzige Teil des sogenannten Nationalreichtums, der wirklich in den Gesamtbesitz der modernen Völker eingeht, ist - ihre Staatsschuld.	ch31_clean.en-ch31_clean.de
Hence, quite consistently with this, the modern doctrine that a nation becomes the richer the more deeply it is in debt.	(243a) Daher ganz konsequent die moderne Doktrin, daß ein Volk um so reicher wird, je tiefer es sich verschuldet.	ch31_clean.en-ch31_clean.de
Public credit becomes the credo of capital.	Der öffentliche Kredit wird zum Credo des Kapitals.	ch31_clean.en-ch31_clean.de
And with the rise of national debt-making, lack of faith in the national debt takes the place of the sin against the Holy Ghost, for which there is no forgiveness.	Und mit dem Entstehen der Staatsverschuldung tritt an die Stelle der Sünde gegen den heiligen Geist, für die keine Verzeihung ist, der Treubruch an der Staatsschuld.	ch31_clean.en-ch31_clean.de
The public debt becomes one of the most powerful levers of primitive accumulation.	Die öffentliche Schuld wird einer der energischsten Hebel der ursprünglichen Akkumulation.	ch31_clean.en-ch31_clean.de
As with the stroke of an enchanter’s wand, it endows unproductive money with the power of creation and thus turns it into capital, without forcing it to expose itself to the troubles and risks inseparable from its employment in industry or even in usury.	Wie mit dem Schlag der Wünschelrute begabt sie das unproduktive Geld mit Zeugungskraft und verwandelt es so in Kapital, ohne daß es dazu nötig hätte, sich der von industrieller und selbst wucherischer Anlage unzertrennlichen Mühwaltung und Gefahr auszusetzen.	ch31_clean.en-ch31_clean.de
The state’s creditors actually give nothing away, for the sum lent is transformed into public bonds, easily negotiable, which go on functioning in their hands just as so much hard cash would.	Die Staatsgläubiger geben in Wirklichkeit nichts, denn die geliehene Summe wird in öffentliche leicht übertragbare Schuldscheine verwandelt, die in ihren Händen fortfungieren, ganz als wären sie ebensoviel Bargeld.	ch31_clean.en-ch31_clean.de
But furthermore, and quite apart from the class of idle rentiers thus created, the improvised wealth of the financiers who play the role of middlemen between the government and the nation, and the tax-farmers, merchants and private manufacturers, for whom a good part of every national loan performs the service of a capital fallen from heaven, apart from all these people, the national debt has given rise to joint-stock companies, to dealings in negotiable effects of all kinds, and to speculation: in a word, it has given rise to stock-exchange gambling and the modern bankocracy.	Aber auch abgesehn von der so geschaffnen Klasse müßiger Rentner und von dem improvisierten Reichtum der zwischen Regierung und Nation die Mittler spielenden Finanziers - wie auch von dem der Steuerpächter, Kaufleute, Privatfabrikanten, denen ein gut Stück jeder Staatsanleihe den Dienst eines vom Himmel gefallenen Kapitals leistet - hat die Staatsschuld die Aktiengesellschaften, den Handel mit negoziablen Effekten aller Art, die Agiotage emporgebracht, in einem Wort: das Börsenspiel und die moderne Bankokratie.	ch31_clean.en-ch31_clean.de
At their birth the great banks, decorated with national titles, were only associations of private speculators, who placed themselves by the side of governments and, thanks to the privileges they received, were in a position to advance money to those governments.	Von ihrer Geburt an waren die mit nationalen Titeln aufgestutzten großen Banken nur Gesellschaften von Privatspekulanten, die sich den Regierungen an die Seite stellten und, dank den erhaltnen Privilegien, ihnen Geld vorzuschießen imstande waren.	ch31_clean.en-ch31_clean.de
Hence the accumulation of the national debt has no more infallible measure than the successive rise in the stocks of these banks, whose full development dates from the founding of the Bank of England in 1694.	Daher hat die Akkumulation der Staatsschuld keinen unfehlbareren Gradmesser als das sukzessive Steigen der Aktien dieser Banken, deren volle Entfaltung von der Gründung der Bank von England datiert .	ch31_clean.en-ch31_clean.de
The Bank of England began by lendingits money to the government at 8 per cent; at the same time it was empowered by Parliament to coin money out of the same capital, by lending it a second time to the public in the form of bank-notes.	Die Bank von England begann damit, der Regierung ihr Geld zu 8% zu verleihen; gleichzeitig war sie vom Parlament ermächtigt, aus demselben Kapital Geld zu münzen, indem sie es dem Publikum nochmals in Form von Banknoten lieh.	ch31_clean.en-ch31_clean.de
It was allowed to use these notes for discounting bills, making advances on commodities and buying the precious metals.	Sie durfte mit diesen Noten Wechsel diskontieren, Waren beleihen und edle Metalle einkaufen.	ch31_clean.en-ch31_clean.de
It was not long before this credit-money, created by the bank itself, became the coin in which the latter made its loans to the state, and paid, on behalf of the state, the interest on the public debt.	Es dauerte nicht lange, so wurde dies von ihr selbst fabrizierte Kreditgeld die Münze, worin die Bank von England dem Staat Anleihen machte und für Rechnung des Staats die Zinsen der öffentlichen Schuld bezahlte.	ch31_clean.en-ch31_clean.de
It was not enough that the bank gave with one hand and took back more with the other; it remained, even while receiving money, the eternal creditor of the nation down to the last farthing advanced.	Nicht genug, daß sie mit einer Hand gab, um mit der andern mehr zurückzuempfangen; sie blieb auch, während sie empfing, ewige Gläubigerin der Nation bis zum letzten gegebnen Heller.	ch31_clean.en-ch31_clean.de
Gradually it became the inevitable receptacle of the metallic hoard of the country, and the centre of gravity of all commercial credit.	Allmählich wurde sie der unvermeidliche Behälter der Metallschätze des Landes und das Gravitationszentrum des gesamten Handelskredits.	ch31_clean.en-ch31_clean.de
	Um dieselbe Zeit, wo man in England aufhörte, Hexen zu verbrennen, fing man dort an, Banknotenfälscher zu hängen.	ch31_clean.en-ch31_clean.de
The writings of the time (Bolingbroke’s, for instance) show what effect was produced on their contemporaries by the sudden emergence of this brood of bankocrats, financiers, rentiers, brokers, stock-jobbers, etc.	Welchen Effekt auf die Zeitgenossen das plötzliche Auftauchen dieser Brut von Bankokraten, Finanziers, Rentiers, Maklern, Stockjobbers und Börsenwölfen machte, beweisen die Schriften jener Zeit, z.B. Bolingbrokes.	ch31_clean.en-ch31_clean.de
Along with the national debt there arose an international credit system, which often conceals one of the sources of primitive accumulation in this or that people.	(243b) Mit den Staatsschulden entstand ein internationales Kreditsystem, das häufig eine der Quellen der ursprünglichen Akkumulation bei diesem oder jenem Volk versteckt.	ch31_clean.en-ch31_clean.de
Thus the villainies of the Venetian system of robbery formed one of the secret foundations of Holland’s wealth in capital, for Venice in her years of decadence lent large sums of money to Holland.	So bilden die Gemeinheiten des venetianischen Raub- systems eine solche verborgne Grundlage des Kapitalreichtums von Holland, dem das verfallende Venedig große Geldsummen lieh.	ch31_clean.en-ch31_clean.de
There is a similar relationship between Holland and England.	Ebenso verhält es sich zwischen Holland und England.	ch31_clean.en-ch31_clean.de
By the beginning of the eighteenth century, Holland’s manufactures had been far outstripped. It had ceased to be the nation preponderant in commerce and industry.	Schon im Anfang des 18. Jahrhunderts sind die Manufakturen Hollands weit überflügelt und hat es aufgehört, herrschende Handels- und Industrienation zu sein.	ch31_clean.en-ch31_clean.de
One of its main lines of business, therefore, from 1701 to 1776, was the lending out of enormous amounts of capital, especially to its great rival England.	Eins seiner Hauptgeschäfte von 1701-1776 wird daher das Ausleihen ungeheurer Kapitalien, speziell an seinen mächtigen Konkurrenten England.	ch31_clean.en-ch31_clean.de
The same thing is going on today between England and the United States.	Ähnliches gilt heute zwischen England und den Vereinigten Staaten.	ch31_clean.en-ch31_clean.de
A great deal of capital, which appears today in the United States without any birth-certificate, was yesterday, in England, the capitalized blood of children.	Manch Kapital, das heute in den Vereinigten Staaten ohne Geburtsschein auftritt, ist erst gestern in England kapitalisiertes Kinderblut.	ch31_clean.en-ch31_clean.de
As the national debt is backed by the revenues of the state, which must cover the annual interest payments etc., the modern system of taxation was the necessary complement of the system of national loans.	Da die Staatsschuld ihren Rückhalt in den Staatseinkünften hat, die die jährlichen Zins- usw. Zahlungen decken müssen, so wurde das moderne Steuersystem notwendige Ergänzung des Systems der Nationalanleihen.	ch31_clean.en-ch31_clean.de
The loans enable the government to meet extraordinary expenses without the taxpayers feeling it immediately, but they still make increased taxes necessary as a consequence.	Die Anleihen befähigen die Regierung, außerordentliche Ausgaben zu bestreiten, ohne daß der Steuerzahler es sofort fühlt, aber sie erfordern doch für die Folge erhöhte Steuern.	ch31_clean.en-ch31_clean.de
On the other hand, the raising of taxation caused by the accumulation of debts contracted one after another compels the government always to have recourse to new loans for new extraordinary expenses.	Andrerseits zwingt die durch Anhäufung nacheinander kontrahierter Schulden verursachte Steuererhöhung die Regierung, bei neuen außerordentlichen Ausgaben stets neue Anleihen aufzunehmen.	ch31_clean.en-ch31_clean.de
The modern fiscal system, whose pivot is formed by taxes on the most necessary means of subsistence (and therefore by increases in their price), thus contains within itself the germ of automatic progression.	Die moderne Fiskalität, deren Drehungsachse die Steuern auf die notwendigsten Lebensmittel (also deren Verteuerung) bilden, trägt daher in sich selbst den Keim automatischer Progression.	ch31_clean.en-ch31_clean.de
Over-taxation is not an accidental occurrence, but rather a principle.	Die Überbesteuerung ist nicht ein Zwischenfall, sondern vielmehr Prinzip.	ch31_clean.en-ch31_clean.de
In Holland, therefore, where this system was first inaugurated, the great patriot, De Witt, extolled it in his Maxims* as the best system for making the wage-labourer submissive, frugal, industrious… and overburdened with work.	In Holland, wo dies System zuerst inauguriert, hat daher der große Patriot de Witt es in seinen Maximen gefeiert als das beste System, um den Lohnarbeiter unterwürfig, frugal, fleißig und ... mit Arbeit überladen zu machen.	ch31_clean.en-ch31_clean.de
Here, however, we are less concerned with the destructive influence it exercises on the situation of the wage-labourer than with the forcible expropriation, resulting from it, of peasants and artisans, in short, of all the constituents of the lower middle class.	Der zerstörende Einfluß, den es auf die Lage der Lohnarbeiter ausübt, geht uns hier jedoch weniger an als die durch es bedingte gewaltsame Expropriation des Bauern, des Handwerkers, kurz aller Bestandteile der kleinen Mittelklasse.	ch31_clean.en-ch31_clean.de
There are no two opinions about this, even among the bourgeois economists.	Darüber bestehn keine zwei Meinungen, selbst nicht bei den bürgerlichen Ökonomen.	ch31_clean.en-ch31_clean.de
Its effectiveness as an expropriating agent is heightened still further by the system of protection, which forms one of its integral parts.	Verstärkt wird seine expropriierende Wirksamkeit noch durch das Protektionssystem, das einer seiner integrierenden Teile ist.	ch31_clean.en-ch31_clean.de
The great part that the public debt and the fiscal system corresponding to it have played in the capitalization of wealth and the expropriation of the masses, has led many writers, like Cobbett,† Doubleday‡ and others, to seek here, incorrectly, the fundamental cause of the misery of the people in modern times.	Der große Anteil an der Kapitalisation des Reichtums und der Expropriation der Massen, der auf die öffentliche Schuld und das ihr entsprechende Fiskalitätssystem fällt, hat eine Menge Schriftsteller, wie Cobbett, Doubleday und andre, dahin geführt, mit Unrecht hierin die Grundursache des Elends der modernen Völker zu suchen.	ch31_clean.en-ch31_clean.de
The system of protection was an artificial means of manufacturing manufacturers, or expropriating independent workers, of capitalizing the national means of production and subsistence, and of forcibly cutting short the transition from a mode of production that was out of date to the modern mode of production.	Das Protektionssystem war ein Kunstmittel, Fabrikanten zu fabrizieren, unabhängige Arbeiter zu expropriieren, die nationalen Produktions- und Lebensmittel zu kapitalisieren, den Übergang aus der altertümlichen in die moderne Produktionsweise gewaltsam abzukürzen.	ch31_clean.en-ch31_clean.de
The European states tore each other to pieces to gain the patent of this invention, and, once they had entered into the service of the profit-mongers, they did not restrict themselves to plundering their own people, indirectly through protective duties, directly through export premiums, in the pursuit of this purpose. They also forcibly uprooted all industries in the neighbouring dependent countries, as for example England did with the Irish woollen manufacture.	Die europäischen Staaten rissen sich um das Patent dieser Erfindung, und einmal in den Dienst der Plusmacher eingetreten, brandschatzten sie zu jenem Behuf nicht nur das eigne Volk, indirekt durch Schutzzölle, direkt durch Exportprämien usw. In den abhängigen Nebenlanden wurde alle Industrie gewaltsam ausgerodet, wie z. B. die irische Wollmanufaktur durch England.	ch31_clean.en-ch31_clean.de
On the Continent of Europe the process was much simplified, following the example of Colbert.	Auf dem europäischen Kontinent ward nach Colberts Vorgang der Prozeß noch sehr vereinfacht.	ch31_clean.en-ch31_clean.de
The original capital for industry here came in part directly out of the state treasury.	Das ursprüngliche Kapital des Industriellen fließt hier zum Teil direkt aus dem Staatsschatz.	ch31_clean.en-ch31_clean.de
‘Why,’ cries Mirabeau, ‘why go so far to seek the cause of the manufacturing glory of Saxony before the war? One hundred and eighty millions of debts contracted by the sovereigns!’	"Warum", ruft Mirabeau, "so weit die Ursache des Manufakturglanzes Sachsens vor dem Siebenjährigen Krieg suchen gehn? 180 Millionen Staatsschulden!"	ch31_clean.en-ch31_clean.de
Colonial system, public debts, heavy taxes, protection, commercial wars, etc., these offshoots of the period of manufacture swell to gigantic proportions during the period of infancy of large-scale industry.	Kolonialsystem, Staatsschulden, Steuerwucht, Protektion, Handelskriege usw., diese Sprößlinge der eigentlichen Manufakturperiode, schwellen riesenhaft während der Kinderperiode der großen Industrie.	ch31_clean.en-ch31_clean.de
The birth of the latter is celebrated by a vast, Herod-like slaughter of the innocents.	Die Geburt der letztren wird gefeiert durch den großen herodischen Kinderraub.	ch31_clean.en-ch31_clean.de
Like the royal navy, the factories were recruited by means of the press-gang.	Wie die königliche Flotte, rekrutieren sich die Fabriken vermittelst der Presse.	ch31_clean.en-ch31_clean.de
Though Sir F. M. Eden is indifferent to the horrors of the expropriation of the agricultural population from the soil, from the last third of the fifteenth century up to his own time; though he shows great self-satisfaction in congratulating his country on this process, which was ‘essentia’ in order to establish capitalist agriculture and ‘the due proportion between arable and pasture land’; despite this, he does not show the same economic insight into the necessity of child-stealing and child-slavery for the transformation of manufacturing production into factory production and the establishment of the true relation between capital and labour-power.	So blasiert Sir F. M. Eden ist über die Greuel der Expropriation des Landvolks von Grund und Boden seit dem letzten Drittel des 15. Jahrhunderts bis zu seiner Zeit, dem Ende des 18. Jahrhunderts, so selbstgefällig er gratuliert zu diesem Prozeß, "notwendig", um die kapitalistische Agrikultur und "das wahre Verhältnis von Ackerland und Viehweide herzustellen", beweist er dagegen nicht dieselbe ökonomische Einsicht in die Notwendigkeit des Kinderraubs und der Kindersklaverei für die Verwandlung des Manufakturbetriebs in den Fabrikbetrieb und die Herstellung des wahren Verhältnisses von Kapital und Arbeitskraft.	ch31_clean.en-ch31_clean.de
He says: ‘It may, perhaps be worthy the attention of the public to consider, whether any manufacture, which, in order to be carried on successfully, requires that cottages and workhouses should be ransacked for poor children; that they should be employed by turns during the greater part of the night and robbed of that rest which, though indispensable to all, is most required by the young; and that numbers of both sexes, of different ages and dispositions, should be collected together in such a manner that the contagion of example cannot but lead to profligacy and debauchery; will add to the sum of individual or national felicity?’	Er sagt: "Es mag vielleicht der Erwägung des Publikums wert sein, ob irgendeine Manufaktur, die zu ihrer erfolgreichen Ausführung Cottages und Workhouses von armen Kindern ausplündern muß, damit sie, truppweis sich ablösend, den größten Teil der Nacht durch abgerackert und der Ruhe beraubt werden; eine Manufaktur, die außerdem Haufen beiderlei Geschlechts, von verschiednen Altersstufen und Neigungen, so zusammenhudelt, daß die Ansteckung des Beispiels zu Verworfenheit und Liederlichkeit führen muß - ob solch eine Manufaktur die Summe des nationalen und individuellen Glücks vermehren kann?"	ch31_clean.en-ch31_clean.de
‘In the counties of Derbyshire, Nottinghamshire, and more particularly in Lancashire,’ says Fielden, ‘the newly-invented machinery was used in large factories built on the sides of streams capable of turning the water-wheel.	"In Derbyshire, Nottinghamshire und besonders Lancashire", sagt Fielden, "wurde die jüngst erfundne Maschinerie angewandt in großen Fabriken, dicht bei Strömen, fähig, das Wasserrad zu drehn.	ch31_clean.en-ch31_clean.de
Thousands of hands were suddenly required in these places, remote from towns; and Lancashire, in particular, being, till then, comparatively thinly populated and barren, a population was all that she now wanted.	Tausende von Händen waren plötzlich erheischt an diesen Plätzen, fern von den Städten; und Lancashire namentlich, bis zu jener Zeit vergleichungsweis dünn bevölkert und unfruchtbar, bedurfte jetzt vor allem einer Population.	ch31_clean.en-ch31_clean.de
The small and nimble fingers of little children being by very far the most in request, the custom instantly sprang up of procuring apprentices (!) from the different parish workhouses of London, Birmingham, and elsewhere.	Die kleinen und flinken Finger waren vor allem in Requisition. Sofort sprang die Gewohnheit auf, Lehrlinge (!) aus den verschiednen Pfarrei-Workhouses von London, Birmingham und sonstwo zu beziehn.	ch31_clean.en-ch31_clean.de
Many, many thousands of these little, hapless creatures were sent down into the north, being from the age of 7 to the age of 13 or 14 years old.	Viele, viele Tausende dieser kleinen hilflosen Kreaturen, vom 7. bis zum 13. oder 14. Jahr, wurden so nach dem Norden spediert.	ch31_clean.en-ch31_clean.de
The custom was for the master’ (i.e. the child-stealer) ‘to clothe his apprentices and to feed and lodge them in an “apprentice house” near the factory; overseers were appointed to see to the works, whose interest it was to work the children to the utmost, because their pay was in proportion to the quantity of work that they could exact.	Es war die Gewohnheit für den Meister" (d.h. den Kinderdieb), "seine Lehrlinge zu kleiden, nähren und logieren in einem Lehrlingshaus nah bei der Fabrik. Aufseher wurden bestellt, um ihre Arbeit zu überwachen. Es war das Interesse dieser Sklaventreiber, die Kinder aufs äußerste abzuarbeiten, denn ihre Zahlung stand im Verhältnis zum Produktenquantum, das aus dem Kind erpreßt werden konnte. Grausamkeit war natürliche Folge ...	ch31_clean.en-ch31_clean.de
Cruelty was, of course, the consequence… In many of the manufacturing districts, but particularly, I am afraid, in the guilty county to which I belong (Lancashire), cruelties the most heart-rending were practised upon the unoffending and friendless creatures who were thus consigned to the charge of master-manufacturers; they were harassed to the brink of death by excess of labour… were flogged, fettered and tortured in the most exquisite refinement of cruelty;… they were in many cases starved to the bone while flogged to their work and… even in some instances… were driven to commit suicide… The beautiful and romantic valleys of Derbyshire, Nottinghamshire and Lancashire, secluded from the public eye, became the dismal solitudes of torture, and of many a murder.	In vielen Fabrikdistrikten, besonders Lancashires, wurden die herzzereißendsten Torturen verübt an diesen harmlosen und freundlosen Kreaturen, die den Fabrikherrn konsigniert waren. Sie wurden zu Tod gehetzt durch Arbeitsexzesse ... sie wurden gepeitscht, gekettet und gefoltert mit dem ausgesuchtesten Raffinement von Grausamkeit; sie wurden in vielen Fällen bis auf die Knochen ausgehungert, während die Peitsche sie an der Arbeit hielt ... Ja, in einigen Fällen wurden sie zum Selbstmord getrieben! ... Die schönen und romantischen Täler von Derbyshire, Nottinghamshire und Lancashire, abgeschlossen vom öffentlichen Auge, wurden grause Einöden von Tortur und - oft von Mord! ... Die Profite der Fabrikanten waren enorm.	ch31_clean.en-ch31_clean.de
The profits of manufacturers were enormous; but this only whetted the appetite that it should have satisfied, and therefore the manufacturers had recourse to an expedient that seemed to secure to them those profits without any possibility of limit; they began the practice of what is termed “night-working”, that is, having tired one set of hands, by working them throughout the day, they had another set ready to go on working throughout the night; the day-set getting into the beds that the night-set had just quitted, and in their turn again, the night-set getting into the beds that the day-set quitted in the morning.	Das wetzte nur ihren Werwolfsheißhunger. Sie begannen die Praxis der Nachtarbeit, d.h. nachdem sie eine Gruppe Hände durch das Tagwerk gelähmt, hielten sie eine andre Gruppe für das Nachtwerk bereit; die Tagesgruppe wanderte in die Betten, welche die Nachtgruppe grade verlassen hatte und vice versa.	ch31_clean.en-ch31_clean.de
It is a common tradition in Lancashire, that the beds never get cold.’	Es ist Volksüberlieferung in Lancashire, daß die Betten nie abkühlten."	ch31_clean.en-ch31_clean.de
With the development of capitalist production during the period of manufacture, the public opinion of Europe lost its last remnant of shame and conscience.	Mit der Entwicklung der kapitalistischen Produktion während der Manufakturperiode hatte die öffentliche Meinung von Europa den letzten Rest von Schamgefühl und Gewissen eingebüßt.	ch31_clean.en-ch31_clean.de
The nations bragged cynically of every infamy that served them as a means to the accumulation of capital.	Die Nationen renommierten zynisch mit jeder Infamie, die ein Mittel zu Kapitalakkumulation.	ch31_clean.en-ch31_clean.de
Read, for example, the naïve commercial annals of the worthy A. Anderson. * Here it is trumpeted forth as a triumph of English statesmanship that, at the Peace of Utrecht, England extorted from the Spaniards, by the Asiento Treaty, the privilege of being allowed to ply the slave trade, not only between Africa and the English West Indies, which it had done until then, but also between Africa and Spanish America.	Man lese z.B. die naiven Handelsannalen des Biedermanns A. Anderson. Hier wird es als Triumph englischer Staatsweisheit ausposaunt, daß England im Frieden von Utrecht den Spaniern durch den Asientovertrag das Privilegium abzwang, den Negerhandel, den es bisher nur zwischen Afrika und dem englischen Westindien betrieb, nun auch zwischen Afrika und dem spanischen Amerika betreiben zu dürfen.	ch31_clean.en-ch31_clean.de
England thereby acquired the right to supply Spanish America until 1743 with 4, Negroes a year.	England erhielt das Recht, das spanische Amerika bis 1743 jährlich mit 4.800 Negern zu versorgen.	ch31_clean.en-ch31_clean.de
At the same time this threw an official cloak over British smuggling.	Dies gewährte zugleich einen offiziellen Deckmantel für den britischen Schmuggel.	ch31_clean.en-ch31_clean.de
Liverpool grew fat on the basis of the slave trade.	Liverpool wuchs groß auf der Basis des Sklavenhandels.	ch31_clean.en-ch31_clean.de
This was its method of primitive accumulation.	Er bildet seine Methode der ursprünglichen Akkumulation.	ch31_clean.en-ch31_clean.de
And even to the present day, the Liverpool ‘quality’ have remained the Pindars of the slave trade,* which – as noted in the work by Dr Aikin we have just quoted – ‘has coincided with that spirit of bold adventure which has characterized the trade of Liverpool and rapidly carried it to its present state of prosperity; has occasioned vast employment for shipping and sailors, and greatly augmented the demand for the manufactures of the country’.† In 1730 Liverpool employed 15 ships in the slave trade; in 1751,53; in 1760,74; in 1770,96; and in 1792,132.	Und bis heutzutag blieb die Liverpooler "Ehrbarkeit" Pindar des Sklavenhandels, welcher - vgl. die zitierte Schrift des Dr. Aikin von 1795 - "den kommerziellen Unternehmungsgeist bis zur Leidenschaft steigere, famose Seeleute bilde und enormes Geld einbringe". Liverpool beschäftigte 1730 im Sklavenhandel 15 Schiffe, 1751: 53, 1760: 74, 1770: 96 und 1792: 132.	ch31_clean.en-ch31_clean.de
While the cotton industry introduced child-slavery into England, in the United States it gave the impulse for the transformation of the earlier, more or less patriarchal slavery into a system of commercial exploitation.	Während sie die Kindersklaverei in England einführte, gab die Baumwollindustrie zugleich den Anstoß zur Verwandlung der früher mehr oder minder patriarchalischen Sklavenwirtschaft der Vereinigten Staaten in ein kommerzielles Exploitationssystem.	ch31_clean.en-ch31_clean.de
In fact the veiled slavery of the wage-labourers in Europe needed the unqualified slavery of the New World as its pedestal.	Überhaupt bedurfte die verhüllte Sklaverei der Lohnarbeiter in Europa zum Piedestal die Sklaverei sans phrase <ohne Hülle> in der neuen Welt.	ch31_clean.en-ch31_clean.de
Tantae molis erat‡ to unleash the ‘eternal natural laws’ of the capitalist mode of production, to complete the process of separation between the workers and the conditions of their labour, to transform, at one pole, the social means of production and subsistence into capital, and at the opposite pole, the mass of the population into wage-labourers, into the free ‘labouring poor’, that artificial product of modern history.	Tantae molis erat <solcher Mühe bedurfte es>, die "ewigen Naturgesetze" der kapitalistischen Produktionsweise zu entbinden, den Scheidungsprozeß zwischen Arbeitern und Arbeitsbedingungen zu vollziehn, auf dem einen Pol die gesellschaft- lichen Produktions- und Lebensmittel in Kapital zu verwandeln, auf dem Gegenpol die Volksmasse in Lohnarbeiter, in freie "arbeitende Arme", dies Kunstprodukt der modernen Geschichte.	ch31_clean.en-ch31_clean.de
If money, according to Augier, ‘comes into the world with a congenital blood-stain on one cheek,’ capital comes dripping from head to toe, from every pore, with blood and dirt.15	Wenn das Geld, nach Augier, "mit natürlichen Blutflecken auf einer Backe zur Welt kommt" so das Kapital von Kopf bis Zeh, aus allen Poren, blut- und schmutztriefend.	ch31_clean.en-ch31_clean.de

