Chapter 33: The Modern Theory of Colonization Political economy confuses, on principle, two different kinds of private property, one of which rests on the labour of the producer himself, and the other on the exploitation of the labour of others.	FÜNFUNDZWANZIGSTES KAPITEL Die moderne Kolonisationstheorie Die politische Ökonomie verwechselt prinzipiell zwei sehr verschiedne Sorten Privateigentum, wovon das eine auf eigner Arbeit des Produzenten beruht, das andre auf der Ausbeutung fremder Arbeit.	ch33_clean.en-ch33_clean.de
It forgets that the latter is not only the direct antithesis of the former, but grows on the former’s tomb and nowhere else.	Sie vergißt, daß das letztre nicht nur den direkten Gegensatz des erstren bildet, sondern auch bloß auf seinem Grab wächst.	ch33_clean.en-ch33_clean.de
In Western Europe, the homeland of political economy, the process of primitive accumulation has more or less been accomplished.	Im Westen von Europa, dem Heimatsland der politischen Ökonomie, ist der Prozeß der ursprünglichen Akkumulation mehr oder minder vollbracht.	ch33_clean.en-ch33_clean.de
Here the capitalist regime has either directly subordinated to itself the whole of the nation’s production, or, where economic relations are less developed, it has at least indirect control of those social layers which, although they belong to the antiquated mode of production, still continue to exist side by side with it in a state of decay.	Das kapitalistische Regiment hat hier entweder die ganze nationale Produktion sich direkt unterworfen, oder, wo die Verhältnisse noch unentwickelter, kontrolliert es wenigstens indirekt die neben ihm fortexistierenden, verkommenen, der veralteten Produktionsweise angehörigen Gesellschaftsschichten.	ch33_clean.en-ch33_clean.de
To this ready-made world of capital, the political economist applies the notions of law and of property inherited from a pre-capitalist world, with all the more anxious zeal and all the greater unction, the more loudly the facts cry out in the face of his ideology.	Auf diese fertige Welt des Kapitals wendet der politische Ökonom mit desto ängstlicherem Eifer und desto größerer Salbung die Rechts- und Eigentumsvorstellungen der vorkapitalistischen Welt an, je lauter die Tatsachen seiner Ideologie ins Gesicht schreien.	ch33_clean.en-ch33_clean.de
It is otherwise in the colonies.	Anders in den Kolonien.	ch33_clean.en-ch33_clean.de
There the capitalist regime constantly comes up against the obstacle presented by the producer, who, as owner of his own conditions of labour, employs that labour to enrich himself instead of the capitalist.	Das kapitalistische Regiment stößt dort überall auf das Hindernis des Produzenten, welcher als Besitzer seiner eignen Arbeitsbedingungen sich selbst durch seine Arbeit bereichert statt den Kapitalisten.	ch33_clean.en-ch33_clean.de
The contradiction between these two diametrically opposed economic systems has its practical manifestation here in the struggle between them.	Der Widerspruch dieser zwei diametral entgegengesetzten ökonomischen Systeme betätigt sich hier praktisch in ihrem Kampf.	ch33_clean.en-ch33_clean.de
Where the capitalist has behind him the power of the mother country, he tries to use force to clear out of the way the modes of production and appropriation which rest on the personal labour of the independent producer.	Wo der Kapitalist die Macht des Mutterlandes im Rücken hat, sucht er die auf eigner Arbeit beruhende Produktions- und Aneignungsweise gewaltsam aus dem Weg zu räumen.	ch33_clean.en-ch33_clean.de
The same interest which, in the mother country, compels the sycophant of capital, the political economist, to declare that the capitalist mode of production is theoretically its own opposite, this same interest, in the colonies, drives him ‘to make a clean breast of it’, and to proclaim aloud the antagonism between the two modes of production.	Dasselbe Interesse, welches den Sykophanten des Kapitals, den politischen Ökonomen, im Mutterland bestimmt, die kapitalistische Produktionsweise theoretisch für ihr eignes Gegenteil zu erklären, dasselbe Interesse treibt ihn hier "to make a clean breast of it" <"die Sache offen herauszusagen"> und den Gegensatz beider Produktionsweisen laut zu proklamieren.	ch33_clean.en-ch33_clean.de
To this end he demonstrates that the development of the social productivity of labour, co-operation, division of labour, application of machinery on a large scale, and so on, are impossible without the expropriation of the workers and the corresponding transformation of their means of production into capital.	Zu diesem Behuf weist er nach, wie die Entwicklung der gesellschaftlichen Produktivkraft der Arbeit, Kooperation, Arbeitsteilung, Anwendung der Maschinerie im großen usw. unmöglich sind ohne die Expropriation der Arbeiter und die entsprechende Verwandlung ihrer Produktionsmittel in Kapital.	ch33_clean.en-ch33_clean.de
In the interest of the so-called wealth of the nation, he seeks for artificial means to ensure the poverty of the people.	Im Interesse des sog. Nationalreichtums sucht er nach Kunstmitteln zur Herstellung der Volksarmut.	ch33_clean.en-ch33_clean.de
Here his apologetic armour crumbles on”, piece by piece, like rotten touchwood.	Sein apologetischer Panzer zerbröckelt hier Stück für Stück wie mürber Zunder.	ch33_clean.en-ch33_clean.de
It is the great merit of E. G. Wakefield to have discovered, not something new about the colonies, but, in the colonies, the truth about capitalist relations in the mother country.	Es ist das große Verdienst E. G. Wakefields, nicht irgend etwas Neues über die Kolonien , aber in den Kolonien die Wahrheit über die kapitalistischen Verhältnisse des Mutterlands entdeckt zu haben.	ch33_clean.en-ch33_clean.de
Just as the system of protection originally had the objective of manufacturing capitalists artificially in the mother country, so Wakefield’s theory of colonization, which England tried for a time to enforce by Act of Parliament, aims at manufacturing wage-labourers in the colonies.	Wie das Protektionssystem in seinen Ursprüngen die Fabrikation von Kapitalisten im Mutterland, so erstrebt Wakefields Kolonisationstheorie, welche England eine Zeitlang gesetzlich ins Werk zu setzen suchte, die Fabrikation von Lohnarbeitern in den Kolonien.	ch33_clean.en-ch33_clean.de
This is what he calls ‘systematic colonization’.	Das nennt er "systematic colonization" (systematische Kolonisation).	ch33_clean.en-ch33_clean.de
First of all, Wakefield discovered that, in the colonies, property in money, means of subsistence, machines and other means of production does not as yet stamp a man as a capitalist if the essential complement to these things is missing: the wage-labourer, the other man, who is compelled to sell himself of his own free will.	Zunächst entdeckte Wakefield in den Kolonien, daß das Eigentum an Geld, Lebensmitteln, Maschinen und andren Produktionsmitteln einen Menschen noch nicht zum Kapitalisten stempelt, wenn die Ergänzung fehlt, der Lohnarbeiter, der andre Mensch, der sich selbst freiwillig zu verkaufen gezwungen ist.	ch33_clean.en-ch33_clean.de
He discovered that capital is not a thing, but a social relation between persons which is mediated through things.	Er entdeckte, daß das Kapital nicht eine Sache ist, sondern ein durch Sachen vermitteltes gesellschaftliches Verhältnis zwischen Personen.	ch33_clean.en-ch33_clean.de
A Mr Peel, he complains, took with him from England to the Swan River district of Western Australia means of subsistence and of production to the amount of £50,000.	Herr Peel, jammert er uns vor, nahm Lebensmittel und Produktionsmittel zum Belauf von 50.000 Pfd. St. aus England nach dem Swan River, Neuholland, mit.	ch33_clean.en-ch33_clean.de
This Mr Peel even had the foresight to bring besides, 3, persons of the working class, men, women and children.	Herr Peel war so vorsichtig, außerdem 3.000 Personen der arbeitenden Klasse, Männer, Weiber und Kinder mitzubringen.	ch33_clean.en-ch33_clean.de
Once he arrived at his destination, ‘Mr Peel was left without a servant to make his bed or fetch him water from the river.’	Einmal am Bestimmungsplatz angelangt, "blieb Herr Peel, ohne einen Diener, sein Bett zu machen oder ihm Wasser aus dem Fluß zu schöpfen" .	ch33_clean.en-ch33_clean.de
Unhappy Mr Peel, who provided for everything except the export of English relations of production to Swan River!	Unglücklicher Herr Peel, der alles vorsah, nur nicht den Export der englischen Produktionsverhältnisse nach dem Swan River!	ch33_clean.en-ch33_clean.de
For the understanding of the following discoveries of Wakefield, let us make two preliminary remarks: We know that the means of production and subsistence, while they remain the property of the immediate producer, are not capital.	Zum Verständnis der folgenden Entdeckungen Wakefields zwei Vorbemerkungen. Man weiß: Produktions- und Lebensmittel, als Eigentum des unmittelbaren Produzenten, sind kein Kapital.	ch33_clean.en-ch33_clean.de
They only become capital under circumstances in which they serve at the same time as means of exploitation of, and domination over, the worker.	Sie werden Kapital nur unter Bedingungen, worin sie zugleich als Exploitations- und Beherrschungsmittel des Arbeiters dienen.	ch33_clean.en-ch33_clean.de
But this, their capitalist soul, is so intimately wedded, in the mind of the political economist, to their material substance, that he christens them capital under all circumstances, even where they are its exact opposite.	Diese ihre kapitalistische Seele ist aber im Kopfe des politischen Ökonomen so innig mit ihrer stofflichen Substanz vermählt, daß er sie unter allen Umständen Kapital tauft, auch wo sie das grade Gegenteil sind.	ch33_clean.en-ch33_clean.de
Thus it is with Wakefield.	So bei Wakefield.	ch33_clean.en-ch33_clean.de
Further: he describes the splitting-up of the means of production into the individual property of many mutually independent and self-employed workers as equal division of capital.	Ferner: die Zersplitterung der Produktionsmittel als individuelles Eigentum vieler voneinander unabhängigen, selbstwirtschaftenden Arbeiter nennt er gleiche Teilung des Kapitals.	ch33_clean.en-ch33_clean.de
The political economist is like the feudal jurist, who used to attach the labels supplied by feudal law even to relationships which were purely monetary.	Es geht dem politischen Ökonomen wie dem feudalen Juristen. Letzterer klebte auch auf reine Geldverhältnisse seine feudalen Rechtsetiketten.	ch33_clean.en-ch33_clean.de
‘If,’ says Wakefield, ‘all the members of the society are supposed to possess equal portions of capital… no man would have a motive for accumulating more capital than he could use with his own hands.	"Wäre", sagt Wakefield, "das Kapital unter alle Mitglieder der Gesellschaft in gleiche Portionen verteilt, so hätte kein Mensch ein Interesse, mehr Kapital zu akkumulieren, als er mit seinen eignen Händen anwenden kann.	ch33_clean.en-ch33_clean.de
This is to some extent the case in new American settlements, where a passion for owning land prevents the existence of a class of labourers for hire.’	Dies ist in gewissem Grad der Fall in neuen amerikanischen Kolonien, wo die Leidenschaft für Grundeigentum die Existenz einer Klasse von Lohnarbeitern verhindert."	ch33_clean.en-ch33_clean.de
So long, therefore, as the worker can accumulate for himself – and this he can do so long as he remains in possession of his means of production – capitalist accumulation and the capitalist mode of production are impossible.	Solange also der Arbeiter für sich selbst akkumulieren kann, und das kann er, solange er Eigentümer seiner Produktionsmittel bleibt, ist die kapitalistische Akkumulation und die kapitalistische Produktionsweise unmöglich.	ch33_clean.en-ch33_clean.de
The class of wage-labourers essential to these is lacking.	Die dazu unentbehrliche Klasse der Lohnarbeiter fehlt.	ch33_clean.en-ch33_clean.de
How then, in old Europe, was the expropriation of the worker from his conditions of labour brought about? In other words, how did capital and wage-labour come into existence?	Wie wurde nun im alten Europa die Expropriation des Arbeiters von seinen Arbeitsbedingungen, daher Kapital und Lehnarbeit, hergestellt?	ch33_clean.en-ch33_clean.de
By a social contract of a quite original kind.	Durch einen contrat social <Gesellschaftsvertrag> ganz origineller Art.	ch33_clean.en-ch33_clean.de
‘Mankind have adopted a… simple contrivance for promoting the accumulation of capital,’ which, of course, had dangled in front of them since the time of Adam as the ultimate and only goal of their existence, ‘they have divided themselves into owners of capital and owners of labour… This division was the result of concert and combination.’	"Die Menschheit ... adoptierte eine einfache Methode zur Förderung der Akkumulation des Kapitals", die ihr natürlich seit Adams Zeiten als letzter und einziger Zweck ihres Daseins vorschwebte; "sie teilte sich in Eigner von Kapital und Eigner von Arbeit ... diese Teilung war das Resultat freiwilliger Verständigung und Kombination."	ch33_clean.en-ch33_clean.de
In short: the mass of mankind expropriated itself in honour of the ‘accumulation of capital’.	Mit einem Wort: die Masse der Menschheit expropriierte sich selbst zu Ehren der "Akkumulation des Kapitals".	ch33_clean.en-ch33_clean.de
Now one would think that this instinct of selfdenying fanaticism would especially run riot in the colonies, the only places where the men and the conditions exist to turn a social contract from a dream into a reality.	Nun sollte man glauben, der Instinkt dieses selbstentsagenden Fanatismus müsse sich namentlich in Kolonien den Zügel frei schießen lassen, wo allein Menschen und Umstände existieren, welche einen contrat social aus dem Traumreich in das der Wirklichkeit übersetzen könnten.	ch33_clean.en-ch33_clean.de
So why should ‘systematic colonization’ be called in to replace its opposite, spontaneous and unregulated colonization?	Aber wozu dann überhaupt die "systematische Kolonisation" im Gegensatz zur naturwüchsigen Kolonisation?	ch33_clean.en-ch33_clean.de
Here is one reason: ‘In the Northern States of the American Union, it may be doubted whether so many as a tenth of the people would fall under the description of hired labourers… In England… the labouring class compose the bulk of the people.’	Aber, aber: "in den nördlichen Staaten der amerikanischen Union ist es zweifelhaft, ob ein Zehntel der Bevölkerung der Kategorie der Lohnarbeiter angehört ... In England ... besteht die große Volksmasse aus Lohnarbeitern."	ch33_clean.en-ch33_clean.de
Indeed, the drive to self-expropriation for the glory of capital exists so little in the case of working humanity, that slavery, according to Wakefield himself, is the sole natural basis of colonial wealth.	Ja, der Selbstexpropriationstrieb der arbeitenden Menschheit zu Ehren des Kapitals existiert so wenig, daß Sklaverei, selbst nach Wakefield, die einzige naturwüchsige Grundlage des Kolonialreichtums ist.	ch33_clean.en-ch33_clean.de
His systematic colonization is a mere makeshift, resulting from the fact that he has free men, not slaves, to deal with.	Seine systematische Kolonisation ist ein bloßes pis aller <ein Notbehelf>, da er nun einmal mit Freien statt mit Sklaven zu tun hat.	ch33_clean.en-ch33_clean.de
‘The first Spanish settlers in Saint Domingo did not obtain labourers from Spain.	"Die ersten spanischen Ansiedler in Santo Domingo erhielten keine Arbeiter aus Spanien.	ch33_clean.en-ch33_clean.de
But, without labourers’, (i.e. without slavery) ‘their capital must have perished, or, at least, must soon have been diminished to that small amount which each individual could employ with his own hands.	Aber ohne Arbeiter" (d.h. ohne Sklaverei) "wäre des Kapital kaputt gegangen oder wenigstens auf die kleinen Massen zusammengeschrumpft, worin jedes Individuum es mit seinen eignen Händen anwenden kann.	ch33_clean.en-ch33_clean.de
This has actually occurred in the last colony founded by Englishmen – the Swan River Settlement – where a great mass of capital, of seeds, implements, and cattle, has perished for want of labourers to use it, and where no settler has preserved much more capital than he can employ with his own hands.’	Dies fand wirklich statt in der letzten von den Engländern gegründeten Kolonie, wo ein großes Kapital in Samen, Vieh und Instrumenten unterging am Mangel von Lohnarbeitern und wo kein Ansiedler viel mehr Kapital besitzt, als er mit seinen eignen Händen anwenden kann."	ch33_clean.en-ch33_clean.de
We have seen that the expropriation of the mass of the people from the soil forms the basis of the capitalist mode of production.	Man sah: die Expropriation der Volksmasse von Grund und Boden bildet die Grundlage der kapitalistischen Produktionsweise.	ch33_clean.en-ch33_clean.de
The essence of a free colony, on the contrary, consists in this, that the bulk of the soil is still public property, and every settler on it can therefore turn part of it into his private property and his individual means of production, without preventing later settlers from performing the same operation.	Das Wesen einer freien Kolonie besteht umgekehrt darin, daß die Masse des Bodens noch Volkseigentum ist und jeder Ansiedler daher einen Teil davon in sein Privateigentum und individuelles Produktionsmittel verwandeln kann, ohne den spätren Ansiedler an derselben Operation zu verhindern.	ch33_clean.en-ch33_clean.de
This is the secret both of the prosperity of the colonies and of their cancerous affliction -their resistance to the establishment of capital.	Dies ist das Geheimnis sowohl der Blüte der Kolonien als ihres Krebsschadens - ihres Widerstands wider die Ansiedlung des Kapitals.	ch33_clean.en-ch33_clean.de
‘Where land is very cheap and all men are free, where every one who so pleases can easily obtain a piece of land for himself, not only is labour very dear, as respects the labourer’s share of the produce, but the difficulty is to obtain combined labour at any price.’	"Wo Land sehr wohlfeil ist und alle Menschen frei sind, wo jeder nach Wunsch ein Stück Land für sich selbst erhalten kann, ist Arbeit nicht nur sehr teuer, was den Anteil des Arbeiters an seinem Produkt angeht, sondern die Schwierigkeit ist, kombinierte Arbeit zu irgendeinem Preis zu erhalten."	ch33_clean.en-ch33_clean.de
In the colonies the separation of the worker from the conditions of labour and from the soil, in which they are rooted, does not yet exist, or only sporadically, or on too limited a scale. Hence the separation of agriculture from industry does not exist either, nor have any of the domestic industries of the countryside been destroyed. Whence then is to come the home market for capital?	Da in den Kolonien die Scheidung des Arbeiters von den Arbeitsbedingungen und ihrer Wurzel, dem Grund und Boden, noch nicht existiert oder nur sporadisch oder auf zu beschränktem Spielraum, existiert auch noch nicht die Losscheidung der Agrikultur von der Industrie, noch nicht die Vernichtung der ländlich häuslichen Industrie, und wo soll da der innere Markt für das Kapital herkommen?	ch33_clean.en-ch33_clean.de
‘No part of the population of America is exclusively agricultural, excepting slaves and their employers who combine capital and labour in particular works.	"Kein Teil der Bevölkerung Amerikas ist ausschließlich agrikol, mit Ausnahme der Sklaven und ihrer Anwender, die Kapital und Arbeit für große Werke kombinieren.	ch33_clean.en-ch33_clean.de
Free Americans, who cultivate the soil, follow many other occupations.	Freie Amerikaner, die den Boden selbst bauen, treiben zugleich viele andre Beschäftigungen.	ch33_clean.en-ch33_clean.de
Some portion of the furniture and tools which they use is commonly made by themselves.	Ein Teil der von ihnen gebrauchten Möbel und Werkzeuge wird gewöhnlich von ihnen selbst gemacht.	ch33_clean.en-ch33_clean.de
They frequently build their own houses, and carry to market, at whatever distance, the produce of their own industry.	Sie bauen häufig ihre eignen Häuser und bringen das Produkt ihrer eignen Industrie zu noch so fernem Markt.	ch33_clean.en-ch33_clean.de
They are spinners and weavers, they make soap and candles, as well as, in many cases, shoes and clothes for their own use.	Sie sind Spinner und Weber, sie fabrizieren Seife und Kerzen, Schuhe und Kleider für ihren eignen Gebrauch.	ch33_clean.en-ch33_clean.de
In America the cultivation of land is often the secondary pursuit of a blacksmith, a miller or a shopkeeper.’	In Amerika bildet der Landbau oft das Nebengeschäft eines Grobschmieds, Müllers oder Krämers."	ch33_clean.en-ch33_clean.de
Where, among such curious characters, is the ‘field of abstinence’ for the capitalists?	Wo bleibt unter solchen Käuzen das "Entsagungsfeld" für den Kapitalisten?	ch33_clean.en-ch33_clean.de
The great beauty of capitalist production consists in this, that it not only constantly reproduces the wage-labourer as a wage-labourer, but also always produces a relative surplus population of wage-labourers in proportion to the accumulation of capital.	Die große Schönheit der kapitalistischen Produktion besteht darin, daß sie nicht nur beständig den Lohnarbeiter als Lohnarbeiter reproduziert, sondern im Verhältnis zur Akkumulation des Kapitals stets eine relative Übervölkerung von Lohnarbeitern produziert.	ch33_clean.en-ch33_clean.de
Thus the law of supply and demand as applied to labour is kept on the right lines, the oscillation of wages is confined within limits satisfactory to capitalist exploitation, and lastly, the social dependence of the worker on the capitalist, which is indispensable, is secured. At home, in the mother country, the smug deceitfulness of the political economist can turn this relation of absolute dependence into a free contract between buyer and seller, between equally independent owners of commodities, the owner of the commodity capital on one side, the owner of the commodity labour on the other.	So wird das Gesetz von Arbeitsnachfrage und Zufuhr in richtigem Gleis gehalten, die Lohnschwankung innerhalb der kapitalistischen Exploitation zusagende Schranken gebannt und endlich die so unentbehrliche soziale Abhängigkeit des Arbeiters vom Kapitalisten verbürgt, ein absolutes Abhängigkeitsverhältnis, das der politische Ökonom zu Haus, im Mutterland, breimäulig umlügen kann in ein freies Kontraktverhältnis von Käufer und Verkäufer, von gleich unabhängigen Warenbesitzern, Besitzern der Ware Kapital und der Ware Arbeit.	ch33_clean.en-ch33_clean.de
But in the colonies this beautiful illusion is torn aside.	Aber in den Kolonien reißt der schöne Wahn entzwei.	ch33_clean.en-ch33_clean.de
There, the absolute numbers of the population increase much more quickly than in the mother country, because many workers enter the colonial world as ready-made adults, and still the labour-market is always understocked.	Die absolute Bevölkerung wächst hier viel rascher als im Mutterland, indem viele Arbeiter erwachsen auf die Welt kommen, und dennoch ist der Arbeitsmarkt stets untervoll.	ch33_clean.en-ch33_clean.de
The law of the supply and demand of labour collapses completely.	Das Gesetz der Arbeitsnachfrage und Zufuhr gerät in die Brüche.	ch33_clean.en-ch33_clean.de
On the one hand, the old world constantly throws in capital, thirsting after exploitation and ‘abstinence’; on the other, the regular reproduction of the wage-labourer as a wage-labourer comes up against the most mischievous obstacles, which are in part insuperable.	Einerseits wirft die alte Welt fortwährend exploitationslustiges, entsagungebedürftiges Kapital ein; andrerseits stößt die regelmäßige Reproduktion der Lohnarbeiter als Lohnarbeiter auf die unartigsten und teilweis unüberwindliche Hindernisse.	ch33_clean.en-ch33_clean.de
And what becomes of the production of redundant wage-labourers, redundant, that is, in proportion to the accumulation of capital?	Und nun gar die Produktion von überzähligen Lohnarbeitern im Verhältnis zur Akkumulation des Kapitals!	ch33_clean.en-ch33_clean.de
Today’s wage-labourer is tomorrow’s independent peasant or artisan, working for himself.	Der Lohnarbeiter von heute wird morgen unabhängiger, selbstwirtschaftender Bauer oder Handwerker.	ch33_clean.en-ch33_clean.de
He vanishes from the labour-market – but not into the workhouse.	Er verschwindet vom Arbeitsmarkt, aber - nicht ins Workehouse.	ch33_clean.en-ch33_clean.de
This constant transformation of wage-labourers into independent producers, who work for themselves instead of for capital, and enrich themselves instead of the capitalist gentlemen, reacts in its turn very adversely on the conditions of the labour-market.	Diese beständige Verwandlung der Lohnarbeiter in unabhängige Produzenten, die statt für das Kapital, für sich selbst arbeiten, und statt den Herrn Kapitalisten sich selbst bereichern, wirkt ihrerseits durchaus schadhaft auf die Zustände des Arbeitsmarkts zurück.	ch33_clean.en-ch33_clean.de
Not only does the degree of exploitation of the wage-labourer remain indecently low.	Nicht nur bleibt der Exploitationsgrad des Lohnarbeiters unanständig niedrig.	ch33_clean.en-ch33_clean.de
The wage-labourer also loses, along with the relation of dependence, the feeling of dependence on the abstemious capitalist.	Der letztre verliert obendrein mit dem Abhängigkeitsverhältnis auch das Abhängigkeitsgefühl vom entsagenden Kapitalisten.	ch33_clean.en-ch33_clean.de
Hence all the inconveniences depicted so honestly, so eloquently and so movingly by our friend E. G. Wakefield.	Daher alle Mißstände, die unser E. G. Wakefield so brav, so beredt und so rührend schildert.	ch33_clean.en-ch33_clean.de
The supply of wage-labour, he complains, is neither constant, nor regular, nor sufficient.	Die Zufuhr von Lohnarbeit, klagt er, ist weder beständig noch regelmäßig, noch genügend.	ch33_clean.en-ch33_clean.de
‘The supply of labour is always, not only small, but uncertain.’	Sie "ist stets nicht nur zu klein, sondern unsicher" .	ch33_clean.en-ch33_clean.de
‘Though the produce divided between the capitalist and the labourer be large, the labourer takes so great a share that he soon becomes a capitalist… Few, even of those whose lives are unusually long, can accumulate great masses of wealth.’	"Obgleich das zwischen Arbeiter und Kapitalist zu teilende Produkt groß ist, nimmt der Arbeiter einen so großen Teil, daß er rasch ein Kapitalist wird ... Dagegen können wenige, selbst wenn sie ungewöhnlich lang leben, große Reichtumsmassen akkumulieren."	ch33_clean.en-ch33_clean.de
The workers most emphatically refuse to let the capitalist abstain from paying for the greater part of their labour.	Die Arbeiter erlauben den Kapitalisten platterdings nicht, auf Zahlung des größten Teils ihrer Arbeit zu entsagen.	ch33_clean.en-ch33_clean.de
It is of no assistance to him if he cunningly imports his own wage-labourers from Europe, with his own capital.	Es hilft ihm nichts, wenn er so schlau ist, mit seinem eignen Kapital auch seine eignen Lohnarbeiter aus Europa zu importieren.	ch33_clean.en-ch33_clean.de
They soon ‘cease… to be labourers for hire; they… become independent landowners, if not competitors with their former masters in the labour-market.’	"Sie hören bald auf, Lohnarbeiter zu sein, sie verwandeln sich bald in unabhängige Bauern oder gar in Konkurrenten ihrer alten Meister auf dem Lohnarbeitsmarkt selbst."	ch33_clean.en-ch33_clean.de
Horror of horrors!	Man begreife den Greuel!	ch33_clean.en-ch33_clean.de
The excellent capitalist has imported bodily from Europe, with his own good money, his own competitors!	Der brave Kapitalist hat seine eignen leibhaftigen Konkurrenten selbst aus Europa für sein eignes gutes Geld importiert!	ch33_clean.en-ch33_clean.de
The end of the world has come!	Da hört denn doch alles auf!	ch33_clean.en-ch33_clean.de
No wonder Wake-field laments the absence both of relations of dependence and feelings of dependence on the part of the wage-labourers in the colonies.	Kein Wunder, wenn Wakefield klagt über mangelndes Abhängigkeitsverhältnis und Abhängigkeitsgefühl der Lohnarbeiter in den Kolonien.	ch33_clean.en-ch33_clean.de
On account of the high wages, says his disciple Merivale, there is in the colonies an urgent desire for cheaper and moresubservient workers, for a class of people to whom the capitalist may dictate his terms, instead of having his terms dictated by them… In the old civilized countries the worker, although free, is by a law of nature dependent on the capitalist; in colonies this dependence must be created by artificial means.	Wegen der hohen Löhne, sagt sein Schüler Merivale, existiert in den Kolonien der leidenschaftliche Drang nach wohlfeilerer und unterwürfigerer Arbeit, nach einer Klasse, welcher der Kapitalist die Bedingungen diktieren kann, statt sie von ihr diktiert zu erhalten ... In altzivilisierten Ländern ist der Arbeiter, obgleich frei, naturgesetzlich abhängig vom Kapitalisten, in Kolonien muß diese Abhängigkeit durch künstliche Mittel geschaffen werden.	ch33_clean.en-ch33_clean.de
What now is the consequence of this regrettable state of affairs in the colonies, according to Wakefield?	Was ist nun, nach Wakefield, die Folge dieses Mißstands in den Kolonien?	ch33_clean.en-ch33_clean.de
A ‘barbarizing tendency of dispersion’ of producers and of the wealth of the nation.	Ein "barbarisches System der Zerstreuung" der Produzenten und des Nationalvermögens.	ch33_clean.en-ch33_clean.de
The fragmentation of the means of production among innumerable owners, working on their own account, annihilates, along with the centralization of capital, all the foundations of combined labour.	Die Zersplitterung der Produktionsmittel unter un- zählige, selbstwirtschaftende Eigentümer vernichtet mit der Zentralisation des Kapitals alle Grundlage kombinierter Arbeit.	ch33_clean.en-ch33_clean.de
Every lengthy undertaking, extending over several years and demanding the outlay of fixed capital, is prevented from being carried out.	Jedes langatmige Unternehmen, das sich über Jahre erstreckt und Auslage von fixem Kapital erheischt, stößt auf Hindernisse der Ausführung.	ch33_clean.en-ch33_clean.de
In Europe, capital does not hesitate for a moment, for the working class forms its living appendage, always present in excess, always at its disposal.	In Europa zögert das Kapital keinen Augenblick, denn die Arbeiterklasse bildet sein lebendiges Zubehör, stets im Überfluß da, stets zur Verfügung.	ch33_clean.en-ch33_clean.de
But not in the colonies!	Aber in den Kolonialländern!	ch33_clean.en-ch33_clean.de
Wakefield recounts the following exceedingly painful anecdote.	Wakefield erzählt eine äußerst schmerzensreiche Anekdote.	ch33_clean.en-ch33_clean.de
He was talking with some capitalists of Canada and the state of New York, where moreover the wave of immigration often sticks, depositing a sediment of ‘redundant’ workers.	Er unterhielt sich mit einigen Kapitalisten von Kanada und dem Staat New York, wo zudem die Einwanderungswogen oft stocken und einen Bodensatz "überzähliger" Arbeiter niederschlagen.	ch33_clean.en-ch33_clean.de
‘Our capital,’ says one of the characters in the melodrama, ‘was ready for many operations which require a considerable period of time for their completion; but we could not begin such operations with labour which, we knew, would soon leave us.	"Unser Kapital", seufzt eine der Personen des Melodramas, "unser Kapital lag bereit für viele Operationen, die eine beträchtliche Zeitperiode zu ihrer Vollendung brauchen; aber konnten wir solche Operationen beginnen mit Arbeitern, welche, wir wußten es, uns bald den Rücken wenden würden?	ch33_clean.en-ch33_clean.de
If we had been sure of retaining the labour of such emigrants, we should have been glad to have engaged it at once, and for a high price: and we should have engaged it, even though we had been sure it would leave us, provided we had been sure of a fresh supply whenever we might need it.’	Wären wir sicher gewesen, die Arbeit solcher Einwandrer festhalten zu können, wir hätten sie mit Freude sofort engagiert und zu hohem Preis. Ja, trotz der Sicherheit ihres Verlustes würden wir sie dennoch engagiert haben, wären wir einer frischen Zufuhr je nach unsrem Bedürfnis sicher gewesen."	ch33_clean.en-ch33_clean.de
After Wakefield has contrasted English capitalist agriculture and its ‘combined’ labour with the scattered cultivation of American peasants, he unwittingly shows us the obverse of the medal.	Nachdem Wakefield die englische kapitalistische Agrikultur und ihre "kombinierte" Arbeit prunkvoll kontrastiert hat mit der zerstreuten amerikanischen Bauernwirtschaft, entschlüpft ihm auch die Kehrseite der Medaille.	ch33_clean.en-ch33_clean.de
He depicts the mass of the American people as well-to-do, independent, enterprising and comparatively cultured, whereas ‘the English agricultural labourer is a miserable wretch, a pauper… In what country, except North America and some new colonies, do the wages of free labour employed in agriculture, much exceed a bare subsistence for the labourer?… Undoubtedly, farm-horses in England, being a valuable property, are better fed than English peasants.’	Er schildert die amerikanische Volksmasse als wohlhabend, unabhängig, unternehmend und relativ gebildet, während "der englische Agrikulturarbeiter ein elender Lump (a miserable wretch) ist, ein Pauper ... In welchem Land außer Nordamerika und einigen neuen Kolonien übersteigen die Löhne der auf dem Land angewandten freien Arbeit nennenswert die unentbehrlichsten Subsistenzmittel des Arbeiters? ... Zweifelsohne, Ackerpferde in England, da sie ein wertvolles Eigentum sind, werden viel besser genährt als der englische Landbebauer."	ch33_clean.en-ch33_clean.de
But never mind, the wealth of the nation is once again, by its very nature, identical with the misery of the people.	Aber never mind <was soll's>, Nationalreichtum ist nun einmal von Natur identisch mit Volkselend.	ch33_clean.en-ch33_clean.de
How then can the anti-capitalist cancer of the colonies be healed?	Wie nun den antikapitalistischen Krebsschaden der Kolonien heilen?	ch33_clean.en-ch33_clean.de
If men were willing to turn the whole of the land from public into private property at one blow, this would certainly destroy the root of the evil, but it would also destroy – the colony.	Wollte man allen Grund und Boden mit einem Schlag aus Volkseigentum in Privateigentum verwandeln, so zerstörte man zwar die Wurzel des Übels, aber auch - die Kolonie.	ch33_clean.en-ch33_clean.de
The trick is to kill two birds with one stone.	Die Kunst ist, zwei Fliegen mit einer Klappe zu schlagen.	ch33_clean.en-ch33_clean.de
Let the government. set an artificial price on the virgin soil, a price independent of the law of supply and demand, a price that compels the immigrant to work a long time for wages before he can earn enough money to buy land and turn himself into an independent farmer.	Man gebe von Regierungs wegen der jungfräulichen Erde einen vom Gesetz der Nachfrage und Zufuhr unabhängigen, einen künstlichen Preis, welcher den Einwandrer zwingt, längere Zeit zu lohnarbeiten, bis er genug Geld verdienen kann, um Grund und Boden zu kaufen und sich in einen unabhängigen Bauern zu verwandeln.	ch33_clean.en-ch33_clean.de
The fund resulting from the sale of land at a price relatively prohibitory for the wage-labourers, this fund of money extorted from the wages of labour by a violation of the sacred law of supply and demand, is to be applied by the government, in proportion to its growth, to the importation of paupers from Europe into the colonies, so as to keep the wage-labour market full for the capitalists.	Den Fonds, der aus dem Verkauf der Ländereien zu einem für den Lohnarbeiter relativ prohibitorischen Preis fließt, also diesen aus dem Arbeitslohn durch Verletzung des heiligen Gesetzes von Nachfrage und Zufuhr erpreßten Geldfonds, verwende die Regierung andrerseits, um im selben Maß, wie er wächst, Habenichtse aus Europa in die Kolonien zu importieren und so dem Herrn Kapitalisten seinen Lohnarbeitsmarkt vollzuhalten.	ch33_clean.en-ch33_clean.de
Under these circumstances, ‘everything will be for the best in the best of all possible worlds’.	Unter diesen Umständen tout sera pour le mieux dans le meilleur des mondes possibles <alles ist aufs beste bestellt in der besten aller Welten>.	ch33_clean.en-ch33_clean.de
This is the great secret of ‘systematic colonization’.	Dies ist das große Geheimnis der "systematischen Kolonisation".	ch33_clean.en-ch33_clean.de
Under this plan, Wakefield exclaims triumphantly, ‘the supply of labour must be constant and regular, because, first, as no labourer would be able to procure land until he had worked for money, all immigrant labourers, working for a time for wages and in combination, would produce capital for the employment of more labourers; secondly, because every labourer who left off working for wages and became a landowner, would, by purchasing land, provide a fund for bringing fresh labour to the colony.’	"Nach diesem Plan", ruft Wakefield triumphierend aus, "muß die Zufuhr von Arbeit konstant und regelmäßig sein; denn erstens, da kein Arbeiter fähig ist, sich Land zu verschaffen, bevor er für Geld gearbeitet hat, würden alle einwandernden Arbeiter dadurch, daß sie für Lohn kombiniert arbeiten, ihrem Anwender Kapital zur Anwendung von mehr Arbeit produzieren; zweitens jeder, der die Lohnarbeit an den Nagel hinge und Grundeigner würde, würde grade durch den Ankauf des Landes einen Fonds zur Herüberbringung frischer Arbeit nach den Kolonien sichern."	ch33_clean.en-ch33_clean.de
The land-price laid down by the state must of course be ‘sufficient’, i.e. it must be high enough ‘to prevent the labourers from becoming independent landowners until others had followed to take their place’.	Der von Staats wegen oktroyierte Bodenpreis muß natürlich "genügend" (sufficient price) sein, d.h. so hoch, "daß er die Arbeiter verhindert, unabhängige Bauern zu werden, bis andre da sind, um ihren Platz auf dem Lohnarbeitsmarkt einzunehmen" .	ch33_clean.en-ch33_clean.de
This ‘sufficient price for the land’ is nothing but a euphemistic circumlocution for the ransom which the worker must pay to the capitalist in return for permission to retire from the wage-labour market to the land.	Dieser "genügende Bodenpreis" ist nichts als eine euphemistische Umschreibung des Lösegelds, welches der Arbeiter dem Kapitalisten zahlt für die Erlaubnis, sich vom Lohnarbeitsmarkt aufs Land zurückzuziehn.	ch33_clean.en-ch33_clean.de
First, he must create for the capitalist the ‘capital’ which enables him to exploit more workers; then, at his own expense, he must put a ‘substitute’ in the labour-market, who is dispatched across the sea by the government, again at the worker’s expense, for his old master, the capitalist.	Erst muß er dem Herrn Kapitalisten "Kapital" schaffen, damit er mehr Arbeiter ausbeuten könne, und dann auf dem Arbeitsmarkt einen "Ersatzmann" stellen, den die Regierung auf seine Kosten seinem ehemaligen Herrn Kapitalisten über die See spediert.	ch33_clean.en-ch33_clean.de
It is extremely characteristic that the English government for years practised this method of ‘primitive accumulation’ prescribed by Mr Wakefield expressly for use in the colonies.	Es ist höchst charakteristisch, daß die englische Regierung diese von Herrn Wakefield eigens zum Gebrauch in Kolonialländern verschriebene Methode der "ursprünglichen Akkumulation" jahrelang ausgeführt hat.	ch33_clean.en-ch33_clean.de
The resulting fiasco was of course as ignominious as the fate of Peel’s Bank Act. * The stream of emigration was simply diverted from the English colonies to the United States.	Das Fiasko war natürlich ebenso schmählich als das des Peelschen Bankakts. Der Emigrationsstrom wurde nur von den englischen Kolonien nach den Vereinigten Staaten abgelenkt.	ch33_clean.en-ch33_clean.de
Meanwhile, the advance of capitalist production in Europe, accompanied by increasing government pressure, has rendered Wakefield’s recipe superfluous.	Unterdes hat der Fortschritt der kapitalistischen Produktion in Europa, begleitet von wachsendem Regierungsdruck, Wakefields Rezept überflüssig gemacht.	ch33_clean.en-ch33_clean.de
On the one hand, the enormous and continuous flood of humanity, driven year in, year out, onto the shores of America, leaves behind a stationary sediment in the East of the United States, since the wave of immigration from Europe throws men onto the labour-market there more rapidly than the wave of immigration to the West can wash them away.	Einerseits läßt der ungeheure und kontinuierliche Menschenstrom, jahraus, jahrein nach Amerika getrieben, stockende Niederschläge im Osten der Vereinigten Staaten zurück, indem die Emigrationswelle von Europa die Menschen rascher dorthin auf den Arbeitsmarkt wirft, als die Emigrationswelle nach dem Westen sie abspülen kann.	ch33_clean.en-ch33_clean.de
On the other hand, the American Civil War has brought in its train a colossal national debt and, with it, a heavy tax-burden, the creation of a finance aristocracy of the vilest type, and the granting of immense tracts of public land to speculative companies for the exploitation of railways, mines, etc. In short, it has brought a very rapid centralization of capital.	Andrerseits hat der Amerikanische Bürgerkrieg eine kolossale Nationalschuld in seinem Gefolge gehabt und mit ihr Steuerdruck, Erzeugung der allergemeinsten Finanzaristokratie, Verschenkung eines ungeheuren Teils der öffentlichen Ländereien an Spekulanten-Gesellschaften zur Ausbeutung von Eisenbahnen, Bergwerken etc. - kurz die rascheste Zentralisation des Kapitals.	ch33_clean.en-ch33_clean.de
The great republic has therefore ceased to be the promised land for emigrating workers.	Die große Republik hat also aufgehört, das gelobte Land für auswandernde Arbeiter zu sein.	ch33_clean.en-ch33_clean.de
Capitalist production advances there with gigantic strides, even though the lowering of wages and dependence of the wage-labourer has by no means yet proceeded so far as to reach the normal European level.	Die kapitalistische Produktion geht dort mit Riesenschritten voran, wenn auch Lohnsenkung und Abhängigkeit des Lohnarbeiters noch lange nicht auf das europäische Normalniveau heruntergebracht sind.	ch33_clean.en-ch33_clean.de
The shameless squandering of uncultivated colonial land on aristocrats and capitalists by the English government, so loudly denounced even by Wakefield, has, especially in Australia, in conjunction with the stream of men attracted by the gold-diggings, and the competition from imported English commodities which affects everyone down to the smallest artisan, produced an ample ‘relative surplus population of workers’, so that almost every mail-boat brings ill tidings of a ‘glut of the Australian labour-market’, and prostitution flourishes there in some places as exuberantly as in the Haymarket in London.	Die von Wakefield selbst so laut denunzierte, schamlose Verschleuderung des unbebauten Kolonialbodens an Aristokraten und Kapitalisten seitens der englischen Regierung hat namentlich in Australien , zusammen mit dem Menschenstrom, den die Gold-Diggings <Gold-Fundstätten> hinziehn, und der Konkurrenz, welche der Import englischer Waren selbst dem kleinsten Handwerker macht, eine hinreichende "relative Abeiterübervölkerung" erzeugt, so daß fast jedes Postdampfschiff die Hiobspost einer Überfüllung des australischen Arbeitsmarktes - "glut of the Australian labour-market" - bringt, und die Prostitution dort stellenweis so üppig gedeiht wie auf dem Haymarket von London.	ch33_clean.en-ch33_clean.de
However, we are not concerned here with the condition of the colonies.	Jedoch beschäftigt uns hier nicht der Zustand der Kolonien.	ch33_clean.en-ch33_clean.de
The only thing that interests us is the secret discovered in the New World by the political economy of the Old World, and loudly proclaimed by it: that the capitalist mode of production and accumulation, and therefore capitalist private property as well, have for their fundamental condition the annihilation of that private property which rests on the labour of the individual himself; in other words, the expropriation of the worker.	Was uns allein interessiert, ist das in der neuen Welt von der politischen Ökonomie der alten Welt entdeckte und laut proklamierte Geheimnis: kapitalistische Produktions- und Akkumulationsweise, also auch kapitalistisches Privateigentum, bedingen die Vernichtung des auf eigner Arbeit beruhenden Privateigentums, d.h. die Expropriation des Arbeiters.	ch33_clean.en-ch33_clean.de

