Chapter 5: Contradictions in the General Formula of Capital The form which circulation takes when money becomes capital, is opposed to all the laws we have hitherto investigated bearing on the nature of commodities, value and money, and even of circulation itself.	2. Widersprüche der allgemeinen Formel Die Zirkulationsform worin sich das Geld zum Kapital entpuppt, widerspricht allen früher entwickelten Gesetzen über die Natur der Ware, des Werts, des Geldes und der Zirkulation selbst.	ch05_clean.en-ch05_clean.de
What distinguishes this form from that of the simple circulation of commodities, is the inverted order of succession of the two antithetical processes, sale and purchase.	Was sie von der einfachen Warenzirkulation unterscheidet, ist die umgekehrte Reihenfolge derselben zwei entgegengesetzten Prozesse, Verkauf und Kauf.	ch05_clean.en-ch05_clean.de
How can this purely formal distinction between these processes change their character as it were by magic?	Und wie sollte solcher rein formelle Unterschied die Natur dieser Prozesse umzaubern?	ch05_clean.en-ch05_clean.de
But that is not all.	Noch mehr.	ch05_clean.en-ch05_clean.de
This inversion has no existence for two out of the three persons who transact business together.	Diese Umkehrung existiert nur für einen der drei Geschäftsfreunde, die miteinander handeln.	ch05_clean.en-ch05_clean.de
As capitalist, I buy commodities from A and sell them again to B, but as a simple owner of commodities, I sell them to B and then purchase fresh ones from A. A and B see no difference between the two sets of transactions.	Als Kapitalist kaufe ich Ware von A und verkaufe sie wieder an B, während ich als einfacher Warenbesitzer Ware an B verkaufe und dann Ware von A kaufe. Für die Geschäftsfreunde A und B existiert dieser Unterschied nicht.	ch05_clean.en-ch05_clean.de
They are merely buyers or sellers.	Sie treten nur als Käufer oder Verkäufer von Waren auf.	ch05_clean.en-ch05_clean.de
And I on each occasion meet them as a mere owner of either money or commodities, as a buyer or a seller, and, what is more, in both sets of transactions, I am opposed to A only as a buyer and to B only as a seller, to the one only as money, to the other only as commodities, and to neither of them as capital or a capitalist, or as representative of anything that is more than money or commodities, or that can produce any effect beyond what money and commodities can.	Ich selbst stehe ihnen jedesmal gegenüber als einfacher Geldbesitzer oder Warenbesitzer, Käufer oder Verkäufer, und zwar trete ich in beiden Reihenfolgen der einen Person nur als Käufer und der andren nur als Verkäufer gegenüber, der einen als nur Geld, der andren als nur Ware, keiner von beiden als Kapital oder Kapitalist oder Repräsentant von irgend etwas, das mehr als Geld oder Ware wäre oder eine andre Wirkung außer der des Geldes oder der Ware ausüben könnte.	ch05_clean.en-ch05_clean.de
For me the purchase from A and the sale to B are part of a series.	Für mich bilden Kauf von A und Verkauf an B eine Reihenfolge.	ch05_clean.en-ch05_clean.de
But the connexion between the two acts exists for me alone.	Aber der Zusammenhang zwischen diesen beiden Akten existiert nur für mich.	ch05_clean.en-ch05_clean.de
A does not trouble himself about my transaction with B, nor does B about my business with A. And if I offered to explain to them the meritorious nature of my action in inverting the order of succession, they would probably point out to me that I was mistaken as to that order of succession, and that the whole transaction, instead of beginning with a purchase and ending with a sale, began, on the contrary, with a sale and was concluded with a purchase.	A schert sich nicht um meine Transaktion mit B, und B nicht um meine Transaktion mit A. Wollte ich ihnen etwa das besondre Verdienst klarmachen, das ich mir durch die Umkehrung der Reihenfolge erwerbe, so würden sie mir beweisen, daß ich mich in der Reihenfolge selbst irre und daß die Gesamttransaktion nicht mit einem Kauf begann und einem Verkauf endete, sondern umgekehrt mit einem Verkauf begann und mit einem Kauf abschloß.	ch05_clean.en-ch05_clean.de
In truth, my first act, the purchase, was from the standpoint of A, a sale, and my second act, the sale, was from the standpoint of B, a purchase.	In der Tat, mein erster Akt, der Kauf, war von A's Standpunkt ein Verkauf, und mein zweiter Akt, der Verkauf, war von B's Standpunkt ein Kauf.	ch05_clean.en-ch05_clean.de
Not content with that, A and B would declare that the whole series was superfluous and nothing but Hokus Pokus; that for the future A would buy direct from B, and B sell direct to A. Thus the whole transaction would be reduced to a single act forming an isolated, non-complemented phase in the ordinary circulation of commodities, a mere sale from A’s point of view, and from B’s, a mere purchase.	Nicht zufrieden damit, werden A und B erklären, daß die ganze Reihenfolge überflüssig und Hokuspokus war. A wird die Ware direkt an B verkaufen und B sie direkt von A kaufen. Damit verschrumpft die ganze Transaktion in einen einseitigen Akt der gewöhnlichen Warenzirkulation, vom Standpunkt A's bloßer Verkauf und vom Standpunkt B's bloßer Kauf.	ch05_clean.en-ch05_clean.de
The inversion, therefore, of the order of succession, does not take us outside the sphere of the simple circulation of commodities, and we must rather look, whether there is in this simple circulation anything permitting an expansion of the value that enters into circulation, and, consequently, a creation of surplus-value.	Wir sind also durch die Umkehrung der Reihenfolge nicht über die Sphäre der einfachen Warenzirkulation hinausgekommen und müssen vielmehr zusehn, ob sie ihrer Natur nach Verwertung der in sie eingehenden Werte und daher Bildung von Mehrwert gestattet.	ch05_clean.en-ch05_clean.de
Let us take the process of circulation in a form under which it presents itself as a simple and direct exchange of commodities.	Nehmen wir den Zirkulationsprozeß in einer Form, worin er sich als bloßer Warenaustausch darstellt.	ch05_clean.en-ch05_clean.de
This is always the case when two owners of commodities buy from each other, and on the settling day the amounts mutually owing are equal and cancel each other.	Dies ist stets der Fall, wenn beide Warenbesitzer Waren voneinander kaufen und die Bilanz ihrer wechselseitigen Geldforderungen sich am Zahlungstag ausgleicht.	ch05_clean.en-ch05_clean.de
The money in this case is money of account and serves to express the value of the commodities by their prices, but is not, itself, in the shape of hard cash, confronted with them.	Das Geld dient hier als Rechengeld, um die Werte der Waren in ihren Preisen auszudrücken, tritt aber nicht den Waren selbst dinglich gegenüber.	ch05_clean.en-ch05_clean.de
So far as regards use-values, it is clear that both parties may gain some advantage.	Soweit es sich um den Gebrauchswert handelt, ist es klar, daß beide Austauscher gewinnen können.	ch05_clean.en-ch05_clean.de
Both part with goods that, as use-values, are of no service to them, and receive others that they can make use of.	Beide veräußern Waren, die ihnen als Gebrauchswert nutzlos, und erhalten Waren, deren sie zum Gebrauch bedürfen.	ch05_clean.en-ch05_clean.de
And there may also be a further gain.	Und dieser Nutzen mag nicht der einzige sein.	ch05_clean.en-ch05_clean.de
A, who sells wine and buys corn, possibly produces more wine, with given labour-time, than farmer B could, and B on the other hand, more corn than wine-grower A could.	A, der Wein verkauft und Getreide kauft, produziert vielleicht mehr Wein, als Getreidebauer B in derselben Arbeitszeit produzieren könnte, und Getreidebauer B in derselben Arbeitszeit mehr Getreide, als Weinbauer A produzieren könnte.	ch05_clean.en-ch05_clean.de
A, therefore, may get, for the same exchange-value, more corn, and B more wine, than each would respectively get without any exchange by producing his own corn and wine.	A erhält also für denselben Tauschwert mehr Getreide und B mehr Wein, als wenn jeder von den bei- den, ohne Austausch, Wein und Getreide für sich selbst produzieren müßte.	ch05_clean.en-ch05_clean.de
With reference, therefore, to use-value, there is good ground for saying that “exchange is a transaction by which both sides gain.”	Mit Bezug auf den Gebrauchswert also kann gesagt werden, daß "der Austausch eine Transaktion ist, worin beide Seiten gewinnen".	ch05_clean.en-ch05_clean.de
It is otherwise with exchange-value.	Anders mit dem Tauschwert.	ch05_clean.en-ch05_clean.de
“A man who has plenty of wine and no corn treats with a man who has plenty of corn and no wine; an exchange takes place between them of corn to the value of 50, for wine of the same value.	"Ein Mann, der viel Wein und kein Getreide besitzt, handelt mit einem Mann, der viel Getreide und keinen Wein besitzt, und zwischen ihnen wird ausgetauscht Weizen zum Wert von 50 gegen einen Wert von 50 in Wein.	ch05_clean.en-ch05_clean.de
This act produces no increase of exchange-value either for the one or the other; for each of them already possessed, before the exchange, a value equal to that which he acquired by means of that operation.”	Dieser Austausch ist keine Vermehrung des Tauschwerts weder für den einen noch für den andren; denn bereits vor dem Austausch besaß jeder von ihnen einen Wert gleich dem, den er sich vermittelst dieser Operation verschafft hat."	ch05_clean.en-ch05_clean.de
The result is not altered by introducing money, as a medium of circulation, between the commodities, and making the sale and the purchase two distinct acts.	Es ändert nichts an der Sache, wenn das Geld als Zirkulationsmittel zwischen die Waren tritt und die Akte des Kaufs und Verkaufs sinnlich auseinanderfallen.	ch05_clean.en-ch05_clean.de
The value of a commodity is expressed in its price before it goes into circulation, and is therefore a precedent condition of circulation, not its result.	Der Wert der Waren ist in ihren Preisen dargestellt, bevor sie in die Zirkulation treten, also Voraussetzung und nicht Resultat derselben.	ch05_clean.en-ch05_clean.de
Abstractedly considered, that is, apart from circumstances not immediately flowing from the laws of the simple circulation of commodities, there is in an exchange nothing (if we except the replacing of one use-value by another) but a metamorphosis, a mere change in the form of the commodity.	Abstrakt betrachtet, d.h. abgesehn von Umständen, die nicht aus den immanenten Gesetzen der einfachen Warenzirkulation hervorfließen, geht außer dem Ersatz eines Gebrauchswerts durch einen andren nichts in ihr vor als eine Metamorphose, ein bloßer Formwechsel der Ware.	ch05_clean.en-ch05_clean.de
The same exchange-value, i.e., the same quantity of incorporated social labour, remains throughout in the hands of the owner of the commodity, first in the shape of his own commodity, then in the form of the money for which he exchanged it, and lastly, in the shape of the commodity he buys with that money.	Derselbe Wert, d.h. dasselbe Quantum vergegenständlichter gesellschaftlicher Arbeit, bleibt in der Hand desselben Warenbesitzers in Gestalt erst seiner Ware, dann des Geldes, worin sie sich verwandelt, endlich der Ware, worin sich dies Geld rückverwandelt.	ch05_clean.en-ch05_clean.de
This change of form does not imply a change in the magnitude of the value.	Dieser Formwechsel schließt keine Änderung der Wertgröße ein.	ch05_clean.en-ch05_clean.de
But the change, which the value of the commodity undergoes in this process, is limited to a change in its money-form.	Der Wechsel aber, den der Wert der Ware selbst in diesem Prozeß durchläuft, beschränkt sich auf einen Wechsel seiner Geldform.	ch05_clean.en-ch05_clean.de
This form exists first as the price of the commodity offered for sale, then as an actual sum of money, which, however, was already expressed in the price, and lastly, as the price of an equivalent commodity.	Sie existiert erst als Preis der zum Verkauf angebotenen Ware, dann als eine Geldsumme, die aber schon im Preise ausgedrückt war, endlich als der Preis einer äquivalenten Ware.	ch05_clean.en-ch05_clean.de
This change of form no more implies, taken alone, a change in the quantity of value, than does the change of a £ note into sovereigns, half sovereigns and shillings.	Dieser Formwechsel schließt an und für sich ebensowenig eine Änderung der Wertgröße ein wie das Auswechseln einer Fünfpfundnote gegen Sovereigns, halbe Sovereigns und Schilling.	ch05_clean.en-ch05_clean.de
So far therefore as the circulation of commodities effects a change in the form alone of their values, and is free from disturbing influences, it must be the exchange of equivalents.	Sofern also die Zirkulation der Ware nur einen Formwechsel ihres Werts bedingt, bedingt sie, wenn das Phänomen rein vorgeht, Austausch von Äquivalenten.	ch05_clean.en-ch05_clean.de
Little as Vulgar-Economy knows about the nature of value, yet whenever it wishes to consider the phenomena of circulation in their purity, it assumes that supply and demand are equal, which amounts to this, that their effect is nil.	Die Vulgärökonomie selbst, so wenig sie ahnt, was der Wert ist, unterstellt daher, sooft sie in ihrer Art das Phänomen rein betrachten will, daß Nachfrage und Zufuhr sich decken, d.h., daß ihre Wirkung überhaupt aufhört.	ch05_clean.en-ch05_clean.de
If therefore, as regards the use-values exchanged, both buyer and seller may possibly gain something, this is not the case as regards the exchange-values.	Wenn also mit Bezug auf den Gebrauchswert beide Austauscher gewinnen können, können sie nicht beide gewinnen an Tauschwert.	ch05_clean.en-ch05_clean.de
Here we must rather say, “Where equality exists there can be no gain.”	Hier heißt es vielmehr: "Wo Gleichheit ist, ist kein Gewinn."	ch05_clean.en-ch05_clean.de
It is true, commodities may be sold at prices deviating from their values, but these deviations are to be considered as infractions of the laws of the exchange of commodities6, which in its normal state is an exchange of equivalents, consequently, no method for increasing value.	Waren können zwar zu Preisen verkauft werden, die von ihren Werten abweichen, aber diese Abweichung erscheint als Verletzung des Gesetzes des Warenaustausches. In seiner reinen Gestalt ist er ein Austausch von Äquivalenten, also kein Mittel, sich an Wert zu bereichern.	ch05_clean.en-ch05_clean.de
Hence, we see that behind all attempts to represent the circulation of commodities as a source of surplus-value, there lurks a quid pro quo, a mixing up of use-value and exchange-value.	Hinter den Versuchen, die Warenzirkulation als Quelle von Mehrwert darzustellen, lauert daher meist ein Quidproquo, eine Verwechslung von Gebrauchswert und Tauschwert.	ch05_clean.en-ch05_clean.de
For instance, Condillac says: “It is not true that on an exchange of commodities we give value for value.	So z.B. bei Condillac: "Es ist falsch, daß man im Warenaustausch gleichen Wert gegen gleichen Wert austauscht.	ch05_clean.en-ch05_clean.de
On the contrary, each of the two contracting parties in every case, gives a less for a greater value. ...	Umgekehrt. Jeder der beiden Kontrahenten gibt immer einen kleineren für einen größeren Wert ...	ch05_clean.en-ch05_clean.de
If we really exchanged equal values, neither party could make a profit.	Tauschte man in der Tat immer gleiche Werte aus, so wäre kein Gewinn zu machen für irgendeinen Kontrahenten.	ch05_clean.en-ch05_clean.de
And yet, they both gain, or ought to gain.	Aber alle beide gewinnen oder sollten doch gewinnen.	ch05_clean.en-ch05_clean.de
Why?	Warum?	ch05_clean.en-ch05_clean.de
The value of a thing consists solely in its relation to our wants.	Der Wert der Dinge besteht bloß in ihrer Beziehung auf unsre Bedürfnisse.	ch05_clean.en-ch05_clean.de
What is more to the one is less to the other, and vice versâ. ...	Was für den einen mehr, ist für den andren weniger, und umgekehrt ...	ch05_clean.en-ch05_clean.de
It is not to be assumed that we offer for sale articles required for our own consumption. ...	Man setzt nicht voraus, daß wir für unsre Konsumtion unentbehrliche Dinge zum Verkauf ausbieten ...	ch05_clean.en-ch05_clean.de
We wish to part with a useless thing, in order to get one that we need; we want to give less for more. ...	Wir wollen eine uns nutzlose Sache weggeben, um eine uns notwendige zu erhalten; wir wollen weniger für mehr geben ...	ch05_clean.en-ch05_clean.de
It was natural to think that, in an exchange, value was given for value, whenever each of the articles exchanged was of equal value with the same quantity of gold. ...	Es war natürlich, zu urteilen, daß man im Austausch gleichen Wert für gleichen Wert gebe, sooft jedes der ausgetauschten Dinge an Wert demselben Quantum Geld gleich war ...	ch05_clean.en-ch05_clean.de
But there is another point to be considered in our calculation.	Aber eine andre Betrachtung muß noch in die Rechnung eingehn; es fragt sich, ob wir beide einen Überfluß gegen etwas Notwendiges austauschen."	ch05_clean.en-ch05_clean.de
The question is, whether we both exchange something superfluous for something necessary.” 8 We see in this passage, how Condillac not only confuses use-value with exchange-value, but in a really childish manner assumes, that in a society, in which the production of commodities is well developed, each producer produces his own means of subsistence, and throws into circulation only the excess over his own requirements Still, Condillac’s argument is frequently used by modern economists, more especially when the point is to show, that the exchange of commodities in its developed form, commerce, is productive of surplus-value.	Man sieht, wie Condillac nicht nur Gebrauchswert und Tauschwert durcheinanderwirft, sondern wahrhaft kindlich einer Gesellschaft mit entwickelter Warenproduktion einen Zustand unterschiebt, worin der Produzent seine Subsistenzmittel selbst produziert und nur den Überschuß über den eignen Bedarf, den Überfluß, in die Zirkulation wirft. Dennoch wird Condillacs Argument häufig bei modernen Ökonomen wiederholt, namentlich wenn es gilt, die entwickelte Gestalt des Warenaustausches, den Handel, als produktiv von Mehrwert darzustellen.	ch05_clean.en-ch05_clean.de
For instance, “Commerce ... adds value to products, for the same products in the hands of consumers, are worth more than in the hands of producers, and it may strictly be considered an act of production.”	"Der Handel" heißt es z.B. "fügt den Produkten Wert zu, denn dieselben Produkte haben mehr Wert in den Händen des Konsumenten als in den Händen des Produzenten, und er muß daher wörtlich (strictly) als Produktionsakt betrachtet werden."	ch05_clean.en-ch05_clean.de
But commodities are not paid for twice over, once on account of their use-value, and again on account of their value.	Aber man zahlt die Waren nicht doppelt, das eine Mal ihren Gebrauchswert und das andre Mal ihren Wert.	ch05_clean.en-ch05_clean.de
And though the use-value of a commodity is more serviceable to the buyer than to the seller, its money-form is more serviceable to the seller.	Und wenn der Gebrauchswert der Ware dem Käufer nützlicher als dem Verkäufer, ist ihre Geldform dem Verkäufer nützlicher als dem Käufer.	ch05_clean.en-ch05_clean.de
Would he otherwise sell it?	Würde er sie sonst verkaufen?	ch05_clean.en-ch05_clean.de
We might therefore just as well say that the buyer performs “strictly an act of production,” by converting stockings, for example, into money.	Und so könnte ebensowohl gesagt werden, daß der Käufer wörtlich (strictly) einen "Produktionsakt" vollbringt, indem er z.B. die Strümpfe des Kaufmanns in Geld verwandelt.	ch05_clean.en-ch05_clean.de
If commodities, or commodities and money, of equal exchange-value, and consequently equivalents, are exchanged, it is plain that no one abstracts more value from, than he throws into, circulation.	Werden Waren oder Waren und Geld von gleichem Tauschwert, also Äquivalente ausgetauscht, so zieht offenbar keiner mehr Wert aus der Zirkulation heraus, als er in sie hineinwirft.	ch05_clean.en-ch05_clean.de
There is no creation of surplus-value.	Es findet dann keine Bildung von Mehrwert statt.	ch05_clean.en-ch05_clean.de
And, in its normal form, the circulation of commodities demands the exchange of equivalents.	In seiner reinen Form aber bedingt der Zirkulationsprozeß der Waren Austausch von Äquivalenten.	ch05_clean.en-ch05_clean.de
But in actual practice, the process does not retain its normal form.	Jedoch gehn die Dinge in der Wirklichkeit nicht rein zu.	ch05_clean.en-ch05_clean.de
Let us, therefore, assume an exchange of non-equivalents.	Unterstellen wir daher Austausch von Nicht-Äquivalenten.	ch05_clean.en-ch05_clean.de
In any case the market for commodities is only frequented by owners of commodities, and the power which these persons exercise over each other, is no other than the power of their commodities.	Jedenfalls steht auf dem Warenmarkt nur Warenbesitzer dem Warenbesitzer gegenüber, und die Macht, die diese Personen über einander ausüben, ist nur die Macht ihrer Waren.	ch05_clean.en-ch05_clean.de
The material variety of these commodities is the material incentive to the act of exchange, and makes buyers and sellers mutually dependent, because none of them possesses the object of his own wants, and each holds in his hand the object of another’s wants.	Die stoffliche Verschiedenheit der Waren ist das stoffliche Motiv des Austausches und macht die Warenbesitzer wechselseitig voneinander abhängig, indem keiner von ihnen den Gegenstand seines eignen Bedürfnisses und jeder von ihnen den Gegen- stand des Bedürfnisses des andren in seiner Hand hält.	ch05_clean.en-ch05_clean.de
Besides these material differences of their use-values, there is only one other difference between commodities, namely, that between their bodily form and the form into which they are converted by sale, the difference between commodities and money.	Außer dieser stofflichen Verschiedenheit ihrer Gebrauchswerte besteht nur noch ein Unterschied unter den Waren, der Unterschied zwischen ihrer Naturalform und ihrer verwandelten Form, zwischen Ware und Geld.	ch05_clean.en-ch05_clean.de
And consequently the owners of commodities are distinguishable only as sellers, those who own commodities, and buyers, those who own money.	Und so unterscheiden sich die Warenbesitzer nur als Verkäufer, Besitzer von Ware, und als Käufer, Besitzer von Geld.	ch05_clean.en-ch05_clean.de
Suppose then, that by some inexplicable privilege, the seller is enabled to sell his commodities above their value, what is worth 100 for 110, in which case the price is nominally raised 10%.	Gesetzt nun, es sei durch irgendein unerklärliches Privilegium dem Verkäufer gegeben, die Ware über ihrem Werte zu verkaufen, zu 110, wenn sie 100 wert ist, also mit einem nominellen Preisaufschlage von 10%.	ch05_clean.en-ch05_clean.de
The seller therefore pockets a surplus-value of 10.	Der Verkäufer kassiert also einen Mehrwert von 10 ein.	ch05_clean.en-ch05_clean.de
But after he has sold he becomes a buyer.	Aber nachdem er Verkäufer war, wird er Käufer.	ch05_clean.en-ch05_clean.de
A third owner of commodities comes to him now as seller, who in this capacity also enjoys the privilege of selling his commodities 10% too dear.	Ein dritter Warenbesitzer begegnet ihm jetzt als Verkäufer und genießt seinerseits das Privilegium, die Ware 10% zu teuer zu verkaufen.	ch05_clean.en-ch05_clean.de
Our friend gained 10 as a seller only to lose it again as a buyer.	Unser Mann hat als Verkäufer 10 gewonnen, um als Käufer 10 zu verlieren.	ch05_clean.en-ch05_clean.de
The net result is, that all owners of commodities sell their goods to one another at 10% above their value, which comes precisely to the same as if they sold them at their true value.	Das Ganze kommt in der Tat darauf hinaus, daß alle Warenbesitzer ihre Waren einander 10% über dem Wert verkaufen, was durchaus dasselbe ist, als ob sie die Waren zu ihren Werten verkauften.	ch05_clean.en-ch05_clean.de
Such a general and nominal rise of prices has the same effect as if the values had been expressed in weight of silver instead of in weight of gold.	Ein solcher allgemeiner nomineller Preisaufschlag der Waren bringt dieselbe Wirkung hervor, als ob die Warenwerte z.B. in Silber statt in Gold geschätzt würden.	ch05_clean.en-ch05_clean.de
The nominal prices of commodities would rise, but the real relation between their values would remain unchanged.	Die Geldnamen, d.h. die Preise der Waren würden anschwellen, aber ihre Wertverhältnisse unverändert bleiben.	ch05_clean.en-ch05_clean.de
Let us make the opposite assumption, that the buyer has the privilege of purchasing commodities under their value.	Unterstellen wir umgekehrt, es sei das Privilegium des Käufers, die Waren unter ihrem Wert zu kaufen.	ch05_clean.en-ch05_clean.de
In this case it is no longer necessary to bear in mind that he in his turn will become a seller.	Hier ist es nicht einmal nötig zu erinnern, daß der Käufer wird. Er war Verkäufer, bevor er Käufer ward.	ch05_clean.en-ch05_clean.de
He was so before he became buyer; he had already lost 10% in selling before he gained 10% as buyer.	Er hat bereits 10% als Verkäufer verloren, bevor er 10% als Käufer gewinnt.	ch05_clean.en-ch05_clean.de
Everything is just as it was.	Aller bleibt wieder beim alten.	ch05_clean.en-ch05_clean.de
The creation of surplus-value, and therefore the conversion of money into capital, can consequently be explained neither on the assumption that commodities are sold above their value, nor that they are bought below their value.	Die Bildung von Mehrwert und daher die Verwandlung von Geld in Kapital, kann also weder dadurch erklärt werden, daß die Verkäufer die Waren über ihrem Werte verkaufen, noch dadurch, daß die Käufer sie unter ihrem Werte kaufen.	ch05_clean.en-ch05_clean.de
The problem is in no way simplified by introducing irrelevant matters after the manner of Col. Torrens: “Effectual demand consists in the power and inclination (! ), on the part of consumers, to give for commodities, either by immediate or circuitous barter, some greater portion of ... capital than their production costs.”	Das Problem wird in keiner Weise dadurch vereinfacht, daß man fremde Beziehungen einschmuggelt, also etwa mit Oberst Torrens sagt: "Die effektive Nachfrage besteht in dem Vermögen und der Neigung (!) der Konsumenten, sei es durch unmittelbaren oder vermittelten Austausch, für Waren eine gewisse größere Portion von allen Ingredienzien des Kapitals zu geben, als ihre Produktion kostet."	ch05_clean.en-ch05_clean.de
In relation to circulation, producers and consumers meet only as buyers and sellers.	In der Zirkulation stehn sich Produzenten und Konsumenten nur als Verkäufer und Käufer gegenüber.	ch05_clean.en-ch05_clean.de
To assert that the surplus-value acquired by the producer has its origin in the fact that consumers pay for commodities more than their value, is only to say in other words: The owner of commodities possesses, as a seller, the privilege of selling too dear.	Behaupten, der Mehrwert für den Produzenten entspringe daraus, daß die Konsumenten die Ware über den Wert zahlen, heißt nur den einfachen Satz maskieren: Der Warenbesitzer besitzt als Verkäufer das Privilegium, zu teuer zu verkaufen.	ch05_clean.en-ch05_clean.de
The seller has himself produced the commodities or represents their producer, but the buyer has to no less extent produced the commodities represented by his money, or represents their producer.	Der Verkäufer hat die Ware selbst produziert oder vertritt ihren Produzenten, aber der Käufer hat nicht minder die in seinem Gelde dargestellte selbst produziert oder vertritt ihren Produzenten.	ch05_clean.en-ch05_clean.de
	Es steht also Produzent dem Produzenten gegenüber.	ch05_clean.en-ch05_clean.de
The distinction between them is, that one buys and the other sells.	Was sie unterscheidet, ist, daß der eine kauft und der andre verkauft.	ch05_clean.en-ch05_clean.de
The fact that the owner of the commodities, under the designation of producer, sells them over their value, and under the designation of consumer, pays too much for them, does not carry us a single step further.	Es bringt uns keinen Schritt weiter, daß der Warenbesitzer unter dem Namen Produzent die Ware über ihrem Werte verkauft und unter dem Namen Konsument sie zu teuer zahlt.	ch05_clean.en-ch05_clean.de
To be consistent therefore, the upholders of the delusion that surplus-value has its origin in a nominal rise of prices or in the privilege which the seller has of selling too dear, must assume the existence of a class that only buys and does not sell, i.e., only consumes and does not produce.	Die konsequenten Vertreter der Illusion, daß der Mehrwert aus einem nominellen Preiszuschlag entspringt oder aus dem Privilegium des Verkäufers, die Ware zu teuer zu verkaufen, unterstellen daher eine Klasse, die nur kauft, ohne zu verkaufen, also auch nur konsumiert ohne zu produzieren.	ch05_clean.en-ch05_clean.de
The existence of such a class is inexplicable from the standpoint we have so far reached, viz., that of simple circulation.	Die Existenz einer solchen Klasse ist von unsrem bisher erreichten Standpunkt, dem der einfachen Zirkulation, noch unerklärlich.	ch05_clean.en-ch05_clean.de
But let us anticipate.	Aber greifen wir vor.	ch05_clean.en-ch05_clean.de
The money with which such a class is constantly making purchases, must constantly flow into their pockets, without any exchange, gratis, by might or right, from the pockets of the commodity-owners themselves.	Das Geld, womit eine solche Klasse beständig kauft, muß ihr beständig, ohne Austausch, umsonst, auf beliebige Rechts- und Gewaltstitel hin, von den Warenbesitzern selbst zufließen.	ch05_clean.en-ch05_clean.de
To sell commodities above their value to such a class, is only to crib back again a part of the money previously given to it.	Dieser Klasse die Waren über dem Wert verkaufen, heißt nur, umsonst weggegebenes Geld sich zum Teil wieder zurückschwindeln.	ch05_clean.en-ch05_clean.de
The towns of Asia Minor thus paid a yearly money tribute to ancient Rome.	So zahlten die kleinasiatischen Städte jährlichen Geldtribut an das alte Rom.	ch05_clean.en-ch05_clean.de
With this money Rome purchased from them commodities, and purchased them too dear.	Mit diesem Geld kaufte Rom Waren von ihnen und kaufte sie zu teuer.	ch05_clean.en-ch05_clean.de
The provincials cheated the Romans, and thus got back from their conquerors, in the course of trade, a portion of the tribute.	Die Kleinasiaten prellten die Römer, indem sie den Eroberern einen Teil des Tributs wieder abluchsten auf dem Wege des Handels.	ch05_clean.en-ch05_clean.de
Yet, for all that, the conquered were the really cheated.	Aber dennoch blieben die Kleinasiaten die Geprellten.	ch05_clean.en-ch05_clean.de
Their goods were still paid for with their own money.	Ihre Waren wurden ihnen nach wie vor mit ihrem eignen Gelde gezahlt.	ch05_clean.en-ch05_clean.de
That is not the way to get rich or to create surplus-value.	Es ist dies keine Methode der Bereicherung oder der Bildung von Mehrwert.	ch05_clean.en-ch05_clean.de
Let us therefore keep within the bounds of exchange where sellers are also buyers, and buyers, sellers.	Halten wir uns also innerhalb der Schranken des Warenaustausches, wo Verkäufer Käufer und Käufer Verkäufer sind.	ch05_clean.en-ch05_clean.de
Our difficulty may perhaps have arisen from treating the actors as personifications instead of as individuals.	Unsre Verlegenheit stammt vielleicht daher, daß wir die Personen nur als personifizierte Kategorien, nicht individuell, gefaßt haben.	ch05_clean.en-ch05_clean.de
A may be clever enough to get the advantage of B or C without their being able to retaliate.	Warenbesitzer A mag so pfiffig sein, seine Kollegen B oder C übers Ohr zu hauen, während sie trotz des besten Willens die Revanche schuldig bleiben.	ch05_clean.en-ch05_clean.de
A sells wine worth £ to B, and obtains from him in exchange corn to the value of £50.	A verkauft Wein zum Wert von 40 Pfd.St. an B und erwirbt im Austausch Getreide zum Wert von 50 Pfd.St.	ch05_clean.en-ch05_clean.de
A has converted his £ into £50, has made more money out of less, and has converted his commodities into capital.	A hat seine 40 Pfd.St. in 50 Pfd.St. verwandelt, mehr Geld aus weniger Geld gemacht und seine Ware in Kapital verwandelt. Sehn wir näher zu.	ch05_clean.en-ch05_clean.de
Let us examine this a little more closely.	Vor dem Austausch hatten wir für 40 Pfd.St.	ch05_clean.en-ch05_clean.de
Before the exchange we had £ worth of wine in the hands of A, and £ worth of corn in those of B, a total value of £90.	Wein in der Hand von A und für 50 Pfd.St. Getreide in der Hand von B, Gesamtwert von 90 Pfd.St.	ch05_clean.en-ch05_clean.de
After the exchange we have still the same total value of £90.	Nach dem Austausch haben wir denselben Gesamtwert von 90 Pfd.St.	ch05_clean.en-ch05_clean.de
The value in circulation has not increased by one iota, it is only distributed differently between A and B. What is a loss of value to B is surplus-value to A; what is “minus” to one is “plus” to the other.	Der zirkulierende Wert hat sich um kein Atom vergrößert, seine Verteilung zwischen A und B hat sich verändert. Auf der einen Seite erscheint als Mehrwert, was auf der andren Minderwert ist, auf der einen Seite als Plus, was auf der andren als Minus.	ch05_clean.en-ch05_clean.de
The same change would have taken place, if A, without the formality of an exchange, had directly stolen the £ from B. The sum of the values in circulation can clearly not be augmented by any change in their distribution, any more than the quantity of the precious metals in a country by a Jew selling a Queen Anne’s farthing for a guinea.	Derselbe Wechsel hätte sich ereignet, wenn A, ohne die verhüllende Form des Austausches, dem B 10 Pfd.St. direkt gestohlen hätte. Die Summe der zirkulierenden Werte kann offenbar durch keinen Wechsel in ihrer Verteilung vermehrt werden, sowenig wie ein Jude die Masse der edlen Metalle in einem Lande dadurch vermehrt, daß er einen Farthing aus der Zeit der Königin Anna für eine Guinee verkauft.	ch05_clean.en-ch05_clean.de
The capitalist class, as a whole, in any country, cannot over-reach themselves.	Die Gesamtheit der Kapitalistenklasse eines Landes kann sich nicht selbst übervorteilen.	ch05_clean.en-ch05_clean.de
Turn and twist then as we may, the fact remains unaltered.	Man mag sich also drehen und wenden, wie man will, das Fazit bleibt dasselbe.	ch05_clean.en-ch05_clean.de
If equivalents are exchanged, no surplus-value results, and if non-equivalents are exchanged, still no surplus-value.	Werden Äquivalente ausgetauscht, so entsteht kein Mehrwert, und werden Nicht-Äquivalente ausgetauscht, so entsteht auch kein Mehrwert.	ch05_clean.en-ch05_clean.de
Circulation, or the exchange of commodities, begets no value.	Die Zirkulation oder der Warenaustausch schafft keinen Wert.	ch05_clean.en-ch05_clean.de
The reason is now therefore plain why, in analysing the standard form of capital, the form under which it determines the economic organisation of modern society, we entirely left out of consideration its most popular, and, so to say, antediluvian forms, merchants’ capital and money-lenders’ capital.	Man versteht daher, warum in unsrer Analyse der Grundform des Kapitals, der Form, worin es die ökonomische Organisation der modernen Gesellschaft bestimmt, seine populären und sozusagen antediluvianischen Gestalten, Handelskapital und Wucherkapital, zunächst gänzlich unberücksichtigt bleiben.	ch05_clean.en-ch05_clean.de
The circuit M-C-M, buying in order to sell dearer, is seen most clearly in genuine merchants’ capital.	Im eigentlichen Handelskapital erscheint die Form G - W - G', kaufen, um teurer zu verkaufen, am reinsten.	ch05_clean.en-ch05_clean.de
But the movement takes place entirely within the sphere of circulation.	Andrerseits geht seine ganze Bewegung innerhalb der Zirkulationssphäre vor.	ch05_clean.en-ch05_clean.de
Since, however, it is impossible, by circulation alone, to account for the conversion of money into capital, for the formation of surplus-value, it would appear, that merchants’ capital is an impossibility, so long as equivalents are exchanged; that, therefore, it can only have its origin in the two-fold advantage gained, over both the selling and the buying producers, by the merchant who parasitically shoves himself in between them.	Da es aber unmöglich ist, aus der Zirkulation selbst die Verwandlung von Geld in Kapital, die Bildung von Mehrwert zu erklären, erscheint das Handelskapital unmöglich, sobald Äquivalente ausgetauscht werden , daher nur ableitbar aus der doppelseitigen Übervorteilung der kaufenden und verkaufenden Warenproduzenten durch den sich parasitisch zwischen sie schiebenden Kaufmann.	ch05_clean.en-ch05_clean.de
It is in this sense that Franklin says, “war is robbery, commerce is generally cheating.”	In diesem Sinn sagt Franklin: "Krieg ist Raub, Handel ist Prellerei."	ch05_clean.en-ch05_clean.de
If the transformation of merchants’ money into capital is to be explained otherwise than by the producers being simply cheated, a long series of intermediate steps would be necessary, which, at present, when the simple circulation of commodities forms our only assumption, are entirely wanting.	Soll die Verwertung des Handelskapitals nicht aus bloßer Prellerei der Warenproduzenten erklärt werden, so gehört dazu eine lange Reihe von Mittelgliedern, die hier, wo die Warenzirkulation und ihre einfachen Momente unsre einzige Voraussetzung bilden, noch gänzlich fehlt.	ch05_clean.en-ch05_clean.de
What we have said with reference to merchants’ capital, applies still more to money-lenders’ capital.	Was vom Handelskapital, gilt noch mehr vom Wucherkapital.	ch05_clean.en-ch05_clean.de
In merchants’ capital, the two extremes, the money that is thrown upon the market, and the augmented money that is withdrawn from the market, are at least connected by a purchase and a sale, in other words by the movement of the circulation.	Im Handelskapital sind die Extreme, das Geld, das auf den Markt geworfen, und das vermehrte Geld, das dem Markt entzogen wird, wenigstens vermittelt durch Kauf und Verkauf, durch die Bewegung der Zirkulation.	ch05_clean.en-ch05_clean.de
In money-lenders’ capital the form M-C-M is reduced to the two extremes without a mean, M-M , money exchanged for more money, a form that is incompatible with the nature of money, and therefore remains inexplicable from the standpoint of the circulation of commodities.	Im Wucherkapital ist die Form G - W - G' abgekürzt auf die unvermittelten Extreme G - G', Geld, das sich gegen mehr Geld austauscht, eine der Natur des Geldes widersprechende und daher vom Standpunkt des Warenaustausches unerklärliche Form.	ch05_clean.en-ch05_clean.de
Hence Aristotle: “since chrematistic is a double science, one part belonging to commerce, the other to economic, the latter being necessary and praiseworthy, the former based on circulation and with justice disapproved (for it is not based on Nature, but on mutual cheating), therefore the usurer is most rightly hated, because money itself is the source of his gain, and is not used for the purposes for which it was invented.	Daher Aristoteles: "Da die Chrematistik eine doppelte ist, die eine zum Handel, die andre zu Ökonomik gehörig, die letztere notwendig und lobenswert, die erstere auf die Zirkulation gegründet und mit Recht getadelt (denn sie beruht nicht auf der Natur, sondern auf wechselseitiger Prellerei), so ist der Wucher mit vollstem Recht verhaßt, weil das Geld selbst hier die Quelle des Erwerbs und nicht dazu gebraucht wird, wozu es erfunden ward.	ch05_clean.en-ch05_clean.de
For it originated for the exchange of commodities, but interest makes out of money, more money.	Denn für den Warenaustausch entstand es, der Zins aber macht aus Geld mehr Geld.	ch05_clean.en-ch05_clean.de
Hence its name (τοκος interest and offspring).	Daher auch sein Name" (tokoz <griechisch: tokos> Zins und Geborenes).	ch05_clean.en-ch05_clean.de
For the begotten are like those who beget them.	"Denn die Geborenen sind den Erzeugern ähnlich.	ch05_clean.en-ch05_clean.de
But interest is money of money, so that of all modes of making a living, this is the most contrary to Nature.”	Der Zins aber ist Geld von Geld, so daß von allen Erwerbszweigen dieser der naturwidrigste."	ch05_clean.en-ch05_clean.de
In the course of our investigation, we shall find that both merchants’ capital and interest-bearing capital are derivative forms, and at the same time it will become clear, why these two forms appear in the course of history before the modern standard form of capital.	Wie das Handelskapital werden wir das zinstragende Kapital im Verlauf unsrer Untersuchung als abgeleitete Formen vorfinden und zugleich sehn, warum sie historisch vor der modernen Grundform des Kapitals erscheinen.	ch05_clean.en-ch05_clean.de
We have shown that surplus-value cannot be created by circulation, and, therefore, that in its formation, something must take place in the background, which is not apparent in the circulation itself.	Es hat sich gezeigt, daß der Mehrwert nicht aus der Zirkulation entspringen kann, bei seiner Bildung also etwas hinter ihrem Rücken vorgehn muß, das in ihr selbst unsichtbar ist.	ch05_clean.en-ch05_clean.de
But can surplus-value possibly originate anywhere else than in circulation, which is the sum total of all the mutual relations of commodity-owners, as far as they are determined by their commodities?	Kann aber der Mehrwert anderswoher entspringen als aus der Zirkulation?	ch05_clean.en-ch05_clean.de
Apart from circulation, the commodity-owner is in relation only with his own commodity.	Die Zirkulation ist die Summe aller Wechselbeziehungen <3. und 4. Auflage: Warenbeziehungen> der Warenbesitzer.	ch05_clean.en-ch05_clean.de
So far as regards value, that relation is limited to this, that the commodity contains a quantity of his own labour, that quantity being measured by a definite social standard.	Außerhalb derselben steht der Warenbesitzer nur noch in Beziehung zu seiner eignen Ware.	ch05_clean.en-ch05_clean.de
This quantity is expressed by the value of the commodity, and since the value is reckoned in money of account, this quantity is also expressed by the price, which we will suppose to be £10.	Was ihren Wert angeht, beschränkt sich das Verhältnis darauf, daß sie ein nach bestimmten gesellschaftlichen Gesetzen gemessenes Quantum seiner eignen Arbeit enthält.	ch05_clean.en-ch05_clean.de
But his labour is not represented both by the value of the commodity, and by a surplus over that value, not by a price of 10 that is also a price of 11, not by a value that is greater than itself.	Dies Quantum Arbeit drückt sich aus in der Wertgröße seiner Ware, und, da sich Wertgröße in Rechengeld darstellt, in einem Preise von z.B. 10 Pfd.St.	ch05_clean.en-ch05_clean.de
	Aber seine Arbeit stellt sich nicht dar im Werte der Ware und einem Überschuß über ihrem eignen Wert, nicht in einem Preise von 10, der zugleich ein Preis von 11, nicht in einem Wert, der größer als er selbst ist.	ch05_clean.en-ch05_clean.de
The commodity owner can, by his labour, create value, but not self-expanding value.	Der Warenbesitzer kann durch seine Arbeit Werte bilden, aber keine sich verwertenden Werte.	ch05_clean.en-ch05_clean.de
He can increase the value of his commodity, by adding fresh labour, and therefore more value to the value in hand, by making, for instance, leather into boots.	Er kann den Wert einer Ware erhöhn, indem er vorhandnem Wert neuen Wert durch neue Arbeit zusetzt, z.B. aus Leder Stiefel macht.	ch05_clean.en-ch05_clean.de
The same material has now more value, because it contains a greater quantity of labour.	Derselbe Stoff hat jetzt mehr Wert, weil er ein größeres Arbeitsquantum enthält.	ch05_clean.en-ch05_clean.de
The boots have therefore more value than the leather, but the value of the leather remains what it was; it has not expanded itself, has not, during the making of the boots, annexed surplus-value.	Der Stiefel hat daher mehr Wert als das Leder, aber der Wert des Leders ist geblieben, was er war. Er hat sich nicht verwertet, nicht während der Stiefelfabrikation einen Mehrwert angesetzt.	ch05_clean.en-ch05_clean.de
It is therefore impossible that outside the sphere of circulation, a producer of commodities can, without coming into contact with other commodity-owners, expand value, and consequently convert money or commodities into capital.	Es ist also unmöglich, daß der Warenproduzent außerhalb der Zirkulationssphäre, ohne mit andren Warenbesitzern in Berührung zu treten, Wert verwerte und daher Geld oder Ware in Kapital verwandle.	ch05_clean.en-ch05_clean.de
It is therefore impossible for capital to be produced by circulation, and it is equally impossible for it to originate apart from circulation.	Kapital kann also nicht aus der Zirkulation entspringen, und es kann ebensowenig aus der Zirkulation nicht entspringen.	ch05_clean.en-ch05_clean.de
It must have its origin both in circulation and yet not in circulation.	Es muß zugleich in ihr und nicht in ihr entspringen.	ch05_clean.en-ch05_clean.de
We have, therefore, got a double result.	Ein doppeltes Resultat hat sich also ergeben.	ch05_clean.en-ch05_clean.de
The conversion of money into capital has to be explained on the basis of the laws that regulate the exchange of commodities, in such a way that the starting-point is the exchange of equivalents.	Die Verwandlung des Geldes in Kapital ist auf Grundlage dem Warenaustausch immanenter Gesetze zu entwickeln, so daß der Austausch von Äquivalenten als Ausgangspunkt gilt.	ch05_clean.en-ch05_clean.de
Our friend, Moneybags, who as yet is only an embryo capitalist, must buy his commodities at their value, must sell them at their value, and yet at the end of the process must withdraw more value from circulation than he threw into it at starting.	Unser nur noch als Kapitalisten- raupe vorhandner Geldbesitzer muß die Waren zu ihrem Wert kaufen, zu ihrem Wert verkaufen und dennoch am Ende des Prozesses mehr Wert herausziehn, als er hineinwarf.	ch05_clean.en-ch05_clean.de
His development into a full-grown capitalist must take place, both within the sphere of circulation and without it.	Seine Schmetterlingsentfaltung muß in der Zirkulationssphäre und muß nicht in der Zirkulationssphäre vorgehn.	ch05_clean.en-ch05_clean.de
These are the conditions of the problem.	Dies sind die Bedingungen des Problems.	ch05_clean.en-ch05_clean.de
Hic Rhodus, hic salta!	Hic Rhodus, hic salta! <Hier ist Rhodos, hier springe!>	ch05_clean.en-ch05_clean.de

