Chapter 6: The Buying and Selling of Labour-Power The change of value that occurs in the case of money intended to be converted into capital, cannot take place in the money itself, since in its function of means of purchase and of payment, it does no more than realise the price of the commodity it buys or pays for; and, as hard cash, it is value petrified, never varying.	3. Kauf und Verkauf der Arbeitskraft Die Wertverändrung des Geldes, das sich in Kapital verwandeln soll, kann nicht an diesem Geld selbst vorgehn, denn als Kaufmittel und als Zahlungsmittel realisiert es nur den Preis der Ware, die es kauft oder zahlt, während es, in seiner eignen Form verharrend, zum Petrefakt von gleichbleibender Wertgröße erstarrt.	ch06_clean.en-ch06_clean.de
Just as little can it originate in the second act of circulation, the re-sale of the commodity, which does no more than transform the article from its bodily form back again into its money-form.	Ebensowenig kann die Veränderung aus dem zweiten Zirkulationsakt, dem Wiederverkauf der Ware, entspringen, denn dieser Akt verwandelt die Ware bloß aus der Naturalform zurück in die Geldform.	ch06_clean.en-ch06_clean.de
The change must, therefore, take place in the commodity bought by the first act, M-C, but not in its value, for equivalents are exchanged, and the commodity is paid for at its full value.	Die Veränderung muß sich also zutragen mit der Ware, die im ersten Akt G - W gekauft wird, aber nicht mit ihrem Wert, denn es werden Äquivalente ausgetauscht, die Ware wird zu ihrem Werte bezahlt.	ch06_clean.en-ch06_clean.de
We are, therefore, forced to the conclusion that the change originates in the use-value, as such, of the commodity, i.e., in its consumption.	Die Veränderung kann also nur entspringen aus ihrem Gebrauchswert als solchem, d.h. aus ihrem Verbrauch.	ch06_clean.en-ch06_clean.de
In order to be able to extract value from the consumption of a commodity, our friend, Moneybags, must be so lucky as to find, within the sphere of circulation, in the market, a commodity, whose use-value possesses the peculiar property of being a source of value, whose actual consumption, therefore, is itself an embodiment of labour, and, consequently, a creation of value.	Um aus dem Verbrauch einer Ware Wert herauszuziehn, müßte unser Geldbesitzer so glücklich sein, innerhalb der Zirkulationssphäre, auf dem Markt, eine Ware zu entdecken, deren Gebrauchswert selbst die eigentümliche Beschaffenheit besäße, Quelle von Wert zu sein, deren wirklicher Verbrauch also selbst Vergegenständlichung von Arbeit wäre, daher Wertschöpfung.	ch06_clean.en-ch06_clean.de
The possessor of money does find on the market such a special commodity in capacity for labour or labour-power.	Und der Geldbesitzer findet auf dem Markt eine solche spezifische Ware vor - das Arbeitsvermögen oder die Arbeitskraft.	ch06_clean.en-ch06_clean.de
By labour-power or capacity for labour is to be understood the aggregate of those mental and physical capabilities existing in a human being, which he exercises whenever he produces a use-value of any description.	Unter Arbeitskraft oder Arbeitsvermögen verstehen wir den Inbegriff der physischen und geistigen Fähigkeiten, die in der Leiblichkeit, der lebendigen Persönlichkeit eines Menschen existieren und die er in Bewegung setzt, sooft er Gebrauchswerte irgendeiner Art produziert.	ch06_clean.en-ch06_clean.de
But in order that our owner of money may be able to find labour-power offered for sale as a commodity, various conditions must first be fulfilled.	Damit jedoch der Geldbesitzer die Arbeitskraft als Ware auf dem Markt vorfinde, müssen verschiedne Bedingungen erfüllt sein.	ch06_clean.en-ch06_clean.de
The exchange of commodities of itself implies no other relations of dependence than those which result from its own nature.	Der Warenaustausch schließt an und für sich keine andren Abhängigkeitsverhältnisse ein als die aus seiner eignen Natur entspringenden.	ch06_clean.en-ch06_clean.de
On this assumption, labour-power can appear upon the market as a commodity, only if, and so far as, its possessor, the individual whose labour-power it is, offers it for sale, or sells it, as a commodity.	Unter dieser Voraussetzung kann die Arbeitskraft als Ware nur auf dem Markt erscheinen, sofern und weil sie von ihrem eignen Besitzer, der Person, deren Arbeitskraft sie ist, als Ware feilgeboten oder verkauft wird.	ch06_clean.en-ch06_clean.de
In order that he may be able to do this, he must have it at his disposal, must be the untrammelled owner of his capacity for labour, i.e., of his person.	Damit ihr Besitzer sie als Ware verkaufe, muß er über sie verfügen können, also freier Eigentümer seines Arbeitsvermögens, seiner Person sein.	ch06_clean.en-ch06_clean.de
He and the owner of money meet in the market, and deal with each other as on the basis of equal rights, with this difference alone, that one is buyer, the other seller; both, therefore, equal in the eyes of the law.	Er und der Geldbesitzer begegnen sich auf dem Markt und treten in Verhältnis zueinander als ebenbürtige Warenbesitzer, nur dadurch unterschieden, daß der eine Käufer, der andre Verkäufer, beide also juristisch gleiche Personen sind.	ch06_clean.en-ch06_clean.de
The continuance of this relation demands that the owner of the labour-power should sell it only for a definite period, for if he were to sell it rump and stump, once for all, he would be selling himself, converting himself from a free man into a slave, from an owner of a commodity into a commodity.	Die Fortdauer dieses Verhältnisses erheischt, daß der Eigentümer der Arbeitskraft sie stets nur für bestimmte Zeit verkaufe, denn verkauft er sie in Bausch und Bogen, ein für allemal, so verkauft er sich selbst, verwandelt sich aus einem Freien in einen Sklaven, aus einem Warenbesitzer in eine Ware.	ch06_clean.en-ch06_clean.de
He must constantly look upon his labour-power as his own property, his own commodity, and this he can only do by placing it at the disposal of the buyer temporarily, for a definite period of time. By this means alone can he avoid renouncing his rights of ownership over it.	Er als Person muß sich beständig zu seiner Arbeitskraft als seinem Eigentum und daher seiner eignen Ware verhalten, und das kann er nur, soweit er sie dem Käufer stets nur vorübergehend, für einen bestimmten Zeittermin, zur Verfügung stellt, zum Verbrauch überläßt, also durch ihre Veräußerung nicht auf sein Eigentum an ihr verzichtet.	ch06_clean.en-ch06_clean.de
The second essential condition to the owner of money finding labour-power in the market as a commodity is this – that the labourer instead of being in the position to sell commodities in which his labour is incorporated, must be obliged to offer for sale as a commodity that very labour-power, which exists only in his living self.	Die zweite wesentliche Bedingung, damit der Geldbesitzer die Arbeitskraft auf dem Markt als Ware vorfinde, ist die, daß ihr Besitzer, statt Waren verkaufen zu können, worin sich seine Arbeit vergegenständlicht hat, vielmehr seine Arbeitskraft selbst, die nur in seiner lebendigen Leiblichkeit existiert, als Ware feilbieten muß.	ch06_clean.en-ch06_clean.de
In order that a man may be able to sell commodities other than labour-power, he must of course have the means of production, as raw material, implements, &c. No boots can be made without leather.	Damit jemand von seiner Arbeitskraft unterschiedne Waren verkaufe, muß er natürlich Produktionsmittel besitzen, z.B. Rohstoffe, Arbeitsinstrumente usw. Er kann keine Stiefel machen ohne Leder.	ch06_clean.en-ch06_clean.de
He requires also the means of subsistence.	Er bedarf außerdem Lebensmittel.	ch06_clean.en-ch06_clean.de
Nobody – not even “a musician of the future” – can live upon future products, or upon use-values in an unfinished state; and ever since the first moment of his appearance on the world’s stage, man always has been, and must still be a consumer, both before and while he is producing.	Niemand, selbst kein Zukunftsmusikant, kann von Produkten der Zukunft zehren, also auch nicht von Gebrauchswerten, deren Produktion noch unfertig, und wie am ersten Tage seiner Erscheinung auf der Erdbühne, muß der Mensch noch jeden Tag konsumieren, bevor und während er produziert.	ch06_clean.en-ch06_clean.de
In a society where all products assume the form of commodities, these commodities must be sold after they have been produced, it is only after their sale that they can serve in satisfying the requirements of their producer.	Werden die Produkte als Waren produziert, so müssen sie verkauft werden, nachdem sie produziert sind, und können die Bedürfnisse des Produzenten erst nach dem Verkauf befriedigen.	ch06_clean.en-ch06_clean.de
The time necessary for their sale is superadded to that necessary for their production.	Zur Produktionszeit kommt die für den Verkauf nötige Zeit hinzu.	ch06_clean.en-ch06_clean.de
For the conversion of his money into capital, therefore, the owner of money must meet in the market with the free labourer, free in the double sense, that as a free man he can dispose of his labour-power as his own commodity, and that on the other hand he has no other commodity for sale, is short of everything necessary for the realisation of his labour-power.	Zur Verwandlung von Geld in Kapital muß der Geldbesitzer also den freien Arbeiter auf dem Warenmarkt vorfinden, frei in dem Doppelsinn, daß er als freie Person über seine Arbeitskraft als seine Ware verfügt, daß er andrerseits andre Waren nicht zu verkaufen hat, los und ledig, frei ist von allen zur Verwirklichung seiner Arbeitskraft nötigen Sachen.	ch06_clean.en-ch06_clean.de
The question why this free labourer confronts him in the market, has no interest for the owner of money, who regards the labour-market as a branch of the general market for commodities.	Die Frage, warum dieser freie Arbeiter ihm in der Zirkulationssphäre gegenübertritt, interessiert den Geldbesitzer nicht, der den Arbeitsmarkt als eine besondre Abteilung des Warenmarkts vorfindet.	ch06_clean.en-ch06_clean.de
And for the present it interests us just as little.	Und einstweilen interessiert sie uns ebensowenig.	ch06_clean.en-ch06_clean.de
We cling to the fact theoretically, as he does practically.	Wir halten theoretisch an der Tatsache fest, wie der Geldbesitzer praktisch.	ch06_clean.en-ch06_clean.de
One thing, however, is clear – Nature does not produce on the one side owners of money or commodities, and on the other men possessing nothing but their own labour-power.	Eins jedoch ist klar. Die Natur produziert nicht auf der einen Seite Geld- oder Warenbesitzer und auf der andren bloße Besitzer der eignen Arbeitskräfte.	ch06_clean.en-ch06_clean.de
This relation has no natural basis, neither is its social basis one that is common to all historical periods.	Dies Verhältnis ist kein naturgeschichtliches und ebensowenig ein gesellschaftliches, das allen Geschichtsperioden gemein wäre.	ch06_clean.en-ch06_clean.de
It is clearly the result of a past historical development, the product of many economic revolutions, of the extinction of a whole series of older forms of social production.	Es ist offenbar selbst das Resultat einer vorhergegangenen historischen Entwicklung, das Produkt vieler ökonomischen Umwälzungen, des Untergangs einer ganzen Reihe älterer Formationen der gesellschaftlichen Produktion.	ch06_clean.en-ch06_clean.de
So, too, the economic categories, already discussed by us, bear the stamp of history.	Auch die ökonomischen Kategorien, die wir früher betrachtet, tragen ihre geschichtliche Spur.	ch06_clean.en-ch06_clean.de
Definite historical conditions are necessary that a product may become a commodity.	Im Dasein des Produkts als Ware sind bestimmte historische Bedingungen eingehüllt.	ch06_clean.en-ch06_clean.de
It must not be produced as the immediate means of subsistence of the producer himself.	Um Ware zu werden, darf das Produkt nicht als unmittelbares Subsistenzmittel für den Produzenten selbst produziert werden.	ch06_clean.en-ch06_clean.de
Had we gone further, and inquired under what circumstances all, or even the majority of products take the form of commodities, we should have found that this can only happen with production of a very specific kind, capitalist production.	Hätten wir weiter geforscht: Unter welchen Umständen nehmen alle oder nimmt auch nur die Mehrzahl der Produkte die Form der Ware an, so hätte sich gefunden, daß dies nur auf Grundlage einer ganz spezifischen, der kapitalistischen Produktionsweise, geschieht.	ch06_clean.en-ch06_clean.de
Such an inquiry, however, would have been foreign to the analysis of commodities.	Eine solche Untersuchung lag jedoch der Analyse der Ware fern.	ch06_clean.en-ch06_clean.de
Production and circulation of commodities can take place, although the great mass of the objects produced are intended for the immediate requirements of their producers, are not turned into commodities, and consequently social production is not yet by a long way dominated in its length and breadth by exchange-value.	Warenproduktion und Warenzirkulation können stattfinden, obgleich die weit überwiegende Produktenmasse, unmittelbar auf den Selbstbedarf gerichtet, sich nicht in Ware verwandelt, der gesellschaftliche Produktionsprozeß also noch lange nicht in seiner ganzen Breite und Tiefe vom Tauschwert beherrscht ist.	ch06_clean.en-ch06_clean.de
The appearance of products as commodities pre-supposes such a development of the social division of labour, that the separation of use-value from exchange-value, a separation which first begins with barter, must already have been completed.	Die Darstellung des Produkts als Ware bedingt eine so weit entwickelte Teilung der Arbeit innerhalb der Gesellschaft, daß die Scheidung zwischen Gebrauchswert und Tauschwert, die im unmittelbaren Tauschhandel erst beginnt, bereits vollzogen ist.	ch06_clean.en-ch06_clean.de
But such a degree of development is common to many forms of society, which in other respects present the most varying historical features.	Eine solche Entwicklungsstufe ist aber den geschichtlich verschiedensten ökonomischen Gesellschaftsformationen gemein.	ch06_clean.en-ch06_clean.de
On the other hand, if we consider money, its existence implies a definite stage in the exchange of commodities.	Oder betrachten wir das Geld, so setzt es eine gewisse Höhe des Warenaustausches voraus.	ch06_clean.en-ch06_clean.de
The particular functions of money which it performs, either as the mere equivalent of commodities, or as means of circulation, or means of payment, as hoard or as universal money, point, according to the extent and relative preponderance of the one function or the other, to very different stages in the process of social production.	Die besondren Geldformen, bloßes Warenäquivalent oder Zirkulationsmittel oder Zahlungsmittel, Schatz und Weltgeld, deuten, je nach dem verschiednen Umfang und dem relativen Vorwiegen einer oder der andren Funktion, auf sehr verschiedne Stufen des gesellschaftlichen Produktionsprozesses.	ch06_clean.en-ch06_clean.de
Yet we know by experience that a circulation of commodities relatively primitive, suffices for the production of all these forms.	Dennoch genügt erfahrungsmäßig eine relativ schwach entwickelte Warenzirkulation zur Bildung aller dieser Formen.	ch06_clean.en-ch06_clean.de
Otherwise with capital.	Anders mit dem Kapital.	ch06_clean.en-ch06_clean.de
The historical conditions of its existence are by no means given with the mere circulation of money and commodities.	Seine historischen Existenzbedingungen sind durchaus nicht da mit der Waren- und Geldzirkulation.	ch06_clean.en-ch06_clean.de
It can spring into life, only when the owner of the means of production and subsistence meets in the market with the free labourer selling his labour-power. And this one historical condition comprises a world’s history.	Es entsteht nur, wo der Besitzer von Produktions- und Lebensmitteln den freien Arbeiter als Verkäufer seiner Arbeitskraft auf dem Markt vorfindet, und diese eine historische Bedingung umschließt eine Weltgeschichte.	ch06_clean.en-ch06_clean.de
Capital, therefore, announces from its first appearance a new epoch in the process of social production.	Das Kapital kündigt daher von vornherein eine Epoche des gesellschaftlichen Produktionsprozesses an.	ch06_clean.en-ch06_clean.de
We must now examine more closely this peculiar commodity, labour-power.	Diese eigentümliche Ware, die Arbeitskraft, ist nun näher zu betrachten.	ch06_clean.en-ch06_clean.de
Like all others it has a value.	Gleich allen andren Waren besitzt sie einen Wert.	ch06_clean.en-ch06_clean.de
How is that value determined?	Wie wird er bestimmt?	ch06_clean.en-ch06_clean.de
The value of labour-power is determined, as in the case of every other commodity, by the labour-time necessary for the production, and consequently also the reproduction, of this special article.	Der Wert der Arbeitskraft, gleich dem jeder andren Ware, ist bestimmt durch die zur Produktion, also auch Reproduktion, dieses spezifischen Artikels notwendige Arbeitszeit.	ch06_clean.en-ch06_clean.de
So far as it has value, it represents no more than a definite quantity of the average labour of society incorporated in it.	So sie Wert, repräsentiert die Arbeits- kraft selbst nur ein bestimmtes Quantum in ihr vergegenständlichter gesellschaftlicher Durchschnittsarbeit.	ch06_clean.en-ch06_clean.de
Labour-power exists only as a capacity, or power of the living individual.	Die Arbeitskraft existiert nur als Anlage des lebendigen Individuums.	ch06_clean.en-ch06_clean.de
Its production consequently pre-supposes his existence.	Ihre Produktion setzt also seine Existenz voraus.	ch06_clean.en-ch06_clean.de
Given the individual, the production of labour-power consists in his reproduction of himself or his maintenance.	Die Existenz des Individuums gegeben, besteht die Produktion der Arbeitskraft in seiner eignen Reproduktion oder Erhaltung.	ch06_clean.en-ch06_clean.de
For his maintenance he requires a given quantity of the means of subsistence.	Zu seiner Erhaltung bedarf das lebendige Individuum einer gewissen Summe von Lebensmitteln.	ch06_clean.en-ch06_clean.de
Therefore the labour-time requisite for the production of labour-power reduces itself to that necessary for the production of those means of subsistence; in other words, the value of labour-power is the value of the means of subsistence necessary for the maintenance of the labourer.	Die zur Produktion der Arbeitskraft notwendige Arbeitszeit löst sich also auf in die zur Produktion dieser Lebensmittel notwendige Arbeitszeit, oder der Wert der Arbeitskraft ist der Wert der zur Erhaltung ihres Besitzers notwendigen Lebensmittel.	ch06_clean.en-ch06_clean.de
Labour-power, however, becomes a reality only by its exercise; it sets itself in action only by working.	Die Arbeitskraft verwirklicht sich jedoch nur durch ihre Äußerung, betätigt sich nur in der Arbeit.	ch06_clean.en-ch06_clean.de
But thereby a definite quantity of human muscle, nerve, brain, &c., is wasted, and these require to be restored.	Durch ihre Betätigung, die Arbeit, wird aber ein bestimmtes Quantum von menschlichem Muskel, Nerv, Hirn usw. verausgabt, das wieder ersetzt werden muß.	ch06_clean.en-ch06_clean.de
This increased expenditure demands a larger income.	Diese vermehrte Ausgabe bedingt eine vermehrte Einnahme.	ch06_clean.en-ch06_clean.de
If the owner of labour-power works to-day, to-morrow he must again be able to repeat the same process in the same conditions as regards health and strength.	Wenn der Eigentümer der Arbeitskraft heute gearbeitet hat, muß er denselben Prozeß morgen unter denselben Bedingungen von Kraft und Gesundheit wiederholen können.	ch06_clean.en-ch06_clean.de
His means of subsistence must therefore be sufficient to maintain him in his normal state as a labouring individual.	Die Summe der Lebensmittel muß also hinreichen, das arbeitende Individuum als arbeitendes Individuum in seinem normalen Lebenszustand zu erhalten.	ch06_clean.en-ch06_clean.de
His natural wants, such as food, clothing, fuel, and housing, vary according to the climatic and other physical conditions of his country.	Die natürlichen Bedürfnisse selbst, wie Nahrung, Kleidung, Heizung, Wohnung usw., sind verschieden je nach den klimatischen und andren natürlichen Eigentümlichkeiten eines Landes.	ch06_clean.en-ch06_clean.de
On the other hand, the number and extent of his so-called necessary wants, as also the modes of satisfying them, are themselves the product of historical development, and depend therefore to a great extent on the degree of civilisation of a country, more particularly on the conditions under which, and consequently on the habits and degree of comfort in which, the class of free labourers has been formed.	Andrerseits ist der Umfang sog. notwendiger Bedürfnisse, wie die Art ihrer Befriedigung, selbst ein historisches Produkt und hängt daher großenteils von der Kulturstufe eines Landes, unter andrem auch wesentlich davon ab, unter welchen Bedingungen, und daher mit welchen Gewohnheiten und Lebensansprüchen die Klasse der freien Arbeiter sich gebildet hat.	ch06_clean.en-ch06_clean.de
In contradistinction therefore to the case of other commodities, there enters into the determination of the value of labour-power a historical and moral element.	Im Gegensatz zu den andren Waren enthält also die Wertbestimmung der Arbeitskraft ein historisches und moralisches Element.	ch06_clean.en-ch06_clean.de
Nevertheless, in a given country, at a given period, the average quantity of the means of subsistence necessary for the labourer is practically known.	Für ein bestimmtes Land, zu einer bestimmten Periode jedoch, ist der Durchschnitts-Umkreis der notwendigen Lebensmittel gegeben.	ch06_clean.en-ch06_clean.de
The owner of labour-power is mortal.	Der Eigentümer der Arbeitskraft ist sterblich.	ch06_clean.en-ch06_clean.de
If then his appearance in the market is to be continuous, and the continuous conversion of money into capital assumes this, the seller of labour-power must perpetuate himself, “in the way that every living individual perpetuates himself, by procreation.”	Soll also seine Erscheinung auf dem Markt eine kontinuierliche sein, wie die kontinuierliche Verwandlung von Geld in Kapital voraussetzt, so muß der Verkäufer der Arbeitskraft sich verewigen, "wie jedes lebendige Individuum sich verewigt, durch Fortpflanzung".	ch06_clean.en-ch06_clean.de
The labour-power withdrawn from the market by wear and tear and death, must be continually replaced by, at the very least, an equal amount of fresh labour-power.	Die durch Abnutzung und Tod dem Markt entzogenen Arbeitskräfte müssen zum allermindesten durch eine gleiche Zahl neuer Arbeitskräfte beständigt ersetzt werden.	ch06_clean.en-ch06_clean.de
Hence the sum of the means of subsistence necessary for the production of labour-power must include the means necessary for the labourer’s substitutes, i.e., his children, in order that this race of peculiar commodity-owners may perpetuate its appearance in the market.	Die Summe der zur Produktion der Arbeitskraft notwendigen Lebensmittel schließt also die Lebensmittel der Ersatzmänner ein, d.h. der Kinder der Arbeiter, so daß sich diese Race eigentümlicher Warenbesitzer auf dem Warenmarkte verewigt.	ch06_clean.en-ch06_clean.de
In order to modify the human organism, so that it may acquire skill and handiness in a given branch of industry, and become labour-power of a special kind, a special education or training is requisite, and this, on its part, costs an equivalent in commodities of a greater or less amount.	Um die allgemein menschliche Natur so zu modifizieren, daß sie Geschick und Fertigkeit in einem bestimmten Arbeitszweig erlangt, entwickelte und spezifische Arbeitskraft wird, bedarf es einer bestimmten Bildung oder Erziehung, welche ihrerseits eine größere oder geringere Summe von Warenäquivalenten kostet.	ch06_clean.en-ch06_clean.de
This amount varies according to the more or less complicated character of the labour-power.	Je nach dem mehr oder minder vermittelten Charakter der Arbeitskraft sind ihre Bildungskosten verschieden.	ch06_clean.en-ch06_clean.de
The expenses of this education (excessively small in the case of ordinary labour-power), enter pro tanto into the total value spent in its production.	Diese Erlernungskosten, verschwindend klein für die gewöhnliche Arbeitskraft, gehn also ein in den Umkreis der zu ihrer Produktion verausgabten Werte.	ch06_clean.en-ch06_clean.de
The value of labour-power resolves itself into the value of a definite quantity of the means of subsistence.	Der Wert der Arbeitskraft löst sich auf in den Wert einer bestimmten Summe von Lebensmitteln.	ch06_clean.en-ch06_clean.de
It therefore varies with the value of these means or with the quantity of labour requisite for their production.	Er wechselt daher auch mit dem Wert dieser Lebensmittel, d.h. der Größe der zu ihrer Produktion erheischten Arbeitszeit.	ch06_clean.en-ch06_clean.de
Some of the means of subsistence, such as food and fuel, are consumed daily, and a fresh supply must be provided daily.	Ein Teil der Lebensmittel, z.B. Nahrungsmittel, Heizungsmittel usw., werden täglich neu verzehrt und müssen täglich neu ersetzt werden.	ch06_clean.en-ch06_clean.de
Others such as clothes and furniture last for longer periods and require to be replaced only at longer intervals.	Andre Lebensmittel, wie Kleider, Möbel usw., verbrauchen sich in längeren Zeiträumen und sind daher nur in längeren Zeiträumen zu ersetzen.	ch06_clean.en-ch06_clean.de
One article must be bought or paid for daily, another weekly, another quarterly, and so on.	Waren einer Art müssen täglich, andre wöchentlich, vierteljährlich usf. gekauft oder gezahlt werden.	ch06_clean.en-ch06_clean.de
But in whatever way the sum total of these outlays may be spread over the year, they must be covered by the average income, taking one day with another.	Wie sich die Summe dieser Ausgaben aber immer während eines Jahres z.B. verteilen möge, sie muß gedeckt sein durch die Durchschnittseinnahme tagein, tagaus.	ch06_clean.en-ch06_clean.de
If the total of the commodities required daily for the production of labour-power = A, and those required weekly = B, and those required quarterly = C, and so on, the daily average of these commodities = (365A + 52B + 4C + &c) / 365.	Wäre die Masse der täglich zur Produktion der Arbeitskraft erheischten Waren = A, die der wöchentlich erheischten = B, die der vierteljährlich erheischten = C usw., so wäre der täglich Durchschnitt dieser Waren = 365A + 52B + 4C + usw./365.	ch06_clean.en-ch06_clean.de
Suppose that in this mass of commodities requisite for the average day there are embodied 6 hours of social labour, then there is incorporated daily in labour-power half a day’s average social labour, in other words, half a day’s labour is requisite for the daily production of labour-power.	Gesetzt, in dieser für den Durchschnittstag nötigen Warenmasse steckten 6 Stunden gesellschaftlicher Arbeit, so vergegenständlicht sich in der Arbeitskraft täglich ein halber Tag gesellschaftlicher Durchschnittsarbeit, oder ein halber Arbeitstag ist zur täglichen Produktion der Arbeitskraft erheischt.	ch06_clean.en-ch06_clean.de
This quantity of labour forms the value of a day’s labour-power or the value of the labour-power daily reproduced.	Dies zu ihrer täglichen Produktion erheischte Arbeitsquantum bildet den Tageswert der Arbeitskraft oder den Wert der täglich reproduzierten Arbeitskraft.	ch06_clean.en-ch06_clean.de
If half a day’s average social labour is incorporated in three shillings, then three shillings is the price corresponding to the value of a day’s labour-power.	Wenn sich ein halber Tag gesellschaftlicher Durchschnittsarbeit ebenfalls in einer Goldmasse von 3 sh. oder einem Taler darstellt, so ist ein Taler der dem Tauschwert der Arbeitskraft entsprechende Preis.	ch06_clean.en-ch06_clean.de
If its owner therefore offers it for sale at three shillings a day, its selling price is equal to its value, and according to our supposition, our friend Moneybags, who is intent upon converting his three shillings into capital, pays this value.	Bietet der Besitzer der Arbeitskraft sie feil für einen Taler täglich, so ist ihr Verkaufspreis gleich ihrem Wert und, nach unsrer Voraussetzung, zahlt der auf Verwandlung seiner Taler in Kapital erpichte Geldbesitzer diesen Wert.	ch06_clean.en-ch06_clean.de
The minimum limit of the value of labour-power is determined by the value of the commodities, without the daily supply of which the labourer cannot renew his vital energy, consequently by the value of those means of subsistence that are physically indispensable.	Die letzte Grenze oder Minimalgrenze des Werts der Arbeitskraft wird gebildet durch den Wert einer Warenmasse, ohne deren tägliche Zufuhr der Träger der Arbeitskraft, der Mensch, seinen Lebensprozeß nicht erneuern kann, also durch den Wert der physisch unentbehrlichen Lebensmittel.	ch06_clean.en-ch06_clean.de
If the price of labour-power fall to this minimum, it falls below its value, since under such circumstances it can be maintained and developed only in a crippled state.	Sinkt der Preis der Arbeitskraft auf diese Minimum, so sinkt er unter ihren Wert, denn sie kann sich so nur in verkümmerter Form erhalten und entwickeln.	ch06_clean.en-ch06_clean.de
But the value of every commodity is determined by the labour-time requisite to turn it out so as to be of normal quality.	Der Wert jeder Ware ist aber bestimmt durch die Arbeitszeit, erfordert, um sie in normaler Güte zu liefern.	ch06_clean.en-ch06_clean.de
It is a very cheap sort of sentimentality which declares this method of determining the value of labour-power, a method prescribed by the very nature of the case, to be a brutal method, and which wails with Rossi that, “To comprehend capacity for labour (puissance de travail) at the same time that we make abstraction from the means of subsistence of the labourers during the process of production, is to comprehend a phantom (être de raison).	Es ist eine außerordentlich wohlfeile Sentimentalität, diese aus der Natur der Sache fließende Wertbestimmung der Arbeitskraft grob zu finden und etwa mit Rossi zu jammern: "Das Arbeitsvermögen (puissance de travail) begreifen, während man von den Subsistenzmitteln der Arbeit während des Produktionsprozesses abstrahiert, heißt ein Hirngespinst (être de raison) begreifen.	ch06_clean.en-ch06_clean.de
When we speak of labour, or capacity for labour, we speak at the same time of the labourer and his means of subsistence, of labourer and wages.”	Wer Arbeit sagt, wer Arbeitsvermögen sagt, sagt zugleich Arbeiter und Subsistenzmittel, Arbeiter und Arbeitslohn."	ch06_clean.en-ch06_clean.de
When we speak of capacity for labour, we do not speak of labour, any more than when we speak of capacity for digestion, we speak of digestion.	Wer Arbeitsvermögen sagt, sagt nicht Arbeit, so wenig als wer Verdauungsvermögen sagt, Verdauen sagt.	ch06_clean.en-ch06_clean.de
The latter process requires something more than a good stomach.	Zum letztren Prozeß ist bekanntlich mehr als ein guter Magen erfordert.	ch06_clean.en-ch06_clean.de
When we speak of capacity for labour, we do not abstract from the necessary means of subsistence.	Wer Arbeitsvermögen sagt, abstrahiert nicht von den zu seiner Subsistenz notwendigen Lebensmitteln.	ch06_clean.en-ch06_clean.de
On the contrary, their value is expressed in its value.	Ihr Wert ist vielmehr ausgedrückt in seinem Wert.	ch06_clean.en-ch06_clean.de
If his capacity for labour remains unsold, the labourer derives no benefit from it, but rather he will feel it to be a cruel nature-imposed necessity that this capacity has cost for its production a definite amount of the means of subsistence and that it will continue to do so for its reproduction.	Wird es nicht verkauft, so nützt es dem Arbeiter nichts, so empfindet er es vielmehr als eine grausame Naturnotwendigkeit, daß sein Arbeitsvermögen ein bestimmtes Quantum Subsistenzmittel zu seiner Produktion erheischt hat und stets wieder von neuem zu seiner Reproduktion erheischt.	ch06_clean.en-ch06_clean.de
He will then agree with Sismondi: “that capacity for labour ... is nothing unless it is sold.”	Er entdeckt dann mit Sismondi: "Das Arbeitsvermögen ... ist nichts, wenn es nicht verkauft wird" .	ch06_clean.en-ch06_clean.de
One consequence of the peculiar nature of labour-power as a commodity is, that its use-value does not, on the conclusion of the contract between the buyer and seller, immediately pass into the hands of the former.	Die eigentümliche Natur dieser spezifischen Ware, der Arbeitskraft, bringt es mit sich, daß mit der Abschließung des Kontrakts zwischen Käufer und Verkäufer ihr Gebrauchswert noch nicht wirklich in die Hand des Käufers übergegangen ist.	ch06_clean.en-ch06_clean.de
Its value, like that of every other commodity, is already fixed before it goes into circulation, since a definite quantity of social labour has been spent upon it; but its use-value consists in the subsequent exercise of its force.	Ihr Wert, gleich dem jeder andren Ware, war bestimmt, bevor sie in die Zirkulation trat, denn ein bestimmtes Quantum gesellschaftlicher Arbeit ward zur Produktion der Arbeitskraft verausgabt, aber ihr Gebrauchswert besteht erst in der nachträglichen Kraftäußerung.	ch06_clean.en-ch06_clean.de
The alienation of labour-power and its actual appropriation by the buyer, its employment as a use-value, are separated by an interval of time.	Die Veräußerung der Kraft und ihre wirkliche Äußerung, d.h. ihr Dasein als Gebrauchswert, fallen daher der Zeit nach auseinander.	ch06_clean.en-ch06_clean.de
But in those cases in which the formal alienation by sale of the use-value of a commodity, is not simultaneous with its actual delivery to the buyer, the money of the latter usually functions as means of payment.	Bei solchen Waren aber , wo die formelle Veräußerung des Gebrauchswerts durch den Verkauf und seine wirkliche Überlassung an den Käufer der Zeit nach auseinanderfallen, funktioniert das Geld des Käufers meist als Zahlungsmittel.	ch06_clean.en-ch06_clean.de
In every country in which the capitalist mode of production reigns, it is the custom not to pay for labour-power before it has been exercised for the period fixed by the contract, as for example, the end of each week.	In allen Ländern kapitalistischer Produktionsweise wird die Arbeitskraft erst gezahlt, nachdem sie bereits während des im Kaufkontrakt festgesetzten Termins funktioniert hat, z.B. am Ende jeder Woche.	ch06_clean.en-ch06_clean.de
In all cases, therefore, the use-value of the labour-power is advanced to the capitalist: the labourer allows the buyer to consume it before he receives payment of the price; he everywhere gives credit to the capitalist.	Überall schießt daher der Arbeiter dem Kapitalisten den Gebrauchswert der Arbeitskraft vor; er läßt sie vom Käufer konsumieren, bevor er ihrem Preis bezahlt erhält, überall kreditiert daher der Arbeiter dem Kapitalisten.	ch06_clean.en-ch06_clean.de
That this credit is no mere fiction, is shown not only by the occasional loss of wages on the bankruptcy of the capitalist, but also by a series of more enduring consequences.	Daß dies Kreditieren kein leerer Wahn ist, zeigt nicht nur der gelegentliche Verlust des kreditierten Lohns beim Bankrott des Kapitalisten , sondern auch eine Reihe mehr nachhaltiger Wirkungen.	ch06_clean.en-ch06_clean.de
Nevertheless, whether money serves as a means of purchase or as a means of payment, this makes no alteration in the nature of the exchange of commodities.	Indes ändert es an der Natur des Warenaustausches selbst nichts, ob das Geld als Kaufmittel oder als Zahlungsmittel funktioniert.	ch06_clean.en-ch06_clean.de
The price of the labour-power is fixed by the contract, although it is not realised till later, like the rent of a house.	Der Preis der Arbeitskraft ist kontraktlich festgesetzt, obgleich er erst hinterher realisiert wird, wie der Mietpreis eines Hauses.	ch06_clean.en-ch06_clean.de
The labour-power is sold, although it is only paid for at a later period.	Die Arbeitskraft ist verkauft, obgleich sie erst hinterher bezahlt wird.	ch06_clean.en-ch06_clean.de
It will, therefore, be useful, for a clear comprehension of the relation of the parties, to assume provisionally, that the possessor of labour-power, on the occasion of each sale, immediately receives the price stipulated to be paid for it.	Für die reine Auffassung des Verhältnisses ist es jedoch nützlich, einstweilen vorauszusetzen, daß der Besitzer der Arbeitskraft mit ihrem Verkauf jedesmal auch sogleich den kontraktlich stipulierten Preis erhält.	ch06_clean.en-ch06_clean.de
We now know how the value paid by the purchaser to the possessor of this peculiar commodity, labour-power, is determined.	Wir kennen nun die Art und Weise der Bestimmung des Werts, welcher dem Besitzer dieser eigentümlichen Ware, der Arbeitskraft, vom Geldbesitzer gezahlt wird.	ch06_clean.en-ch06_clean.de
The use-value which the former gets in exchange, manifests itself only in the actual utilisation, in the consumption of the labour-power.	Der Gebrauchswert, den letztrer seinerseits im Austausch erhält, zeigt sich erst im wirklichen Verbrauch, im Konsumtionsprozeß der Arbeitskraft.	ch06_clean.en-ch06_clean.de
The money-owner buys everything necessary for this purpose, such as raw material, in the market, and pays for it at its full value.	Alle zu diesem Prozeß nötigen Dinge, wie Rohmaterial usw., kauft der Geldbesitzer auf dem Warenmarkt und zahlt sie zum vollen Preis.	ch06_clean.en-ch06_clean.de
The consumption of labour-power is at one and the same time the production of commodities and of surplus-value.	Der Konsumtionsprozeß der Arbeitskraft ist zugleich der Produktionsprozeß von Ware und von Mehrwert.	ch06_clean.en-ch06_clean.de
The consumption of labour-power is completed, as in the case of every other commodity, outside the limits of the market or of the sphere of circulation.	Die Konsumtion der Arbeitskraft, gleich der Konsumtion jeder andren Ware, vollzieht sich außerhalb des Markts oder der Zirkulationssphäre.	ch06_clean.en-ch06_clean.de
Accompanied by Mr. Moneybags and by the possessor of labour-power, we therefore take leave for a time of this noisy sphere, where everything takes place on the surface and in view of all men, and follow them both into the hidden abode of production, on whose threshold there stares us in the face “No admittance except on business.” Here we shall see, not only how capital produces, but how capital is produced.	Diese geräuschvolle, auf der Oberfläche hausende und aller Augen zugängliche Sphäre verlassen wir daher, zusammen mit Geldbesitzer und Arbeitskraftbesitzer, um beiden nachzufolgen in die verborgne Stätte der Produktion, an deren Schwelle zu lesen steht: No admittance except on business. <Eintritt nur in Geschäftsangelegenheiten.> Hier wird sich zeigen, nicht nur wie das Kapital produziert, sondern auch wie man es selbst produziert, das Kapital.	ch06_clean.en-ch06_clean.de
We shall at last force the secret of profit making.	Das Geheimnis der Plusmacherei muß sich endlich enthüllen.	ch06_clean.en-ch06_clean.de
This sphere that we are deserting, within whose boundaries the sale and purchase of labour-power goes on, is in fact a very Eden of the innate rights of man.	Die Sphäre der Zirkulation oder des Warenaustausches, innerhalb deren Schranken Kauf und Verkauf der Arbeitskraft sich bewegt, war in der Tat ein wahres Eden der angebornen Menschenrechte.	ch06_clean.en-ch06_clean.de
There alone rule Freedom, Equality, Property and Bentham.	Was allein hier herrscht, ist Freiheit, Gleichheit, Eigentum und Bentham.	ch06_clean.en-ch06_clean.de
Freedom, because both buyer and seller of a commodity, say of labour-power, are constrained only by their own free will.	Freiheit! Denn Käufer und Verkäufer einer Ware, z.B. der Arbeitskraft, sind nur durch ihren freien Willen bestimmt.	ch06_clean.en-ch06_clean.de
They contract as free agents, and the agreement they come to, is but the form in which they give legal expression to their common will.	Sie kontrahieren als freie, rechtlich ebenbürtige Personen. Der Kontrakt ist das Endresultat, worin sich ihre Willen einen gemeinsamen Rechtsausdruck geben.	ch06_clean.en-ch06_clean.de
Equality, because each enters into relation with the other, as with a simple owner of commodities, and they exchange equivalent for equivalent.	Gleichheit! Denn sie beziehen sich nur als Warenbesitzer aufeinander und tauschen Äquivalent für Äquivalent.	ch06_clean.en-ch06_clean.de
Property, because each disposes only of what is his own.	Eigentum! Denn jeder verfügt nur über das Seine. Bentham!	ch06_clean.en-ch06_clean.de
And Bentham, because each looks only to himself.	Denn jedem von den beiden ist es nur um sich zu tun.	ch06_clean.en-ch06_clean.de
The only force that brings them together and puts them in relation with each other, is the selfishness, the gain and the private interests of each.	Die einzige Macht, die sie zusammen und in ein Verhältnis bringt, ist die ihres Eigennutzes, ihres Sondervorteils, ihrer Privatinteressen.	ch06_clean.en-ch06_clean.de
Each looks to himself only, and no one troubles himself about the rest, and just because they do so, do they all, in accordance with the pre-established harmony of things, or under the auspices of an all-shrewd providence, work together to their mutual advantage, for the common weal and in the interest of all.	Und eben weil so jeder nur für sich und keiner für den andren kehrt, vollbringen alle, infolge einer prästabilierten Harmonie der Dinge oder unter den Auspizien einer allpfiffigen Vorsehung, nur das Werk ihres wechselseitigen Vorteils, des Gemeinnutzens, des Gesamtinteresses.	ch06_clean.en-ch06_clean.de
On leaving this sphere of simple circulation or of exchange of commodities, which furnishes the “Free-trader Vulgaris” with his views and ideas, and with the standard by which he judges a society based on capital and wages, we think we can perceive a change in the physiognomy of our dramatis personae.	Beim Scheiden von dieser Sphäre der einfachen Zirkulation oder des Warenaustausches, woraus der Freihändler vulgaris Anschauungen, Be- griffe und Maßstab für sein Urteil über die Gesellschaft des Kapitals und der Lohnarbeit entlehnt, verwandelt sich, so scheint es, schon in etwas die Physiognomie unsrer dramatis personae.	ch06_clean.en-ch06_clean.de
He, who before was the money-owner, now strides in front as capitalist; the possessor of labour-power follows as his labourer. The one with an air of importance, smirking, intent on business; the other, timid and holding back, like one who is bringing his own hide to market and has nothing to expect but – a hiding.	Der ehemalige Geldbesitzer schreitet voran als Kapitalist, der Arbeitskraftbesitzer folgt ihm nach als sein Arbeiter; der eine bedeutungsvoll schmunzelnd und geschäftseifrig, der andre scheu, widerstrebsam, wie jemand, der seine eigne Haut zu Markt getragen und nun nichts andres zu erwarten hat als die - Gerberei.	ch06_clean.en-ch06_clean.de

