Chapter 9: The Rate of Surplus-Value Section 1: The Degree of Exploitation of Labour-Power The surplus-value generated in the process of production by C, the capital advanced, or in other words, the self-expansion of the value of the capital C, presents itself for our consideration, in the first place, as a surplus, as the amount by which the value of the product exceeds the value of its constituent elements.	SIEBENTES KAPITEL Die Rate des Mehrwerts 1. Der Exploitationsgrad der Arbeitskraft Der Mehrwert, den das vorgeschoßne Kapital C im Produktionsprozeß erzeugt hat, oder die Verwertung des vorgeschoßnen Kapitalwerts C stellt sich zunächst dar als Überschuß des Werts des Produkts über die Wertsumme seiner Produktionselemente.	ch09_clean.en-ch09_clean.de
The capital C is made up of two components, one, the sum of money c laid out upon the means of production, and the other, the sum of money v expended upon the labour-power; c represents the portion that has become constant capital, and v the portion that has become variable capital.	Das Kapital C zerfällt in zwei Teile, eine Geldsumme c, die für Produktionsmittel, und eine andre Geldsumme v, die für Arbeitskraft verausgabt wird; c stellt den in konstantes, v den in variables Kapital verwandelten Wertteil vor.	ch09_clean.en-ch09_clean.de
At first then, C = c + v: for example, if £ is the capital advanced, its components may be such that the £ = £ const. + £ var.	Ursprünglich ist also C = c + v, z.B. das vorgeschoßne Kapital von 500 Pfd.St. = 410 Pfd.St. + 90 Pfd.St.	ch09_clean.en-ch09_clean.de
When the process of production is finished, we get a commodity whose value = (c + v) + s, where s is the surplus-value; or taking our former figures, the value of this commodity may be (£ const. + £ var.) + £ surpl.	Am Ende des Produktionsprozesses kommt Ware heraus, deren Wert = c + v + m, wo m der Mehrwert, z.B. 410 Pfd.St. + 90 Pfd.St. + 90 Pfd.St.	ch09_clean.en-ch09_clean.de
The original capital has now changed from C to C', from £ to £590.	Das ursprüngliche Kapital C hat sich in C' verwandelt, aus 500 Pfd.St. in 590 Pfd.St.	ch09_clean.en-ch09_clean.de
The difference is s or a surplus-value of £90. Since the value of the constituent elements of the product is equal to the value of the advanced capital, it is mere tautology to say, that the excess of the value of the product over the value of its constituent elements, is equal to the expansion of the capital advanced or to the surplus-value produced.	Die Differenz zwischen beiden ist = m, einem Mehrwert von 90. Da der Wert der Produktionselemente gleich dem Wert des vorgeschoßnen Kapitals, so ist es in der Tat eine Tautologie, daß der Überschuß des Produktenwerts über den Wert seiner Produktionselemente gleich der Verwertung des vorgeschoßnen Kapitals oder gleich dem produzierten Mehrwert.	ch09_clean.en-ch09_clean.de
Nevertheless, we must examine this tautology a little more closely.	Indes erfordert diese Tautologie eine nähere Bestimmung.	ch09_clean.en-ch09_clean.de
The two things compared are, the value of the product and the value of its constituents consumed in the process of production.	Was mit dem Produktenwert verglichen wird, ist der Wert der in seiner Bildung aufgezehrten Produktionselemente.	ch09_clean.en-ch09_clean.de
Now we have seen how that portion of the constant capital which consists of the instruments of labour, transfers to the production only a fraction of its value, while the remainder of that value continues to reside in those instruments.	Nun haben wir aber gesehn, daß der aus Arbeitsmitteln bestehende Teil des angewandten konstanten Kapitals nur ein Stück seines Werts an das Produkt abgibt, während ein andres Stück in seiner alten Existenzform fortdauert.	ch09_clean.en-ch09_clean.de
Since this remainder plays no part in the formation of value, we may at present leave it on one side.	Da das letztre keine Rolle in der Wertbildung spielt, ist hier davon zu abstrahieren.	ch09_clean.en-ch09_clean.de
To introduce it into the calculation would make no difference.	Sein Hineinziehen in die Rechnung würde nichts ändern.	ch09_clean.en-ch09_clean.de
For instance, taking our former example, c = £410: suppose this sum to consist of £ value of raw material, £ value of auxiliary material, and £ value of the machinery worn away in the process; and suppose that the total value of the machinery employed is £1,054.	Nimm an, c = 410 Pfd.St. bestehe aus Rohmaterial zu 312 Pfd.St., Hilfsstoffen zu 44 Pfd.St. und im Prozeß verschleißender Maschinerie von 54 Pfd.St., der Wert der wirklich angewandten Maschinerie betrage aber 1.054 Pfd.St.	ch09_clean.en-ch09_clean.de
Out of this latter sum, then, we reckon as advanced for the purpose of turning out the product, the sum of £ alone, which the machinery loses by wear and tear in the process; for this is all it parts with to the product.	Als vorgeschossen zur Erzeugung des Produktenwerts berechnen wir nur den Wert von 54 Pfd.St., den die Maschinerie durch ihre Funktion verliert und daher dem Produkt abgibt.	ch09_clean.en-ch09_clean.de
Now if we also reckon the remaining £1,000, which still continues in the machinery, as transferred to the product, we ought also to reckon it as part of the value advanced, and thus make it appear on both sides of our calculation.	Rechneten wir die 1.000 Pfd.St. mit, die in ihrer alten Form fortexistieren als Dampfmaschine usw., so müßten wir sie auf beiden Seiten mitrechnen, auf Seite des vorgeschoßnen Werts und auf Seite des Produktenwerts (26a), und erhielten so resp.	ch09_clean.en-ch09_clean.de
We should, in this way, get £1, on one side and £1, on the other.	1.500 Pfd.St. und 1.590 Pfd.St.	ch09_clean.en-ch09_clean.de
The difference of these two sums, or the surplus-value, would still be £90.	Die Differenz oder der Mehrwert wäre nach wie vor 90 Pfd.St.	ch09_clean.en-ch09_clean.de
Throughout this Book therefore, by constant capital advanced for the production of value, we always mean, unless the context is repugnant thereto, the value of the means of production actually consumed in the process, and that value alone.	Unter dem zur Wertproduktion vorgeschoßnen konstanten Kapital verstehen wir daher, wo das Gegenteil nicht aus dem Zusammenhang erhellt, stets nur den Wert der in der Produktion verzehrten Produktionsmittel.	ch09_clean.en-ch09_clean.de
This being so, let us return to the formula C = c + v, which we saw was transformed into C' = (c + v) + s, C becoming C'.	Dies vorausgesetzt, kehren wir zurück zur Formel C = c + v, die sich in C' = c + v + m und eben dadurch C in C' verwandelt.	ch09_clean.en-ch09_clean.de
We know that the value of the constant capital is transferred to, and merely re-appears in the product.	Man weiß, daß der Wert des konstanten Kapitals im Produkt nur wieder erscheint.	ch09_clean.en-ch09_clean.de
The new value actually created in the process, the value produced, or value-product, is therefore not the same as the value of the product; it is not, as it would at first sight appear (c + v) + s or £ const. + £ var. + £ surpl. ; but v + s or £ var. + £ surpl., not £ but £180.	Das im Prozeß wirklich neu erzeugte Wertprodukt ist also verschieden von dem aus dem Prozeß erhaltnen Produktenwert, daher nicht, wie es auf den ersten Blick scheint, c + v + m oder 410 Pfd.St. + 90 Pfd.St. + 90, sondern v + m oder 90 Pfd.St. + 90 Pfd.St., nicht 590 Pfd.St., sondern 180 Pfd.St.	ch09_clean.en-ch09_clean.de
If c = 0, or in other words, if there were branches of industry in which the capitalist could dispense with all means of production made by previous labour, whether they be raw material, auxiliary material, or instruments of labour, employing only labour-power and materials supplied by Nature, in that case, there would be no constant capital to transfer to the product.	Wäre c, das konstante Kapital, = 0, in andren Worten, gäbe es Industriezweige, worin der Kapitalist keine produzierten Produktionsmittel, weder Rohmaterial noch Hilfsstoffe, noch Arbeitsinstrumente, sondern nur von Natur vorhandne Stoffe und Arbeitskraft anzuwenden hätte, so wäre kein konstanter Wertteil auf das Produkt zu übertragen.	ch09_clean.en-ch09_clean.de
This component of the value of the product, i.e., the £ in our example, would be eliminated, but the sum of £180, the amount of new value created, or the value produced, which contains £ of surplus-value, would remain just as great as if c represented the highest value imaginable.	Dies Element des Produktenwerts, in unsrem Beispiel 410 Pfd.St., fiele fort, aber das Wertprodukt von 180 Pfd.St., welches 90 Pfd.St.	ch09_clean.en-ch09_clean.de
We should have C = ( + v) = v or C' the expanded capital = v + s and therefore C' - C = s as before.	Mehrwert enthält, bliebe ganz ebenso groß, als ob c die größte Wertsumme darstellte.	ch09_clean.en-ch09_clean.de
On the other hand, if s = 0, or in other words, if the labour-power, whose value is advanced in the form of variable capital, were to produce only its equivalent, we should have C = c + v or C' the value of the product = (c + v) + 0 or C = C'.	Wir hätten C = 0 + v = v, und C', das verwertete Kapital, = v + m, C' - C nach wie vor = m. Wäre umgekehrt m = 0, in andren Worten, hätte die Arbeitskraft, deren Wert im variablen Kapital vorgeschossen wird, nur ein Äquivalent produziert, so C = c + v, und C' (der Produktenwert) = c + v + 0, daher C = C'.	ch09_clean.en-ch09_clean.de
The capital advanced would, in this case, not have expanded its value.	Das vorgeschoßne Kapital hätte sich nicht verwertet.	ch09_clean.en-ch09_clean.de
From what has gone before, we know that surplus-value is purely the result of a variation in the value of v, of that portion of the capital which is transformed into labour-power; consequently, v + s = v + v', or v plus an increment of v. But the fact that it is v alone that varies, and the conditions of that variation, are obscured by the circumstance that in consequence of the increase in the variable component of the capital, there is also an increase in the sum total of the advanced capital.	Wir wissen in der Tat bereits, daß der Mehrwert bloß Folge der Wertveränderung ist, die mit v, dem in Arbeitskraft umgesetzten Kapitalteil vorgeht, daß also v + m = v + Dv (v plus Inkrement von v) ist. Aber die wirkliche Wertveränderung und das Verhältnis, worin sich der Wert ändert, werden dadurch verdunkelt, daß infolge des Wachstums seines variierenden Bestandteils auch das vorgeschoßne Gesamtkapital wächst.	ch09_clean.en-ch09_clean.de
It was originally £ and becomes £590.	Es war 500, und es wird 590.	ch09_clean.en-ch09_clean.de
Therefore in order that our investigation may lead to accurate results, we must make abstraction from that portion of the value of the product, in which constant capital alone appears, and consequently must equate the constant capital to zero or make c = 0.	Die reine Analyse des Prozesses erheischt also von dem Teil des Produktenwerts, worin nur konstanter Kapitalwert wieder erscheint, ganz zu abstrahieren, also das konstante Kapital c = 0 zu setzen, und damit ein Gesetz der Mathematik anzuwenden, wo sie mit variablen und konstanten Größen operiert und die konstante Größe nur durch Addition oder Subtraktion mit der variablen verbunden ist.	ch09_clean.en-ch09_clean.de
This is merely an application of a mathematical rule, employed whenever we operate with constant and variable magnitudes, related to each other by the symbols of addition and subtraction only.	Eine andre Schwierigkeit entspringt aus der ursprünglichen Form des variablen Kapitals.	ch09_clean.en-ch09_clean.de
A further difficulty is caused by the original form of the variable capital.	So im obigen Beispiel ist C' = 410 Pfd.St. konstantes Kapital + 90 Pfd.St. variables Kapital + 90 Pfd.St.	ch09_clean.en-ch09_clean.de
In our example, C' = £ const. + £ var. + £ surpl. ; but £ is a given and therefore a constant quantity; hence it appears absurd to treat it as variable.	Mehrwert. Neunzig Pfd.St. sind aber eine gegebne, also konstante Größe, und es scheint daher ungereimt, sie als variable Größe zu behandeln.	ch09_clean.en-ch09_clean.de
But in fact, the term £ var. is here merely a symbol to show that this value undergoes a process.	Aber 90 Pfd.St. oder 90 Pfd.St. variables Kapital ist hier in der Tat nur Symbol für den Prozeß, den dieser Wert durchläuft.	ch09_clean.en-ch09_clean.de
The portion of the capital invested in the purchase of labour-power is a definite quantity of materialised labour, a constant value like the value of the labour-power purchased.	Der im Ankauf der Arbeitskraft vorgeschoßne Kapitalteil ist ein bestimmtes Quantum vergegenständlichter Arbeit, also konstante Wertgröße, wie der Wert der gekauften Arbeitskraft.	ch09_clean.en-ch09_clean.de
But in the process of production the place of the £ is taken by the labour-power in action, dead labour is replaced by living labour, something stagnant by something flowing, a constant by a variable.	Im Produktionsprozeß selbst aber tritt an die Stelle der vorgeschoßnen 90 Pfd.St. die sich betätigende Arbeitskraft, an die Stelle toter, lebendige Arbeit, an die Stelle einer ruhenden eine fließende Größe, an die Stelle einer konstanten eine variable.	ch09_clean.en-ch09_clean.de
The result is the reproduction of v plus an increment of v. From the point of view then of capitalist production, the whole process appears as the spontaneous variation of the originally constant value, which is transformed into labour-power.	Das Resultat ist die Reproduktion von v plus Inkrement von v. Vom Standpunkt der kapitalistischen Produktion ist dieser ganze Verlauf Selbstbewegung des in Arbeitskraft umgesetzten, ursprünglich konstanten Werts.	ch09_clean.en-ch09_clean.de
Both the process and its result, appear to be owing to this value.	Ihm wird der Prozeß und sein Resultat zugut geschrieben.	ch09_clean.en-ch09_clean.de
If, therefore, such expressions as “£ variable capital,” or “so much self-expanding value,” appear contradictory, this is only because they bring to the surface a contradiction immanent in capitalist production.	Erscheint die Formel 90 Pfd.St. variables Kapital oder sich verwertender Wert daher widerspruchsvoll, so drückt sie nur einen der kapitalistischen Produktion immanenten Widerspruch aus.	ch09_clean.en-ch09_clean.de
At first sight it appears a strange proceeding, to equate the constant capital to zero.	Die Gleichsetzung des konstanten Kapitals mit 0 befremdet auf den ersten Blick.	ch09_clean.en-ch09_clean.de
Yet it is what we do every day.	Indes vollzieht man sie beständig im Alltagsleben.	ch09_clean.en-ch09_clean.de
If, for example, we wish to calculate the amount of England’s profits from the cotton industry, we first of all deduct the sums paid for cotton to the United States, India, Egypt and other countries; in other words, the value of the capital that merely re-appears in the value of the product, is put = 0.	Will jemand z.B. Englands Gewinn an der Baumwollindustrie berechnen, so zieht er vor allem den an die Vereinigten Staaten, Indien, Ägypten usw. gezahlten Baumwollpreis ab; d.h., er setzt im Produktenwert nur wiedererscheinenden Kapitalwert = 0.	ch09_clean.en-ch09_clean.de
Of course the ratio of surplus-value not only to that portion of the capital from which it immediately springs, and whose change of value it represents, but also to the sum total of the capital advanced is economically of very great importance.	Allerdings hat das Verhältnis des Mehrwerts nicht nur zum Kapitalteil, woraus er unmittelbar entspringt und dessen Wertverändrung er darstellt, sondern auch zum vorgeschoßnen Gesamtkapital seine große ökonomische Bedeutung.	ch09_clean.en-ch09_clean.de
We shall, therefore, in the third book, treat of this ratio exhaustively.	Wir behandeln dies Verhältnis daher ausführlich im dritten Buch.	ch09_clean.en-ch09_clean.de
In order to enable one portion of a capital to expand its value by being converted into labour-power, it is necessary that another portion be converted into means of production.	Um einen Teil des Kapitals durch seinen Umsatz in Arbeitskraft zu verwerten, muß ein andrer Teil des Kapitals in Produktionsmittel verwandelt werden.	ch09_clean.en-ch09_clean.de
In order that variable capital may perform its function, constant capital must be advanced in proper proportion, a proportion given by the special technical conditions of each labour-process.	Damit das variable Kapital funktioniere, muß konstantes Kapital in entsprechenden Proportionen, je nach dem bestimmten technischen Charakter des Arbeitsprozesses, vorgeschossen werden.	ch09_clean.en-ch09_clean.de
The circumstance, however, that retorts and other vessels, are necessary to a chemical process, does not compel the chemist to notice them in the result of his analysis.	Der Umstand jedoch, daß man zu einem chemischen Prozeß Retorten und andre Gefäße braucht, verhindert nicht, bei der Analyse von der Retorte selbst zu abstrahieren.	ch09_clean.en-ch09_clean.de
If we look at the means of production, in their relation to the creation of value, and to the variation in the quantity of value, apart from anything else, they appear simply as the material in which labour-power, the value-creator, incorporates itself.	Sofern Wertschöpfung und Wertverändrung für sich selbst, d.h. rein betrachtet werden, liefern die Produktionsmittel, diese stofflichen Gestalten des konstanten Kapitals, nur den Stoff, worin sich die flüssige, wertbildende Kraft fixieren soll.	ch09_clean.en-ch09_clean.de
	Die Natur dieses Stoffes ist daher auch gleichgültig, ob Baumwolle oder Eisen.	ch09_clean.en-ch09_clean.de
Neither the nature, nor the value of this material is of any importance.	Auch der Wert dieses Stoffes ist gleichgültig.	ch09_clean.en-ch09_clean.de
The only requisite is that there be a sufficient supply to absorb the labour expended in the process of production.	Er muß nur in hinreichender Masse vorhanden sein, um das während des Produktionsprozesses zu verausgabende Arbeitsquantum einsaugen zu können.	ch09_clean.en-ch09_clean.de
That supply once given, the material may rise or fall in value, or even be, as land and the sea, without any value in itself; but this will have no influence on the creation of value or on the variation in the quantity of value.	Diese Masse gegeben, mag ihr Wert steigen oder fallen, oder sie mag wertlos sein, wie Erde und Meer, der Prozeß der Wertschöpfung und Wertverändrung wird nicht davon berührt.	ch09_clean.en-ch09_clean.de
In the first place then we equate the constant capital to zero.	Wir setzen also zunächst den konstanten Kapitalteil gleich Null.	ch09_clean.en-ch09_clean.de
The capital advanced is consequently reduced from c + v to v, and instead of the value of the product (c + v) + s we have now the value produced (v + s). Given the new value produced = £180, which sum consequently represents the whole labour expended during the process, then subtracting from it £ the value of the variable capital, we have remaining £90, the amount of the surplus-value.	Das vorgeschoßne Kapital reduziert sich daher von c + v auf v, und der Produktenwert c + v + m auf das Wertprodukt v + m. Gegeben das Wertprodukt = 180 Pfd.St., worin sich die während der ganzen Dauer des Produktionsprozesses fließende Arbeit darstellt, so haben wir den Wert des variablen Kapitals = 90 Pfd.St. abzuziehn, um den Mehrwert = 90 Pfd.St. zu erhalten.	ch09_clean.en-ch09_clean.de
This sum of £ or s expresses the absolute quantity of surplus-value produced.	Die Zahl 90 Pfd.St. = m drückt hier die absolute Größe des produzierten Mehrwerts aus.	ch09_clean.en-ch09_clean.de
The relative quantity produced, or the increase per cent of the variable capital, is determined, it is plain, by the ratio of the surplus-value to the variable capital, or is expressed by s/v. In our example this ratio is 90/90, which gives an increase of 100%.	Seine proportionelle Größe aber, also das Verhältnis, worin das variable Kapital sich verwertet hat, ist offenbar bestimmt durch das Verhältnis des Mehrwerts zum variablen Kapital oder ist ausgedrückt in m/v. Im obigen Beispiel also in 90/90 = 100 %.	ch09_clean.en-ch09_clean.de
This relative increase in the value of the variable capital, or the relative magnitude of the surplus-value, I call, “The rate of surplus-value.” 3 We have seen that the labourer, during one portion of the labour-process, produces only the value of his labour-power, that is, the value of his means of subsistence.	Diese verhältnismäßige Verwertung des variablen Kapitals oder die Verhältnismäßige Größe des Mehrwerts nenne ich Rate des Mehrwerts. Wir haben gesehn, daß der Arbeiter während eines Abschnitts des Arbeitsprozesses nur den Wert seiner Arbeitskraft produziert, d.h. den Wert seiner notwendigen Lebensmittel.	ch09_clean.en-ch09_clean.de
Now since his work forms part of a system, based on the social division of labour, he does not directly produce the actual necessaries which he himself consumes; he produces instead a particular commodity, yarn for example, whose value is equal to the value of those necessaries or of the money with which they can be bought.	Da er in einem auf gesellschaftlicher Teilung der Arbeit beruhenden Zustand produziert, produziert er seine Lebensmittel nicht direkt, sondern in Form einer besonderen Ware, des Garns z.B., einen Wert gleich dem Wert seiner Lebensmittel oder dem Geld, womit er sie kauft.	ch09_clean.en-ch09_clean.de
The portion of his day’s labour devoted to this purpose, will be greater or less, in proportion to the value of the necessaries that he daily requires on an average, or, what amounts to the same thing, in proportion to the labour-time required on an average to produce them.	Der Teil seines Arbeitstags, den er hierzu verbraucht, ist größer oder kleiner, je nach dem Wert seiner durchschnittlichen täglichen Lebensmittel, also je nach der zu ihrer Produktion erheischten durchschnittlichen täglichen Arbeitszeit.	ch09_clean.en-ch09_clean.de
If the value of those necessaries represent on an average the expenditure of six hours’ labour, the workman must on an average work for six hours to produce that value.	Wenn der Wert seiner täglichen Lebensmittel im Durchschnitt 6 vergegenständlichte Arbeitsstunden darstellt, so muß der Arbeiter im Durchschnitt täglich 6 Stunden arbeiten, um ihn zu produzieren.	ch09_clean.en-ch09_clean.de
If instead of working for the capitalist, he worked independently on his own account, he would, other things being equal, still be obliged to labour for the same number of hours, in order to produce the value of his labour-power, and thereby to gain the means of subsistence necessary for his conservation or continued reproduction.	Arbeitete er nicht für den Kapitalisten, sondern für sich selbst, unabhängig, so müßte er, unter sonst gleichbleibenden Umständen, nach wie vor im Durchschnitt denselben aliquoten Teil des Tags arbeiten, um den Wert seiner Arbeitskraft zu produzieren, und dadurch die zu seiner eignen Erhaltung oder beständigen Reproduktion nötigen Lebensmittel zu gewinnen.	ch09_clean.en-ch09_clean.de
But as we have seen, during that portion of his day’s labour in which he produces the value of his labour-power, say three shillings, he produces only an equivalent for the value of his labour-power already advanced by the capitalist; the new value created only replaces the variable capital advanced. It is owing to this fact, that the production of the new value of three shillings takes the semblance of a mere reproduction.	Da er in dem Teil des Arbeitstags, worin er den Tageswert der Arbeitskraft, sage 3 sh., produziert, nur ein Äquivalent für ihren vom Kapitalisten bereits gezahlten (28a) Wert produziert, also durch den neu geschaffnen Wert nur den vorgeschoßnen variablen Kapitalwert ersetzt, erscheint diese Produktion von Wert als bloße Reproduktion.	ch09_clean.en-ch09_clean.de
That portion of the working day, then, during which this reproduction takes place, I call “necessary” labour time, and the labour expended during that time I call “necessary” labour.	Den Teil des Arbeitstags also, worin diese Reproduktion vorgeht, nenne ich notwendige Arbeitszeit, die während derselben verausgabte Arbeit notwendige Arbeit.	ch09_clean.en-ch09_clean.de
Necessary, as regards the labourer, because independent of the particular social form of his labour; necessary, as regards capital, and the world of capitalists, because on the continued existence of the labourer depends their existence also.	Notwendig für den Arbeiter, weil unabhängig von der gesellschaftlichen Form seiner Arbeit. Notwendig für das Kapital und seine Welt, weil das beständige Dasein des Arbeiters ihre Basis.	ch09_clean.en-ch09_clean.de
During the second period of the labour-process, that in which his labour is no longer necessary labour, the workman, it is true, labours, expends labour-power; but his labour, being no longer necessary labour, he creates no value for himself.	Die zweite Periode des Arbeitsprozesses, die der Arbeiter über die Grenzen der notwendigen Arbeit hinaus schanzt, kostet ihm zwar Arbeit, Verausgabung von Arbeitskraft, bildet aber keinen Wert für ihn.	ch09_clean.en-ch09_clean.de
He creates surplus-value which, for the capitalist, has all the charms of a creation out of nothing.	Sie bildet Mehrwert, der den Kapitalisten mit allem Reiz einer Schöpfung aus Nichts anlacht.	ch09_clean.en-ch09_clean.de
This portion of the working day, I name surplus labour-time, and to the labour expended during that time, I give the name of surplus labour.	Diesen Teil des Arbeitstags nenne ich Surplusarbeitszeit, und die in ihr verausgabte Arbeit: Mehrarbeit (suplus labour).	ch09_clean.en-ch09_clean.de
It is every bit as important, for a correct understanding of surplus-value, to conceive it as a mere congelation of surplus labour-time, as nothing but materialised surplus labour, as it is, for a proper comprehension of value, to conceive it as a mere congelation of so many hours of labour, as nothing but materialised labour.	So entscheidend es für die Erkenntnis des Werts überhaupt, ihn als bloße Gerinnung von Arbeitszeit, als bloß vergegenständlichte Arbeit, so entscheidend ist es für die Erkenntnis des Mehrwerts, ihn als bloße Gerinnung von Surplusarbeitszeit, als bloß vergegenständlichte Mehrarbeit zu begreifen.	ch09_clean.en-ch09_clean.de
The essential difference between the various economic forms of society, between, for instance, a society based on slave-labour, and one based on wage-labour, lies only in the mode in which this surplus labour is in each case extracted from the actual producer, the labourer.	Nur die Form, worin diese Mehrarbeit dem unmittelbaren Produzenten, dem Arbeiter, abgepreßt wird, unterscheidet die ökonomischen Gesellschaftsformationen, z.B. die Gesellschaft der Sklaverei von der der Lohnarbeit.	ch09_clean.en-ch09_clean.de
Since, on the one hand, the values of the variable capital and of the labour-power purchased by that capital are equal, and the value of this labour-power determines the necessary portion of the working day; and since, on the other hand, the surplus-value is determined by the surplus portion of the working day, it follows that surplus-value bears the same ratio to variable capital, that surplus labour does to necessary labour, or in other words, the rate of surplus-value, s/v = (surplus labour)/(necessary labour).	Da der Wert des variablen Kapitals = Wert der von ihm gekauften Arbeitskraft, da der Wert dieser Arbeitskraft den notwendigen Teil des Arbeitstags bestimmt, der Mehrwert seinerseits aber bestimmt ist durch den überschüssigen Teil des Arbeitstags, so folgt: Der Mehrwert verhält sich zum variablen Kapital, wie die Mehrarbeit zur notwendigen, oder die Rate des Mehrwerts m/v = (Mehrarbeit)/(Notwendige Arbeit).	ch09_clean.en-ch09_clean.de
Both ratios, s/v and (surplus labour)/(necessary labour), express the same thing in different ways; in the one case by reference to materialised, incorporated labour, in the other by reference to living, fluent labour.	Beide Proportionen drücken dasselbe Verhältnis in verschiedner Form aus, das eine Mal in der Form vergegenständlichter, das andre Mal in der Form flüssiger Arbeit.	ch09_clean.en-ch09_clean.de
The rate of surplus-value is therefore an exact expression for the degree of exploitation of labour-power by capital, or of the labourer by the capitalist.	Die Rate des Mehrwerts ist daher der exakte Ausdruck für den Exploitationsgrad der Arbeitskraft durch das Kapital oder des Arbeiters durch den Kapitalisten.	ch09_clean.en-ch09_clean.de
We assumed in our example, that the value of the product = £ const. + £ var. + £ surpl., and that the capital advanced = £500.	(30a) Nach unsrer Annahme war der Wert des Produkts = 410 Pfd.St. + 90 Pfd. St + 90, das vorgeschoßne Kapital = 500 Pfd.St.	ch09_clean.en-ch09_clean.de
Since the surplus-value = £90, and the advanced capital = £500, we should, according to the usual way of reckoning, get as the rate of surplus-value (generally confounded with rate of profits) 18%, a rate so low as possibly to cause a pleasant surprise to Mr. Carey and other harmonisers.	Da der Mehrwert = 90 und das vorgeschoßne Kapital = 500, würde man nach der gewöhnlichen Art der Berechnung herausbekommen, daß die Rate des Mehrwerts (die man mit der Profitrate verwechselt) = 18%, eine Verhältniszahl, deren Niedrigkeit Herrn Carey und andre Harmoniker rühren möchte.	ch09_clean.en-ch09_clean.de
But in truth, the rate of surplus-value is not equal to s/C or s/(c+v), but to s/v: thus it is not 90/ but 90/ or 100%, which is more than five times the apparent degree of exploitation.	In der Tat aber ist die Rate des Mehrwerts nicht = m/C oder m/c + m, sondern = m/v, also nicht 90/500, sondern 90/90 =100%, mehr als das Fünffache des scheinbaren Exploitationsgrads.	ch09_clean.en-ch09_clean.de
Although, in the case we have supposed, we are ignorant of the actual length of the working day, and of the duration in days or weeks of the labour-process, as also of the number of labourers employed, yet the rate of surplus-value s/v accurately discloses to us, by means of its equivalent expression, surplus labour/necessary labour the relation between the two parts of the working day.	Obgleich wir nun im gegebnen Fall die absolute Größe des Arbeitstags nicht kennen, auch nicht die Periode des Arbeitsprozesses (Tag, Woche usw.), endlich nicht die Anzahl der Arbeiter, die das variable Kapital von 90 Pfd.St. gleichzeitig in Bewegung setzt, zeigt uns die Rate des Mehrwerts m/v durch ihre Konvertibilität in (Mehrarbeit)/(Notwendige Arbeit) genau das Verhältnis der zwei Bestandteile des Arbeitstags zueinander.	ch09_clean.en-ch09_clean.de
This relation is here one of equality, the rate being 100%.	Es ist 100%.	ch09_clean.en-ch09_clean.de
Hence, it is plain, the labourer, in our example, works one half of the day for himself, the other half for the capitalist.	Also arbeitete der Arbeiter die eine Hälfte des Tags für sich und die andre für den Kapitalisten.	ch09_clean.en-ch09_clean.de
The method of calculating the rate of surplus-value is therefore, shortly, as follows. We take the total value of the product and put the constant capital which merely re-appears in it, equal to zero.	Die Methode zur Berechnung der Rate des Mehrwerts ist also kurzgefaßt diese: Wir nehmen den ganzen Produktenwert und setzen den darin nur wiedererscheinenden konstanten Kapitalwert gleich Null.	ch09_clean.en-ch09_clean.de
What remains, is the only value that has, in the process of producing the commodity, been actually created.	Die übrig- bleibende Wertsumme ist das einzige im Bildungsprozeß der Ware wirklich erzeugte Wertprodukt.	ch09_clean.en-ch09_clean.de
If the amount of surplus-value be given, we have only to deduct it from this remainder, to find the variable capital.	Ist der Mehrwert gegeben, so ziehn wir ihn von diesem Wertprodukt ab, um das variable Kapital zu finden.	ch09_clean.en-ch09_clean.de
And vice versâ, if the latter be given, and we require to find the surplus-value.	Umgekehrt, wenn letztres gegeben und wir den Mehrwert suchen.	ch09_clean.en-ch09_clean.de
If both be given, we have only to perform the concluding operation, viz., to calculate s/v, the ratio of the surplus-value to the variable capital.	Sind beide gegeben, so ist nur noch die Schlußoperation zu verrichten, das Verhältnis des Mehrwerts zum variablen Kapital, m/v, zu berechnen.	ch09_clean.en-ch09_clean.de
Though the method is so simple, yet it may not be amiss, by means of a few examples, to exercise the reader in the application of the novel principles underlying it.	So einfach die Methode, scheint es doch passend, den Leser in die ihr zu Grunde liegende und ihm ungewohnte Anschauungsweise durch einige Beispiele einzuexerzieren.	ch09_clean.en-ch09_clean.de
First we will take the case of a spinning mill containing 10, mule spindles, spinning No. yarn from American cotton, and producing 1 lb. of yarn weekly per spindle.	Zunächst das Beispiel Spinnerei von 10.000 Mulespindeln, die Nr. 32 Garn aus amerikanischer Baumwolle spinnt und 1 Pfund Garn wöchentlich per Spindel produziert.	ch09_clean.en-ch09_clean.de
We assume the waste to be 6%: under these circumstances 10, lbs. of cotton are consumed weekly, of which 600 lbs. go to waste.	Der Abfall ist 6 %. Also werden 10.600 Pfund Baumwolle wöchentlich in 10.000 Pfund Garn und 600 Pfund Abfall verarbeitet.	ch09_clean.en-ch09_clean.de
The price of the cotton in April, 1871, was 7¾d. per lb. ; the raw material therefore costs in round numbers £342.	Im April 1871 kostet diese Baumwolle 73/4 d. per Pfund, also für 10.600 Pfund rund 342 Pfd.St.	ch09_clean.en-ch09_clean.de
The 10, spindles, including preparation-machinery, and motive power, cost, we will assume, £ per spindle, amounting to a total of £10,000.	Die 10.000 Spindeln, inklusive Vorspinnmaschinerie und Dampfmaschine, kosten 1 Pfd.St. per Spindel, also 10.000 Pfd.St.	ch09_clean.en-ch09_clean.de
The wear and tear we put at 10%, or £1, yearly = £ weekly.	Ihr Verschleiß beträgt 10% = 1.000 Pfd.St. oder wöchentlich 20 Pfd.St.	ch09_clean.en-ch09_clean.de
The rent of the building we suppose to be £ a year, or £ a week.	Die Miete des Fabrikgebäudes ist 300 Pfd.St. oder 6 Pfd.St. per Woche.	ch09_clean.en-ch09_clean.de
Coal consumed (for 100 horse-power indicated, at 4 lbs. of coal per horse-power per hour during 60 hours, and inclusive of that consumed in heating the mill), 11 tons a week at 8s.	Kohlen (4 Pfund per Stunde und Pferdekraft, auf 100 Pferdekraft (Indikator), und 60 Stunden per Woche inklusive Heizung des Gebäudes) 11 tons per Woche, zu 8 sh.	ch09_clean.en-ch09_clean.de
6d. a ton, amounts to about £4½ a week: gas, £ a week, oil, &c., £4½ a week. Total cost of the above auxiliary materials, £ weekly.	6 d. die Tonne, kosten rund 41/2 Pfd.St. per Woche; Gas 1 Pfd.St. per Woche, Öl 41/2 Pfd.St. per Woche, also alle Hilfsstoffe 10 Pfd.St. per Woche.	ch09_clean.en-ch09_clean.de
Therefore the constant portion of the value of the week’s product is £378.	Also ist der konstante Wertteil 378 Pfd.St. per Woche.	ch09_clean.en-ch09_clean.de
Wages amount to £ a week.	Der Arbeitslohn beträgt 52 Pfd.St. per Woche.	ch09_clean.en-ch09_clean.de
The price of the yarn is 12¼d. per. lb. which gives for the value of 10, lbs. the sum of £510. The surplus-value is therefore in this case £ - £ = £80.	Der Garnpreis ist 121/4 d. per Pfund oder 10.000 Pfd. = 510 Pfd.St., der Mehrwert also 510 - 430 = 80 Pfd.St.	ch09_clean.en-ch09_clean.de
We put the constant part of the value of the product = 0, as it plays no part in the creation of value.	Wir setzen den konstanten Wertteil von 378 Pfd.St. = 0, da er in der wöchentlichen Wertbildung nicht mitspielt.	ch09_clean.en-ch09_clean.de
There remains £ as the weekly value created, which = £ var. + £ surpl.	Bleibt das wöchentliche Wertprodukt von 132 = 52 + 80 Pfd.St.	ch09_clean.en-ch09_clean.de
The rate of surplus-value is therefore 80/ = 153 11/13%.	Die Rate des Mehrwerts also = 80/52 = 15311/13%.	ch09_clean.en-ch09_clean.de
In a working day of 10 hours with average labour the result is: necessary labour = 3 31/ hours, and surplus labour = 6 2/33.	Bei zehnstündigem durchschnittlichem Arbeitstag ergibt dies: Notwedige Arbeit = 331/33 Stunden und Mehrarbeit = 62/33 Stunden.	ch09_clean.en-ch09_clean.de
One more example. Jacob gives the following calculation for the year 1815. Owing to the previous adjustment of several items it is very imperfect; nevertheless for our purpose it is sufficient.	Jacob gibt für das Jahr 1815, bei Annahme eines Weizenpreises von 80 sh. per Quarter und eines Durchschnittsertrags von 22 Buschels per acre, so daß der acre 11 Pfd.St. einbringt, folgende durch vorherige Kompensation verschiedner Posten sehr mangelhafte, aber für unsren Zweck genügende Rechnung.	ch09_clean.en-ch09_clean.de
In it he assumes the price of wheat to be 8s. a quarter, and the average yield per acre to be 22 bushels.	Wertproduktion per acre Samen(Weizen) 1 Pfd.St.	ch09_clean.en-ch09_clean.de
VALUE PRODUCED PER ACRE Seed £ 9s.	9 sh.	ch09_clean.en-ch09_clean.de
0d. Tithes, Rates, and taxes, £ 1s.	Zehnten, Rates, Taxes 1 Pfd.St. 1 sh.	ch09_clean.en-ch09_clean.de
0d. Manure £ 10s.	Dünger 2 Pfd.St.	ch09_clean.en-ch09_clean.de
	10 sh.	ch09_clean.en-ch09_clean.de
0d. Rent £ 8s.	Rente 1 Pfd.St.	ch09_clean.en-ch09_clean.de
	8 sh.	ch09_clean.en-ch09_clean.de
0d. Wages £ 10s.	Arbeitslohn 3 Pfd.St.	ch09_clean.en-ch09_clean.de
0d. Farmer’s Profit and Interest £ 2s.	10 sh. Pächters Profit u. Zins 1 Pfd.St. 2 sh.	ch09_clean.en-ch09_clean.de
0d. TOTAL £ 9s.	Summa: 7 Pfd.St.	ch09_clean.en-ch09_clean.de
0d. TOTAL £ 11s 0d.	9 sh. Summa: 3 Pfd.St.	ch09_clean.en-ch09_clean.de
Assuming that the price of the product is the same as its value, we here find the surplus-value distributed under the various heads of profit, interest, rent, &c.	11 sh. Der Mehrwert, stets unter der Voraussetzung, daß Preis des Produkts = seinem Wert, wird hier unter die verschiednen Rubriken, Profit, Zins, Zehnten usw. verteilt.	ch09_clean.en-ch09_clean.de
We have nothing to do with these in detail; we simply add them together, and the sum is a surplus-value of £ 11s.	Diese Rubriken sind uns gleichgültig. Wir addieren sie zusammen und erhalten einen Mehrwert von 3 Pfd.St.	ch09_clean.en-ch09_clean.de
0d. The sum of £ 19s.	11 sh. Die 3 Pfd.St.	ch09_clean.en-ch09_clean.de
0d., paid for seed and manure, is constant capital, and we put it equal to zero.	19 sh. für Samen und Dünger setzen wir als konstanten Kapitalteil gleich Null.	ch09_clean.en-ch09_clean.de
There is left the sum of £ 10s.	Bleibt vorgeschoßnes variables Kapital von 3 Pfd.St.	ch09_clean.en-ch09_clean.de
0d., which is the variable capital advanced: and we see that a new value of £ 10s.	10 sh., an dessen Stelle ein Neuwert von 3 Pfd.St.	ch09_clean.en-ch09_clean.de
0d + £ 11s.	10 sh. + 3 Pfd.St.	ch09_clean.en-ch09_clean.de
0d. has been produced in its place.	11 sh. produziert worden ist.	ch09_clean.en-ch09_clean.de
Therefore s/v = £ 11s.	Also beträgt m/v = (3 Pfd.St.	ch09_clean.en-ch09_clean.de
0d. / £ 10s.	11 sh. )/(3 Pfd.St.	ch09_clean.en-ch09_clean.de
0d., giving a rate of surplus-value of more than 100%.	10 sh. ), mehr als 100%.	ch09_clean.en-ch09_clean.de
The labourer employs more than one half of his working day in producing the surplus-value, which different persons, under different pretexts, share amongst themselves.	Der Arbeiter verwendet mehr als die Hälfte seines Arbeitstags zur Produktion eines Mehrwerts, den verschiedne Personen auf verschiedne Verwände hin unter sich verteilen.	ch09_clean.en-ch09_clean.de
Section 2: The Representation of the Components of the Value of the Product by Corresponding Proportional Parts of the Product Itself Let us now return to the example by which we were shown how the capitalist converts money into capital.	(31a) 2. Darstellung des Produktenwerts in proportionellen Teilen des Produkts Kehren wir nun zum Beispiel zurück, das uns zeigte, wie der Kapitalist aus Geld Kapital macht. Die notwendige Arbeit seines Spinners betrug 6 Stunden, die Mehrarbeit desgleichen, der Exploitationsgrad der Arbeitskraft daher 100%.	ch09_clean.en-ch09_clean.de
The product of a working day of 12 hours is 20 lbs. of yarn, having a value of 30s.	Das Produkt des zwölfstündigen Arbeitstags sind 20 Pfd.	ch09_clean.en-ch09_clean.de
No less than 8/10ths of this value, or 24s., is due to mere re-appearance in it, of the value of the means of production ( lbs. of cotton, value 20s., and spindle worn away, 4s. ): it is therefore constant capital.	Garn zum Wert von 30 sh. Nicht weniger als 8/10 dieses Garnwerts (24 sh.) sind gebildet durch den nur wieder erscheinenden Wert der verzehrten Produktionsmittel (20 Pfd. Baumwolle zu 20 sh., Spindel usw. zu 4 sh.) oder bestehn aus konstantem Kapital.	ch09_clean.en-ch09_clean.de
The remaining 2/10ths or 6s. is the new value created during the spinning process: of this one half replaces the value of the day’s labour-power, or the variable capital, the remaining half constitutes a surplus-value of 3s.	Die übrigen 2/10 sind der während des Spinnprozesses entstandne Neuwert von 6 sh., wovon eine Hälfte den vorgeschoßnen Tageswert der Arbeitskraft ersetzt oder das variable Kapital und die andre Hälfte eine Mehrwert von 3 sh. bildet.	ch09_clean.en-ch09_clean.de
The total value then of the 20 lbs. of yarn is made up as follows: 30s. value of yarn = 24s. const. + 3s. var. + 3s. surpl.	Der Gesamtwert der 20 Pfd. Garn ist also folgendermaßen zusammengesetzt: Garnwert von 30 sh. = 24 sh. + 3 sh. + 3 sh.	ch09_clean.en-ch09_clean.de
Since the whole of this value is contained in the 20 lbs. of yarn produced, it follows that the various component parts of this value, can be represented as being contained respectively in corresponding parts of the product.	Da dieser Gesamtwert sich in dem Gesamtprodukt von 20 Pfd. Garn darstellt, müssen auch die verschiednen Wertelemente in proportionellen Teilen des Produkts darstellbar sein.	ch09_clean.en-ch09_clean.de
If the value of 30s. is contained in 20 lbs. of yarn, then 8/10ths of this value, or the 24s. that form its constant part, is contained in 8/10ths of the product or in 16 lbs. of yarn.	Existiert ein Garnwert von 30 sh. in 20 Pfd. Garn, so 8/10 dieses Werts, oder sein konstanter Teil von 24 sh. in 8/10 des Produkts, oder in 16 Pfd. Garn.	ch09_clean.en-ch09_clean.de
Of the latter 13 1/ lbs. represent the value of the raw material, the 20s. worth of cotton spun, and 2 2/ lbs. represent the 4s. worth of spindle, &c., worn away in the process.	Davon stellen 131/3 Pfd. den Wert des Rohmaterial dar, der versponnenen Baumwolle zu 20 sh. und 22/3 Pfd. den Wert der verzehrten Hilfsstoffe und Arbeitsmittel, Spindel usw. zu 4 sh.	ch09_clean.en-ch09_clean.de
	131/3 Pfund Garn stellen also alle im Gesamtprodukt vom 20 Pfd.	ch09_clean.en-ch09_clean.de
Hence the whole of the cotton used up in spinning the 20 lbs. of yarn, is represented by 13 1/ lbs. of yarn.	Garn versponnene Baumwolle vor, das Rohmaterial des Gesamtprodukts, aber auch weiter nichts.	ch09_clean.en-ch09_clean.de
This latter weight of yarn contains, it is true, by weight, no more than 13 1/ lbs. of cotton, worth 13 1/ shillings; but the 6 2/ shillings additional value contained in it, are the equivalent for the cotton consumed in spinning the remaining 6 2/ lbs. of yarn.	In ihnen stecken zwar nur 131/3 Pfd. Baumwolle zum Wert von 131/3 sh., aber ihr zusätzlicher Wert von 62/3 sh. bildet ein Äquivalent für die in den andren 62/3 Pfd. Garn versponnene Baumwolle.	ch09_clean.en-ch09_clean.de
The effect is the same as if these 6 2/ lbs. of yarn contained no cotton at all, and the whole 20 lbs. of cotton were concentrated in the 13 1/ lbs. of yarn.	Es ist, als ob letztren die Wolle ausgerupft und alle Wolle des Gesamtprodukts in 131/3 Pfd. Garn zusammengestopft wäre.	ch09_clean.en-ch09_clean.de
The latter weight, on the other hand, does not contain an atom either of the value of the auxiliary materials and implements, or of the value newly created in the process.	Sie enthalten dagegen jetzt kein Atom des Werts der verbrauchten Hilfsstoffe und Arbeitsmittel noch des im Spinnprozeß geschaffnen Neuwerts.	ch09_clean.en-ch09_clean.de
In the same way, the 2 2/ lbs. of yarn, in which the 4s., the remainder of the constant capital, is embodied, represents nothing but the value of the auxiliary materials and instruments of labour consumed in producing the 20 lbs. of yarn.	Ebenso stellen weitre 22/3 Pfd. Garn, worin der Rest des konstanten Kapitals (= 4 sh.) steckt, nichts dar außer dem Wert der im Gesamtprodukt von 20 Pfd. Garn vernutzten Hilfsstoffe und Arbeitsmittel.	ch09_clean.en-ch09_clean.de
We have, therefore, arrived at this result: although eight-tenths of the product, or 16 lbs. of yarn, is, in its character of an article of utility, just as much the fabric of the spinner’s labour, as the remainder of the same product, yet when viewed in this connexion, it does not contain, and has not absorbed any labour expended during the process of spinning.	Acht Zehntel des Produkts, oder 16 Pfd. Garn, obgleich leiblich, als Gebrauchswert betrachtet, als Garn, ebensosehr Gebilde der Spinnarbeit wie die restierenden Produktteile, enthalten daher in diesem Zusammenhang keine Spinnarbeit, keine während des Spinnprozesses selbst eingesaugte Arbeit.	ch09_clean.en-ch09_clean.de
It is just as if the cotton had converted itself into yarn, without help; as if the shape it had assumed was mere trickery and deceit: for so soon as our capitalist sells it for 24s., and with the money replaces his means of production, it becomes evident that this 16 lbs. of yarn is nothing more than so much cotton and spindle-waste in disguise.	Es ist, als ob sie sich ohne Spinnen in Garn verwandelt hätten und als wäre ihre Garngestalt reiner Lug und Trug. In der Tat, wenn der Kapitalist sie verkauft zu 24 sh. und damit seine Produktionsmittel zurückkauft, zeigt sich, daß 16 Pfd. Garn - nur verkleidete Baumwolle, Spindel, Kohle usw. sind.	ch09_clean.en-ch09_clean.de
On the other hand, the remaining 2/10ths of the product, or 4 lbs of yarn, represent nothing but the new value of 6s., created during the 12 hours’ spinning process.	Umgekehrt stellen die übrigbleibenden 8/10 des Produkts oder 4 Pfd. Garn jetzt nichts dar außer dem im zwölfstündigen Spinnprozeß produzierten Neuwert von 6 sh.	ch09_clean.en-ch09_clean.de
All the value transferred to those 4 lbs, from the raw material and instruments of labour consumed, was, so to say, intercepted in order to be incorporated in the 16 lbs. first spun.	Was vom Wert der vernutzten Rohmaterialien und Arbeitsmittel in ihnen steckte, ward bereits ausgeweidet und den ersten 16 Pfd. Garn einverleibt. Die in 20 Pfd.	ch09_clean.en-ch09_clean.de
In this case, it is as if the spinner had spun 4 lbs. of yarn out of air, or, as if he had spun them with the aid of cotton and spindles, that, being the spontaneous gift of Nature, transferred no value to the product.	Garn verkörperte Spinnarbeit ist konzentriert auf 2/10 des Produkts. Es ist, als ob der Spinner 4 Pfd.	ch09_clean.en-ch09_clean.de
Of this 4 lbs. of yarn, in which the whole of the value newly created during the process, is condensed, one half represents the equivalent for the value of the labour consumed, or the 3s. variable capital, the other half represents the 3s. surplus-value.	Garn in der Luft gewirkt oder in Baumwolle und mit Spindeln, die ohne Zutat menschlicher Arbeit, von Natur vorhanden, dem Produkt keinen Wert zusetzen. Von den 4 Pfd. Garn, worin so das ganze Wertprodukt des täglichen Spinnprozesses existiert, stellt die eine Hälfte nur den Ersatzwert der vernutzten Arbeitskraft dar, also das variable Kapital von 3 sh., die andren 2 Pfd. Garn nur den Mehrwert von 3 sh.	ch09_clean.en-ch09_clean.de
Since 12 working-hours of the spinner are embodied in 6s., it follows that in yarn of the value of 30s., there must be embodied 60 working-hours.	Da 12 Arbeitsstunden des Spinners sich in 6 sh. vergegenständlichen, sind im Garnwert von 30 sh. 60 Arbeitsstunden vergegenständlicht.	ch09_clean.en-ch09_clean.de
And this quantity of labour-time does in fact exist in the 20 lbs of yarn; for in 8/10ths or 16 lbs there are materialised the 48 hours of labour expended, before the commencement of the spinning process, on the means of production; and in the remaining 2/10ths or 4 lbs there are materialised the 12 hours’ work done during the process itself.	Sie existieren in 20 Pfd. Garn, wovon 8/10 oder 16 Pfd. die Materiatur von 48 vor dem Spinnprozeß vergangnen Arbeitsstunden sind, nämlich der in den Produktionsmitteln des Garns vergegenständlichten Arbeit, 2/10 oder 4 Pfd. dagegen die Materiatur der im Spinnprozeß selbst verausgabten 12 Arbeitsstunden.	ch09_clean.en-ch09_clean.de
On a former page we saw that the value of the yarn is equal to the sum of the new value created during the production of that yarn plus the value previously existing in the means of production.	Früher sahen wir, daß der Garnwert gleich der Summe des in seiner Produktion erzeugten Neuwerts plus der bereits in seinen Produktionsmitteln präexistierenden Werte ist.	ch09_clean.en-ch09_clean.de
It has now been shown how the various component parts of the value of the product, parts that differ functionally from each other, may be represented by corresponding proportional parts of the product itself.	Jetzt hat sich gezeigt, wie die funktionell oder begrifflich verschiednen Bestandteile des Produktenwerts in proportionellen Teilen des Produkts selbst darstellbar sind.	ch09_clean.en-ch09_clean.de
To split up in this manner the product into different parts, of which one represents only the labour previously spent on the means of production, or the constant capital, another, only the necessary labour spent during the process of production, or the variable capital, and another and last part, only the surplus labour expended during the same process, or the surplus-value; to do this, is, as will be seen later on from its application to complicated and hitherto unsolved problems, no less important than it is simple.	Diese Zerfällung des Produkts - des Resultats des Produktionsprozesses - in ein Quantum Produkt, das nur die in den Produktionsmitteln enthaltne Arbeit oder den konstanten Kapitalteil, ein andres Quantum, das nur die im Produktionsprozeß zugesetzte notwendige Arbeit oder den variablen Kapitalteil, und ein letztes Quantum Produkt, das nur die im selben Prozeß zugesetzte Mehrarbeit oder den Mehrwert darstellt, ist ebenso einfach als wichtig, wie ihre spätre Anwendung auf verwickelte und noch ungelöste Probleme zeigen wird.	ch09_clean.en-ch09_clean.de
In the preceding investigation we have treated the total product as the final result, ready for use, of a working day of 12 hours.	Wir betrachteten eben das Gesamtprodukt als fertiges Resultat des zwölfstündigen Arbeitstags.	ch09_clean.en-ch09_clean.de
We can however follow this total product through all the stages of its production; and in this way we shall arrive at the same result as before, if we represent the partial products, given off at the different stages, as functionally different parts of the final or total product.	Wir können es aber auch in seinem Entstehungsprozeß begleiten und dennoch die Teilprodukte als funktionell unterschiedne Produktenteile darstellen.	ch09_clean.en-ch09_clean.de
The spinner produces in 12 hours 20 lbs. of yarn, or in 1 hour 1⅔ lbs; consequently he produces in 8 hours 13⅔ lbs., or a partial product equal in value to all the cotton that is spun in a whole day.	Der Spinner produziert in 12 Stunden 20 Pfd. Garn, daher in einer Stunde 12/3 und in 8 Stunden 131/3 Pfd., also ein Teilprodukt vom Gesamt- wert der Baumwolle, die während des ganzen Arbeitstags versponnen wird.	ch09_clean.en-ch09_clean.de
In like manner the partial product of the next period of 1 hour and 36 minutes, is 2⅔ lbs. of yarn: this represents the value of the instruments of labour that are consumed in 12 hours.	In derselben Art und Weise ist das Teilprodukt der folgenden Stunde und 36 Minuten = 22/3 Pfd.	ch09_clean.en-ch09_clean.de
In the following hour and 12 minutes, the spinner produces 2 lbs. of yarn worth 3 shillings, a value equal to the whole value he creates in his 6 hours’ necessary labour.	Garn und stellt daher den Wert der während der 12 Arbeitsstunden vernutzten Arbeitsmittel dar.	ch09_clean.en-ch09_clean.de
Finally, in the last hour and 12 minutes he produces another 2 lbs. of yarn, whose value is equal to the surplus-value, created by his surplus labour during half a day.	Ebenso produziert der Spinner in der folgenden Stunde und 12 Minuten 2 Pfd.	ch09_clean.en-ch09_clean.de
This method of calculation serves the English manufacturer for every-day use; it shows, he will say, that in the first 8 hours, or ⅔ of the working day, he gets back the value of his cotton; and so on for the remaining hours.	Garn = 3 sh., ein Produktenwert gleich dem ganzen Wertprodukt, das er in 6 Stunden notwendiger Arbeit schafft. Endlich produziert er in den letzten 6/5 Stunden ebenfalls 2 Pfd. Garn, deren Wert gleich dem durch seine halbtägige Mehrarbeit erzeugten Mehrwert.	ch09_clean.en-ch09_clean.de
It is also a perfectly correct method: being in fact the first method given above with this difference, that instead of being applied to space, in which the different parts of the completed product lie side by side, it deals with time, in which those parts are successively produced.	Diese Art Berechnung dient dem englischen Fabrikanten zum Hausgebrauch, und er wird z.B. sagen, daß er in den ersten 8 Stunden oder 2/3 des Arbeitstags seine Baumwolle herausschlägt usw. Man sieht, die Formel ist richtig, in der Tat nur die erste Formel, übersetzt aus dem Raum, wo die Teile des Produkts fertig nebeneinander liegen, in die Zeit, wo sie aufeinander folgen.	ch09_clean.en-ch09_clean.de
But it can also be accompanied by very barbarian notions, more especially in the heads of those who are as much interested, practically, in the process of making value beget value, as they are in misunderstanding that process theoretically.	Die Formel kann aber auch von sehr barbarischen Vorstellungen begleitet sein, namentlich in Köpfen, die ebenso praktisch im Verwertungsprozeß interessiert sind, als sie ein Interesse haben, ihn theoretisch mißzuverstehn.	ch09_clean.en-ch09_clean.de
Such people may get the notion into their heads, that our spinner, for example, produces or replaces in the first 8 hours of his working day the value of the cotton; in the following hour and 36 minutes the value of the instruments of labour worn away; in the next hour and 12 minutes the value of the wages; and that he devotes to the production of surplus-value for the manufacturer, only that well known “last hour.”	So kann sich eingebildet werden, daß unser Spinner z.B. in den ersten 8 Stunden seines Arbeitstags den Wert der Baumwolle, in der folgenden Stunde und 36 Minuten den Wert der verzehrten Arbeitsmittel, in der folgenden Stunde und 12 Minuten den Wert des Arbeitslohns produziert oder ersetzt, und nur die vielberühmte "letzte Stunde" dem Fabrikherrn, der Produktion von Mehrwert widmet.	ch09_clean.en-ch09_clean.de
In this way the poor spinner is made to perform the two-fold miracle not only of producing cotton, spindles, steam-engine, coal, oil, &c., at the same time that he spins with them, but also of turning one working day into five; for, in the example we are considering, the production of the raw material and instruments of labour demands four working days of twelve hours each, and their conversion into yarn requires another such day.	Dem Spinner wird so das doppelte Wunder aufgebürdet, Baumwolle, Spindel, Dampfmaschine, Kohle, Öl usw. in demselben Augenblick zu produzieren, wo er mit ihnen spinnt, und aus einem Arbeitstag von gegebnem Intensitätsgrad fünf solcher Tage zu machen. In unsrem Fall nämlich erfordert die Produktion des Rohmaterials und der Arbeitsmittel 24/6 = 4 zwölfstündige Arbeitstage und ihre Verwandlung in Garn einen andren zwölfstündigen Arbeitstag.	ch09_clean.en-ch09_clean.de
That the love of lucre induces an easy belief in such miracles, and that sycophant doctrinaires are never wanting to prove them, is vouched for by the following incident of historical celebrity.	Daß die Raubgier solche Wunder glaubt und nie den doktrinären Sykophanten mißt, der sie beweist, zeige nun ein Beispiel von historischer Berühmtheit.	ch09_clean.en-ch09_clean.de
Section 3: Senior’s “Last Hour” One fine morning, in the year 1836, Nassau W. Senior, who may be called the bel-esprit of English economists, well known, alike for his economic “science,” and for his beautiful style, was summoned from Oxford to Manchester, to learn in the latter place, the Political Economy that he taught in the former.	3. Seniors "Letzte Stunde" An einem schönen Morgen des Jahres 1836 wurde der wegen seiner ökonomischen Wissenschaft und seines schönen Stils berufene Nassau W. Senior, gewissermaßen der Clauren unter den englischen Ökonomen, von Oxford nach Manchester zitiert, um hier politische Ökonomie zu lernen, statt sie in Oxford zu lehren.	ch09_clean.en-ch09_clean.de
The manufacturers elected him as their champion, not only against the newly passed Factory Act, but against the still more menacing Ten-hours’ agitation.	Die Fabrikanten erkoren ihn zum Preisfechter gegen den neulich erlaßnen Factory Act und die darüber noch hinausstrebende Zehnstundenagitation.	ch09_clean.en-ch09_clean.de
With their usual practical acuteness, they had found out that the learned Professor “wanted a good deal of finishing;” it was this discovery that caused them to write for him.	Mit gewohntem praktischen Scharfsinn hatten sie erkannt, daß der Herr Professor "wanted a good deal of finishing" <"noch tüchtigen Schliff brauchte">. Sie verschrieben ihn daher nach Manchester.	ch09_clean.en-ch09_clean.de
On his side the Professor has embodied the lecture he received from the Manchester manufacturers, in a pamphlet, entitled: “Letters on the Factory Act, as it affects the cotton manufacture.”	Der Herr Professor seinerseits hat die zu Manchester von den Fabrikanten erhaltne Lektion stilisiert in dem Pamphlet: "Letters on the Factory Act, as it affects the cotton manufacture", London 1837.	ch09_clean.en-ch09_clean.de
London, 1837. Here we find, amongst others, the following edifying passage: “Under the present law, no mill in which persons under 18 years of age are employed, ... can be worked more than 11½ hours a day, that is, 12 hours for 5 days in the week, and nine on Saturday.	Hier kann man u.a. folgendes Erbauliche lesen: "Unter dem gegenwärtigen Gesetz kann keine Fabrik, die Personen unter 18 Jahren beschäftigt, länger als 11 1/2 Stunden täglich arbeiten, d.h. 12 Stunden während der ersten 5 Tage und 9 Stunden am Sonnabend.	ch09_clean.en-ch09_clean.de
“Now the following analysis (!) will show that in a mill so worked, the whole net profit is derived from the last hour.	Die folgende Analyse (!) zeigt nun, daß in einer solchen Fabrik der ganze Reingewinn von der letzten Stunde abgeleitet ist.	ch09_clean.en-ch09_clean.de
I will suppose a manufacturer to invest £100,000: – £80, in his mill and machinery, and £20, in raw material and wages.	Ein Fabrikant legt 100.000 Pfd.St. aus - 80.000 Pfd.St. in Fabrikgebäude und Maschinen, 20.000 in Rohmaterial und Arbeitslohn.	ch09_clean.en-ch09_clean.de
The annual return of that mill, supposing the capital to be turned once a year, and gross profits to be 15 per cent., ought to be goods worth £115,000....	Der jährliche Umsatz der Fabrik, vorausgesetzt, das Kapital schlage jährlich einmal um und der Bruttogewinn betrage 15%, muß sich auf Waren zum Wert von 115.000 Pfd.St. belaufen ...	ch09_clean.en-ch09_clean.de
Of this £115,000, each of the twenty-three half-hours of work produces 5-115ths or one twenty-third. Of these 23-23rds (constituting the whole £115,000) twenty, that is to say £100, out of the £115,000, simply replace the capital; – one twenty-third (or £5, out of the £115,000) makes up for the deterioration of the mill and machinery.	Von diesen 115.000 Pfd.St. produziert jede der 23 halben Arbeitsstunden täglich 5/115 oder 1/23. Von diesen 23/23, die das Ganze der 115.000 Pfd.St. bilden (constituting the whole 115.000 Pfd.St. ), ersetzen 20/23, d.h. 100.000 von den 115.000, nur das Kapital; 1/23 oder 5.000 Pfd.St. von den 15.000 Brutto-Gewinn (!) ersetzen die Abnutzung der Fabrik und Maschinerie.	ch09_clean.en-ch09_clean.de
The remaining 2-23rds, that is, the last two of the twenty-three half-hours of every day, produce the net profit of 10 per cent.	Die übrigbleibenden 2/23, d.h. die beiden letzten halben Stunden jedes Tages produzieren den Reingewinn von 10%.	ch09_clean.en-ch09_clean.de
If, therefore (prices remaining the same), the factory could be kept at work thirteen hours instead of eleven and a half, with an addition of about £2, to the circulating capital, the net profit would be more than doubled.	Wenn daher bei gleichbleibenden Preisen die Fabrik 13 Stunden statt 11 1/2 arbeiten dürfte, so würde, mit einer Zulage von ungefähr 2.600 Pfd.St. zum zirkulierenden Kapital, der Reingewinn mehr als verdoppelt werden.	ch09_clean.en-ch09_clean.de
On the other hand, if the hours of working were reduced by one hour per day (prices remaining the same), the net profit would be destroyed – if they were reduced by one hour and a half, even the gross profit would be destroyed.”	Andrerseits, wenn die Arbeitsstunden täglich um 1 Stunde reduziert würden, würde der Reingewinn verschwinden, wenn um 1 1/2 Stunden, auch der Bruttogewinn."	ch09_clean.en-ch09_clean.de
And the Professor calls this an “analysis!”	Und das nennt der Herr Professor eine "Analyse"!	ch09_clean.en-ch09_clean.de
If, giving credence to the out-cries of the manufacturers, he believed that the workmen spend the best part of the day in the production, i.e., the reproduction or replacement of the value of the buildings, machinery, cotton, coal, &c., then his analysis was superfluous.	Glaubte er den Fabrikantenjammer, daß die Arbeiter die beste Zeit des Tags in der Produktion, daher der Reproduktion oder dem Ersatz des Werts von Baulichkeiten, Maschinen, Baumwolle, Kohle usw. vergeuden, so war jede Analyse überflüssig.	ch09_clean.en-ch09_clean.de
His answer would simply have been: – Gentlemen! if you work your mills for 10 hours instead of 11½, then, other things being equal, the daily consumption of cotton, machinery, &c., will decrease in proportion.	Er hatte einfach zu antworten: Meine Herren! Wenn ihr 10 Stunden arbeiten laßt statt 111/2, wird, unter sonst gleichbleibenden Umständen, der tägliche Verzehr von Baumwolle, Maschinerie usw. um 11/2 Stunden abnehmen.	ch09_clean.en-ch09_clean.de
You gain just as much as you lose.	Ihr gewinnt also grade so viel, als ihr verliert.	ch09_clean.en-ch09_clean.de
Your work-people will in future spend one hour and a half less time in reproducing or replacing the capital that has been advanced. – If, on the other hand, he did not believe them without further inquiry, but, as being an expert in such matters, deemed an analysis necessary, then he ought, in a question that is concerned exclusively with the relations of net profit to the length of the working day, before all things to have asked the manufacturers, to be careful not to lump together machinery, workshops, raw material, and labour, but to be good enough to place the constant capital, invested in buildings, machinery, raw material, &c., on one side of the account, and the capital advanced in wages on the other side.	Eure Arbeiter werden in Zukunft 11/2 Stunden weniger für Reproduktion oder Ersatz des vorgeschoßnen Kapitalwerts vergeuden. Glaubte er ihnen nicht aufs Wort, sondern hielt als Sachverständiger eine Analyse für nötig, so mußte er vor allem, in einer Frage, die sich ausschließlich um das Verhältnis des Reingewinns zur Größe des Arbeitstags dreht, die Herren Fabrikanten ersuchen, Maschinerie und Fabrikgebäude, Rohmaterial und Arbeit nicht kunterbunt durcheinanderzuwirren, sondern gefälligst das in Fabrikgebäude, Maschinerie, Rohmaterial usw. enthaltne konstante Kapital auf die eine, das in Arbeitslohn vorgeschoßne Kapital auf die andre Seite zu stellen.	ch09_clean.en-ch09_clean.de
If the Professor then found, that in accordance with the calculation of the manufacturers, the workman reproduced or replaced his wages in 2 half-hours, in that case, he should have continued his analysis thus: According to your figures, the workman in the last hour but one produces his wages, and in the last hour your surplus-value or net profit.	Ergab sich dann etwa, daß nach der Fabrikantenrechnung der Arbeiter in 2/2 Arbeitsstunden, oder in einer Stunde, den Arbeitslohn reproduziert oder ersetzt, so hatte der Analytiker fortzufahren: Nach eurer Angabe produziert der Arbeiter in der vorletzten Stunde seinen Arbeitslohn und in der letzten euren Mehrwert oder den Reingewinn.	ch09_clean.en-ch09_clean.de
Now, since in equal periods he produces equal values, the produce of the last hour but one, must have the same value as that of the last hour.	Da er in gleichen Zeiträumen gleiche Werte produziert, hat das Produkt der vorletzten Stunde denselben Wert wie das der letzten.	ch09_clean.en-ch09_clean.de
Further, it is only while he labours that he produces any value at all, and the amount of his labour is measured by his labour-time.	Er produziert ferner nur Wert, soweit er Arbeit verausgabt, und das Quantum seiner Arbeit ist gemessen durch seine Arbeitszeit.	ch09_clean.en-ch09_clean.de
This you say, amounts to 11½ hours a day.	Diese beträgt nach eurer Angabe 111/2 Stunden per Tag.	ch09_clean.en-ch09_clean.de
He employs one portion of these 11½ hours, in producing or replacing his wages, and the remaining portion in producing your net profit.	Einen Teil dieser 111/2 Stunden verbraucht er zur Produktion oder zum Ersatz seines Arbeitslohns, den andren zur Produktion eures Reingewinns.	ch09_clean.en-ch09_clean.de
Beyond this he does absolutely nothing.	Weiter tut er nichts während des Arbeitstags.	ch09_clean.en-ch09_clean.de
But since, on your assumption, his wages, and the surplus-value he yields, are of equal value, it is clear that he produces his wages in 5¾ hours, and your net profit in the other 5¾ hours.	Da aber, nach Angabe, sein Lohn und der von ihm gelieferte Mehrwert gleich große Werte sind, produziert er offenbar seinen Arbeitslohn in 53/4 Stunden und euren Reingewinn in andren 53/4 Stunden.	ch09_clean.en-ch09_clean.de
Again, since the value of the yarn produced in 2 hours, is equal to the sum of the values of his wages and of your net profit, the measure of the value of this yarn must be 11½ working-hours, of which 5¾ hours measure the value of the yarn produced in the last hour but one, and 5¾, the value of the yarn produced in the last hour.	Da ferner der Wert des zweistündigen Garnprodukts gleich der Wertsumme seines Arbeitslohns plus eures Reingewinns ist, muß dieser Garnwert durch 111/2 Arbeitsstunden gemessen sein, das Produkt der vorletzten Stunde durch 53/4 Arbeitsstunden, das der letzten ditto.	ch09_clean.en-ch09_clean.de
We now come to a ticklish point; therefore, attention!	Wir kommen jetzt zu einem häklichen Punkt.	ch09_clean.en-ch09_clean.de
The last working-hour but one is, like the first, an ordinary working-hour, neither more nor less.	Also aufgepaßt! Die vorletzte Arbeitsstunde ist eine gewöhnliche Arbeitsstunde wie die erste.	ch09_clean.en-ch09_clean.de
How then can the spinner produce in one hour, in the shape of yarn, a value that embodies 5¾ hours’ labour?	Ni plus, ni moins. <Nicht mehr, nicht weniger.> Wie kann der Spinner daher in einer Arbeitsstunde einen Garnwert produzieren, der 53/4 Arbeitsstunden darstellt?	ch09_clean.en-ch09_clean.de
The truth is that he performs no such miracle.	Er verrichtet in der Tat kein solches Wunder.	ch09_clean.en-ch09_clean.de
The use-value produced by him in one hour, is a definite quantity of yarn.	Was er in einer Arbeitsstunde an Gebrauchswert produziert, ist ein bestimmtes Quantum Garn.	ch09_clean.en-ch09_clean.de
The value of this yarn is measured by 5¾ working-hours, of which 4¾ were, without any assistance from him, previously embodied in the means of production, in the cotton, the machinery, and so on; the remaining one hour alone is added by him.	Der Wert dieses Garns ist gemessen durch 53/4 Arbeitsstunden, wovon 43/4 ohne sein Zutun in den stündlich verzehrten Produktionsmitteln stecken, in Baumwolle, Maschinerie usw., 4/4 oder eine Stunde von ihm selbst zugesetzt ist.	ch09_clean.en-ch09_clean.de
Therefore since his wages are produced in 5¾ hours, and the yarn produced in one hour also contains 5¾ hours’ work, there is no witchcraft in the result, that the value created by his 5¾ hours’ spinning, is equal to the value of the product spun in one hour.	Da also sein Arbeitslohn in 53/4 Stunden produziert wird und das Garnprodukt einer Spinnstunde ebenfalls 53/4 Arbeitsstunden enthält, ist es durchaus keine Hexerei, daß das Wertprodukt seiner 53/4 Spinnstunden gleich dem Produktenwert einer Spinnstunde.	ch09_clean.en-ch09_clean.de
You are altogether on the wrong track, if you think that he loses a single moment of his working day, in reproducing or replacing the values of the cotton, the machinery, and so on. On the contrary, it is because his labour converts the cotton and spindles into yarn, because he spins, that the values of the cotton and spindles go over to the yarn of their own accord.	Ihr seid aber durchaus auf dem Holzweg, wenn ihr meint, er verliere ein einziges Zeitatom seines Arbeitstags mit der Reproduktion oder dem "Ersatz" der Werte von Baumwolle, Maschinerie usw. Dadurch, daß seine Arbeit aus Baumwolle und Spindel Garn macht, dadurch, daß er spinnt, geht der Wert von Baumwolle und Spindel von selbst auf das Garn über.	ch09_clean.en-ch09_clean.de
This result is owing to the quality of his labour, not to its quantity.	Es ist dies der Qualität seiner Arbeit geschuldet, nicht ihrer Quantität.	ch09_clean.en-ch09_clean.de
It is true, he will in one hour transfer to the yarn more value, in the shape of cotton, than he will in half an hour; but that is only because in one hour he spins up more cotton than in half an hour. You see then, your assertion, that the workman produces, in the last hour but one, the value of his wages, and in the last hour your net profit, amounts to no more than this, that in the yarn produced by him in 2 working-hours, whether they are the 2 first or the 2 last hours of the working day, in that yarn, there are incorporated 11½ working-hours, or just a whole day’s work, i.e., two hours of his own work and 9½ hours of other people’s.	Allerdings wird er in einer Stunde mehr Baumwollwert usw. auf Garn übertragen als in 1/2 Stunde, aber nur weil er in 1 Stunde mehr Baumwolle verspinnt als in 1/2. Ihr begreift also: Euer Ausdruck, der Arbeiter produziert in der vorletzten Stunde den Wert seines Arbeitslohns und in der letzten den Reingewinn, heißt weiter nichts, als daß in dem Garnprodukt von zwei Stunden seines Arbeitstags, ob sie vorn oder hinten stehen, 111/2 Arbeitsstunden verkörpert sind, grade so viel Stunden, als sein ganzer Arbeitstag zählt.	ch09_clean.en-ch09_clean.de
And my assertion that, in the first 5¾ hours, he produces his wages, and in the last 5¾ hours your net profit, amounts only to this, that you pay him for the former, but not for the latter.	Und der Ausdruck, daß er in den ersten 53/4 Stunden sei- nen Arbeitslohn und in den letzten 53/4 Stunden euren Reingewinn produziert, heißt wieder nichts, als daß ihr die ersten 53/4 Stunden zahlt und die letzten 53/4 Stunden nicht zahlt.	ch09_clean.en-ch09_clean.de
In speaking of payment of labour, instead of payment of labour-power, I only talk your own slang.	Ich spreche von Zahlung der Arbeit, statt der Arbeitskraft, um euren slang zu reden.	ch09_clean.en-ch09_clean.de
Now, gentlemen, if you compare the working-time you pay for, with that which you do not pay for, you will find that they are to one another, as half a day is to half a day; this gives a rate of 100%, and a very pretty percentage it is.	Vergleicht ihr Herren nun das Verhältnis der Arbeitszeit, die ihr zahlt, zur Arbeitszeit, die ihr nicht zahlt, so werdet ihr finden, daß es halber Tag zu halbem Tag ist, also 100%, was allerdings ein artiger Prozentsatz.	ch09_clean.en-ch09_clean.de
Further, there is not the least doubt, that if you make your “hands” toil for 13 hours, instead of 11½, and, as may be expected from you, treat the work done in that extra one hour and a half, as pure surplus labour, then the latter will be increased from 5¾ hours’ labour to 7¼ hours’ labour, and the rate of surplus-value from 100% to 126 2/23%.	Es unterliegt auch nicht dem geringsten Zweifel, daß, wenn ihr eure "Hände" statt 111/2 Stunden 13 abschanzt und, was euch so ähnlich sieht wie ein Ei dem andren, die überschüssigen 11/2 Stunden zur bloßen Mehrarbeit schlagt, letztre von 53/4 Stunden auf 71/4 Stunden wachsen wird, die Rate des Mehrwerts daher von 100% auf 1262/23%.	ch09_clean.en-ch09_clean.de
So that you are altogether too sanguine, in expecting that by such an addition of 1½ hours to the working day, the rate will rise from 100% to 200% and more, in other words that it will be “more than doubled.”	Dagegen seid ihr gar zu tolle Sanguiniker, wenn ihr hofft, sie werde durch den Zusatz von 11/2 Stunden von 100 auf 200% und gar mehr als 200% steigen, d.h. sich "mehr als verdoppeln".	ch09_clean.en-ch09_clean.de
On the other hand ‒ man’s heart is a wonderful thing, especially when carried in the purse – you take too pessimist a view, when you fear, that with a reduction of the hours of labour from 11½ to 10, the whole of your net profit will go to the dogs.	Andrerseits - des Menschen Herz ist ein wunderlich Ding, namentlich wenn der Mensch sein Herz im Beutel trägt - seid ihr gar zu verrückte Pessimisten, wenn ihr fürchtet, mit der Reduktion des Arbeitstags von 111/2 auf 101/2 Stunden werde euer ganzer Reingewinn in die Brüche gehn.	ch09_clean.en-ch09_clean.de
Not at all.	Beileibe nicht.	ch09_clean.en-ch09_clean.de
All other conditions remaining the same, the surplus labour will fall from 5¾ hours to 4¾ hours, a period that still gives a very profitable rate of surplus-value, namely 82 14/23%.	Alle andren Umstände als gleichbleibend vorausgesetzt, wird die Mehrarbeit von 53/4 auf 43/4 Stunden fallen, was immer noch eine ganz erkleckliche Rate des Mehrwerts gibt, nämlich 8214/23%.	ch09_clean.en-ch09_clean.de
But this dreadful “last hour,” about which you have invented more stories than have the millenarians about the day of judgment, is “all bosh.”	Die verhängnisvolle "letzte Stunde" aber, von der ihr mehr gefabelt habt als die Chiliasten vom Weltuntergang, ist "all bosh" <"lauter Unsinn">.	ch09_clean.en-ch09_clean.de
If it goes, it will cost neither you, your net profit, nor the boys and girls whom you employ, their “purity of mind.”	Ihr Verlust wird weder euch den "Reingewinn" noch den von euch verarbeiteten Kindern beiderlei Geschlechts die "Seelenreinheit" kosten.	ch09_clean.en-ch09_clean.de
Whenever your “last hour” strikes in earnest, think of the Oxford Professor.	(32a) Wenn einmal euer "letztes Stündlein" wirklich schlägt, denkt an den Professor von Oxford.	ch09_clean.en-ch09_clean.de
And now, gentlemen, “farewell, and may we meet again in yonder better world, but not before.”	Und nun: In einer beßren Welt wünsch' ich mir mehr von eurem werten Umgang. Addio! ...	ch09_clean.en-ch09_clean.de
Senior invented the battle cry of the “last hour” in 1836. In the London Economist of the 15th April, 1848, the same cry was again raised by James Wilson, an economic mandarin of high standing: this time in opposition to the 10 hours’ bill.	Das Signal der von Senior 1836 entdeckten "letzten Stunde" ward am 15. April 1848, polemisch gegen das Zehnstundengesetz, von James Wilson, einem der ökonomischen Hauptmandarine, im "London Economist" von neuem geblasen.	ch09_clean.en-ch09_clean.de
Section 4: Surplus-Produce The portion of the product that represents the surplus-value, (one tenth of the 20 lbs., or 2 lbs. of yarn, in the example given in Sec.	4. Das Mehrprodukt Den Teil des Produkts (1/10 von 20 Pfd. Garn oder 2 Pfd.	ch09_clean.en-ch09_clean.de
2) we call “surplus-produce.”	Garn in dem Beispiel sub 2), worin sich der Mehrwert darstellt, nennen wir Mehrprodukt (surplus produce, produit net).	ch09_clean.en-ch09_clean.de
Just as the rate of surplus-value is determined by its relation, not to the sum total of the capital, but to its variable part; in like manner, the relative quantity of surplus-produce is determined by the ratio that this produce bears, not to the remaining part of the total product, but to that part of it in which is incorporated the necessary labour.	Wie die Rate des Mehrwerts durch sein Verhältnis nicht zur Gesamtsumme, sondern zum variablen Bestandteil des Kapitals bestimmt wird, so die Höhe des Mehrprodukts durch sein Verhältnis nicht zum Rest des Gesamtprodukts, sondern zum Produktteil, worin sich die notwendige Arbeit darstellt.	ch09_clean.en-ch09_clean.de
Since the production of surplus-value is the chief end and aim of capitalist production, it is clear, that the greatness of a man’s or a nation’s wealth should be measured, not by the absolute quantity produced, but by the relative magnitude of the surplus-produce.	Wie die Produktion von Mehrwert der bestimmende Zweck der kapitalistischen Produktion, so mißt nicht die absolute Größe des Produkts, sondern die relative Größe des Mehrprodukts den Höhegrad des Reichtums.	ch09_clean.en-ch09_clean.de
The sum of the necessary labour and the surplus labour, i.e., of the periods of time during which the workman replaces the value of his labour-power, and produces the surplus-value, this sum constitutes the actual time during which he works, i.e., the working day.	Die Summe der notwendigen Arbeit und der Mehrarbeit, der Zeitabschnitte, worin der Arbeiter den Ersatzwert seiner Arbeitskraft und den Mehrwert produziert, bildet die absolute Größe seiner Arbeitszeit - den Arbeitstag (working day).	ch09_clean.en-ch09_clean.de

