Chapter 11: Rate and Mass of Surplus-Value In this chapter, as hitherto, the value of labour-power, and therefore the part of the working day necessary for the reproduction or maintenance of that labour-power, are supposed to be given, constant magnitudes.	NEUNTES KAPITEL Rate und Masse des Mehrwerts Wie bisher wird in diesem Kapitel der Wert der Arbeitskraft, also der zur Reproduktion oder Erhaltung der Arbeitskraft notwendige Teil des Arbeitstags, als gegebne, konstante Größe unterstellt.	ch11_clean.en-ch11_clean.de
This premised, with the rate, the mass is at the same time given of the surplus-value that the individual labourer furnishes to the capitalist in a definite period of time.	Dies also vorausgesetzt, ist mit der Rate zugleich die Masse des Mehrwerts gegeben, die der einzelne Arbeiter dem Kapitalisten in bestimmter Zeitperiode liefert.	ch11_clean.en-ch11_clean.de
If, e.g., the necessary labour amounts to 6 hours daily, expressed in a quantum of gold = 3 shillings, then 3s. is the daily value of one labour-power or the value of the capital advanced in the buying of one labour-power.	Beträgt z.B. die notwendige Arbeit täglich 6 Stunden, ausgedrückt in einem Goldquantum von 3 sh. = 1 Taler, so ist der Taler der Tageswert einer Arbeitskraft oder der im Ankauf einer Arbeitskraft vorgeschoßne Kapitalwert.	ch11_clean.en-ch11_clean.de
If, further, the rate of surplus-value be = 100%, this variable capital of 3s. produces a mass of surplus-value of 3s., or the labourer supplies daily a mass of surplus labour equal to 6 hours.	Ist ferner die Rate des Mehrwerts 100%, so produziert dies variable Kapital von 1 Taler eine Masse Mehrwert von 1 Taler, oder der Arbeiter liefert täglich eine Masse Mehrarbeit von 6 Stunden.	ch11_clean.en-ch11_clean.de
But the variable capital of a capitalist is the expression in money of the total value of all the labour-powers that he employs simultaneously.	Das variable Kapital ist aber der Geldausdruck für den Gesamtwert aller Arbeitskräfte, die der Kapitalist gleichzeitig verwendet.	ch11_clean.en-ch11_clean.de
Its value is, therefore, equal to the average value of one labour-power, multiplied by the number of labour-powers employed.	Sein Wert ist also gleich dem Durchschnittswert einer Arbeitskraft, multipliziert mit der Anzahl der verwandten Arbeitskräfte.	ch11_clean.en-ch11_clean.de
With a given value of labour-power, therefore, the magnitude of the variable capital varies directly as the number of labourers employed simultaneously.	Bei gegebnem Wert der Arbeitskraft steht also die Größe des variablen Kapitals in direktem Verhältnis zur Anzahl der gleichzeitig beschäftigten Arbeiter.	ch11_clean.en-ch11_clean.de
If the daily value of one labour-power = 3s., then a capital of 300s. must be advanced in order to exploit daily 100 labour-powers, of n times 3s., in order to exploit daily n labour-powers.	Ist der Tageswert einer Arbeitskraft = 1 Taler, so ist also ein Kapital vorzuschießen von 100 Talern, um 100, von n Talern, um n Arbeitskräfte täglich zu exploitieren.	ch11_clean.en-ch11_clean.de
In the same way, if a variable capital of 3s., being the daily value of one labour-power, produce a daily surplus-value of 3s., a variable capital of 300s. will produce a daily surplus-value of 300s., and one of n times 3s. a daily surplus-value of n × 3s. The mass of the surplus-value produced is therefore equal to the surplus-value which the working day of one labourer supplies multiplied by the number of labourers employed.	Ebenso: Produziert ein variables Kapital von 1 Taler, der Tageswert einer Arbeitskraft, einen täglichen Mehrwert von 1 Taler, so ein variables Kapital von 100 Talern einen täglichen Mehrwert von 100, und eins von n Talern einen täglichen Mehrwert von 1 Taler x n. Die Masse des produzierten Mehrwerts ist also gleich dem Mehrwert, den der Arbeitstag des einzelnen Arbeiters liefert, multipliziert mit der Anzahl der angewandten Arbeiter.	ch11_clean.en-ch11_clean.de
But as further the mass of surplus-value which a single labourer produces, the value of labour-power being given, is determined by the rate of the surplus-value, this law follows: the mass of the surplus-value produced is equal to the amount of the variable capital advanced, multiplied by the rate of surplus-value, in other words: it is determined by the compound ratio between the number of labour-powers exploited simultaneously by the same capitalist and the degree of exploitation of each individual labour-power. Let the mass of the surplus-value be S, the surplus-value supplied by the individual labourer in the average day s the variable capital daily advanced in the purchase of one individual labour-power v, the sum total of the variable capital V, the value of an average labour-power P, its degree of exploitation (a'/a) (surplus labour/necessary-labour) and the number of labourers employed n; we would have: S = { (s/v) × V P × (a'/a) × n It is always supposed, not only that the value of an average labour-power is constant, but that the labourers employed by a capitalist are reduced to average labourers.	Da aber ferner die Masse Mehrwert, die der einzelne Arbeiter produziert, bei gegebnem Wert der Arbeitskraft, durch die Rat des Mehrwerts bestimmt ist, so folgt dies erste Gesetz: Die Masse des produzierten Mehr- werts ist gleich der Größe des vorgeschoßnen variablen Kapitals multipliziert mit der Rate des Mehrwerts oder ist bestimmt durch das zusammengesetzte Verhältnis zwischen der Anzahl der von demselben Kapitalisten gleichzeitig exploitierten Arbeitskräfte und dem Exploitationsgrad der einzelnen Arbeitskraft. <In der autorisierten französischen Ausgabe wurde der zweite Teil dieses Satzes wie folgt wiedergegeben: "oder aber sie ist gleich dem Wert einer Arbeitskraft multipliziert mit dem Grad ihrer Exploitation und multipliziert mit der Anzahl der gleichzeitig exploitierten Arbeitskräfte. "> Nennen wir also die Masse des Mehrwerts M, den vom einzelnen Arbeiter im Tagesdurchschnitt gelieferten Mehrwert m, das im Ankauf der einzelnen Arbeitskraft täglich vorgeschoßne variable Kapital v, die Gesamtsumme des variablen Kapitals V, den Wert einer Durchschnitts-Arbeitskraft k, ihren Exploitationsgrad a'/a (Mehrarbeit)/(Notwendige Arbeit) und die Anzahl der angewandten Arbeiter n, so erhalten wir: M= { m/v * V k * a'/a * n. Es wird fortwährend unterstellt, nicht nur daß der Wert einer Durchschnitts-Arbeitskraft konstant ist, sondern daß die von einem Kapitalisten angewandten Arbeiter auf Durchschnitts-Arbeiter reduziert sind.	ch11_clean.en-ch11_clean.de
There are exceptional cases in which the surplus-value produced does not increase in proportion to the number of labourers exploited, but then the value of the labour-power does not remain constant.	Es gibt Ausnahmefälle, wo der produzierte Mehrwert nicht verhältnismäßig zur Anzahl der exploitierten Arbeiter wächst, aber dann bleibt auch der Wert der Arbeitskraft nicht konstant.	ch11_clean.en-ch11_clean.de
In the production of a definite mass of surplus-value, therefore the decrease of one factor may be compensated by the increase of the other.	In der Produktion einer bestimmten Masse Mehrwert kann daher die Abnahme des einen Faktors durch Zunahme des andren ersetzt werden.	ch11_clean.en-ch11_clean.de
If the variable capital diminishes, and at the same time the rate of surplus-value increases in the same ratio, the mass of surplus-value produced remains unaltered.	Wird das variable Kapital vermindert und gleichzeitig in demselben Verhältnis die Rate des Mehrwerts erhöht, so bleibt die Masse des produzierten Mehrwerts unverändert.	ch11_clean.en-ch11_clean.de
If on our earlier assumption the capitalist must advance 300s., in order to exploit 100 labourers a day, and if the rate of surplus-value amounts to 50%, this variable capital of 300s. yields a surplus-value of 150s. or of 100 × 3 working hours.	Muß unter den frühern Annahmen der Kapitalist 100 Taler vorschießen, um 100 Arbeiter täglich zu exploitieren, und beträgt die Rate des Mehrwerts 50%, so wirft dies variable Kapital von 100 einen Mehrwert von 50 Talern ab oder von 100 x 3 Arbeitsstunden.	ch11_clean.en-ch11_clean.de
If the rate of surplus-value doubles, or the working day, instead of being extended from 6 to 9, is extended from 6 to 12 hours and at the same time variable capital is lessened by half, and reduced to 150s., it yields also a surplus-value of 150s. or 50 × 6 working hours.	Wird die Rate des Mehrwerts verdoppelt, oder der Arbeitstag, statt von 6 zu 9, von 6 zu 12 Stunden verlängert, so wirft das um die Hälfte verminderte variable Kapital von 50 Talern ebenfalls einen Mehrwert von 50 Talern ab oder von 50 x 6 Arbeitsstunden.	ch11_clean.en-ch11_clean.de
Diminution of the variable capital may therefore be compensated by a proportionate rise in the degree of exploitation of labour-power, or the decrease in the number of the labourers employed by a proportionate extension of the working day.	Verminderung des variablen Kapitals ist also ausgleichbar durch proportionelle Erhöhung im Exploitationsgrad der Arbeitskraft oder die Abnahme in der Anzahl der beschäftigten Arbeiter durch proportionelle Verlängerung des Arbeitstags.	ch11_clean.en-ch11_clean.de
Within certain limits therefore the supply of labour exploitable by capital is independent of the supply of labourers.	Innerhalb gewisser Grenzen wird die vom Kapital erpreßbare Zufuhr der Arbeit also unabhängig von der Arbeiterzufuhr.	ch11_clean.en-ch11_clean.de
On the contrary, a fall in the rate of surplus-value leaves unaltered the mass of the surplus-value produced, if the amount of the variable capital, or number of the labourers employed, increases in the same proportion.	Umgekehrt läßt Abnahme in der Rate des Mehrwerts die Masse des produzierten Mehrwerts unverändert, wenn propotionell die Größe des variablen Kapitals oder die Anzahl der beschäftigten Arbeiter wächst.	ch11_clean.en-ch11_clean.de
Nevertheless, the compensation of a decrease in the number of labourers employed, or of the amount of variable capital advanced by a rise in the rate of surplus-value, or by the lengthening of the working day, has impassable limits.	Indes hat der Ersatz von Arbeiteranzahl oder Größe des variablen Kapitals durch gesteigerte Rate des Mehrwerts oder Verlängerung des Arbeitstags unüberspringbare Schranken.	ch11_clean.en-ch11_clean.de
Whatever the value of labour-power may be, whether the working time necessary for the maintenance of the labourer is 2 or 10 hours, the total value that a labourer can produce, day in, day out, is always less than the value in which 24 hours of labour are embodied, less than 12s., if 12s. is the money expression for 24 hours of realised labour.	Welches immer der Wert der Arbeitskraft sei, ob daher die zur Erhaltung des Arbeiters notwendige Arbeitszeit 2 oder 10 Stunden betrage, der Gesamtwert, den ein Arbeiter tagaus, tagein produzieren kann, ist immer kleiner als der Wert, worin sich 24 Arbeitsstunden vergegenständlichen, kleiner als 12 sh. oder 4 Taler, wenn dies der Geldausdruck von 24 vergegenständlichten Arbeitsstunden.	ch11_clean.en-ch11_clean.de
In our former assumption, according to which 6 working hours are daily necessary in order to reproduce the labour-power itself or to replace the value of the capital advanced in its purchase, a variable capital of 1,500s., that employs 500 labourers at a rate of surplus-value of 100% with a 12 hours’ working day, produces daily a surplus-value of 1,500s. or of 6 × 500 working hours.	Unter unsrer frühern Annahme, wonach täglich 6 Arbeitsstunden erheischt, um die Arbeitskraft selbst zu reproduzieren oder den in ihrem Ankauf vorgeschoßnen Kapitalwert zu ersetzen, produziert ein variables Kapital von 500 Talern, das 500 Arbeiter zu Mehrwertsrate von 100% oder mit zwölfstündigem Arbeitstag verwendet, täglich einen Mehrwert von 500 Talern oder 6 x 500 Arbeitsstunden.	ch11_clean.en-ch11_clean.de
A capital of 300s. that employs 100 labourers a day with a rate of surplus-value of 200% or with a working day of 18 hours, produces only a mass of surplus-value of 600s. or 12 × 100 working hours; and its total value-product, the equivalent of the variable capital advanced plus the surplus-value, can, day in, day out, never reach the sum of 1,200s. or 24 × 100 working hours.	Ein Kapital von 100 Talern, das 100 Arbeiter täglich verwendet zur Mehrwertsrate von 200% oder mit 18stündigem Arbeitstag, produziert nur eine Mehrwertsmasse von 200 Talern oder 12 x 100 Arbeitsstunden. Und sein gesamtes Wertprodukt, Äquivalent des vorgeschoßnen variablen Kapitals plus Mehrwert, kann tagaus, tagein niemals die Summe von 400 Talern oder 24 x 100 Arbeitsstunden erreichen.	ch11_clean.en-ch11_clean.de
The absolute limit of the average working day – this being by nature always less than 24 hours – sets an absolute limit to the compensation of a reduction of variable capital by a higher rate of surplus-value, or of the decrease of the number of labourers exploited by a higher degree of exploitation of labour-power.	Die absolute Schranke des durchschnittlichen Arbeitstags, der von Natur immer kleiner ist als 24 Stunden, bildet eine absolute Schranke für den Ersatz von vermindertem variablen Kapital durch gesteigerte Rate des Mehrwerts oder von verringerter exploitierten Arbeiteranzahl durch erhöhten Exploitationsgrad der Arbeitskraft.	ch11_clean.en-ch11_clean.de
This palpable law is of importance for the clearing up of many phenomena, arising from a tendency (to be worked out later on) of capital to reduce as much as possible the number of labourers employed by it, or its variable constituent transformed into labour-power, in contradiction to its other tendency to produce the greatest possible mass of surplus-value.	Dies handgreifliche zweite Gesetz ist wichtig zur Erklärung vieler Erscheinungen, entspringend aus der später zu entwickelnden Tendenz des Kapitals, die von ihm beschäftigte Arbeiteranzahl oder seinen variablen in Arbeitskraft umgesetzten Bestandteil soviel als immer möglich zu reduzieren, im Widerspruch zu seiner andren Tendenz, die möglichst große Masse von Mehrwert zu produzieren. Umgekehrt.	ch11_clean.en-ch11_clean.de
On the other hand, if the mass of labour-power employed, or the amount of variable capital, increases, but not in proportion to the fall in the rate of surplus-value, the mass of the surplus-value produced, falls.	Wächst die Masse der verwandten Arbeitskräfte oder die Größe des variablen Kapitals, aber nicht verhältnismäßig zur Abnahme in der Rate des Mehrwerts, so sinkt die Masse des produzierten Mehrwerts.	ch11_clean.en-ch11_clean.de
A third law results from the determination, of the mass of the surplus-value produced, by the two factors: rate of surplus-value and amount of variable capital advanced.	Ein drittes Gesetz ergibt sich aus der Bestimmung der Masse des produzierten Mehrwerts durch die zwei Faktoren, Rate des Mehrwerts und Größe des vorgeschoßnen variablen Kapitals.	ch11_clean.en-ch11_clean.de
The rate of surplus-value, or the degree of exploitation of labour-power, and the value of labour-power, or the amount of necessary working time being given, it is self evident that the greater the variable capital, the greater would be the mass of the value produced and of the surplus-value.	Die Rate des Mehrwerts oder den Exploitationsgrad der Arbeitskraft, und den Wert der Arbeitskraft oder die Größe der notwendigen Arbeitszeit gegeben, ist es selbstverständlich, daß, je größer das variable Kapital, desto größer die Masse des produzierten Werts und Mehrwerts.	ch11_clean.en-ch11_clean.de
If the limit of the working day is given, and also the limit of its necessary constituent, the mass of value and surplus-value that an individual capitalist produces, is clearly exclusively dependent on the mass of labour that he sets in motion.	Ist die Grenze des Arbeitstags gegeben, ebenso die Grenze seines notwendigen Bestandteils, so hängt die Masse von Wert und Mehrwert, die ein einzelner Kapitalist produziert, offenbar ausschließlich ab von der Masse Arbeit, die er in Bewegung setzt.	ch11_clean.en-ch11_clean.de
But this, under the conditions supposed above, depends on the mass of labour-power, or the number of labourers whom he exploits, and this number in its turn is determined by the amount of the variable capital advanced.	Diese aber hängt, unter den gegebnen Annahmen, ab von der Masse Arbeitskraft oder der Arbeiteranzahl, die er exploitiert, und diese Anzahl ihrerseits ist bestimmt durch die Größe des von ihm vorgeschoßnen variablen Kapitals.	ch11_clean.en-ch11_clean.de
With a given rate of surplus-value, and a given value of labour-power, therefore, the masses of surplus-value produced vary directly as the amounts of the variable capitals advanced.	Bei gegebner Rate des Mehrwerts und gegebnem Wert der Arbeitskraft verhalten sich also die Massen des produzierten Mehrwerts direkt wie die Größen der vorgeschoßnen variablen Kapitale.	ch11_clean.en-ch11_clean.de
Now we know that the capitalist divides his capital into two parts.	Nun weiß man aber, daß der Kapitalist sein Kapital in zwei Teile teilt.	ch11_clean.en-ch11_clean.de
One part he lays out in means of production.	Einen Teil legt er aus in Produktionsmitteln.	ch11_clean.en-ch11_clean.de
This is the constant part of his capital.	Dies ist der konstante Teil seines Kapitals.	ch11_clean.en-ch11_clean.de
The other part he lays out in living labour-power.	Den andren Teil setzt er um in lebendige Arbeitskraft.	ch11_clean.en-ch11_clean.de
This part forms his variable capital.	Dieser Teil bildet sein variables Kapital.	ch11_clean.en-ch11_clean.de
On the basis of the same mode of social production, the division of capital into constant and variable differs in different branches of production, and within the same branch of production, too, this relation changes with changes in the technical conditions and in the social combinations of the processes of production.	Auf Basis derselben Produktionsweise findet in verschiednen Produktionszweigen verschiedne Teilung des Kapitals in konstanten und variablen Bestandteil statt.	ch11_clean.en-ch11_clean.de
But in whatever proportion a given capital breaks up into a constant and a variable part, whether the latter is to the former as 1: or 1: or 1:x, the law just laid down is not affected by this.	Innerhalb desselben Produktionszweige wechselt dies Verhältnis mit wechselnder technischer Grundlage und gesellschaftlicher Kombination des Produktionsprozesses.	ch11_clean.en-ch11_clean.de
For, according to our previous analysis, the value of the constant capital reappears in the value of the product, but does not enter into the newly produced value, the newly created value product.	Wie aber ein gegebnes Kapital immer zerfalle in konstanten und variablen Bestandteil, ob der letztre sich zum erstren verhalte wie 1 : 2, 1 : 10 oder 1 : x, das eben aufgestellte Gesetz wird nicht davon berührt, da früherer Analyse gemäß der Wert des konstanten Kapitals im Produktenwert zwar wiedererscheint, aber nicht in das neugebildete Wertprodukt eingeht.	ch11_clean.en-ch11_clean.de
To employ 1, spinners, more raw material, spindles, &c., are, of course, required, than to employ 100.	Um 1.000 Spinner zu verwenden, sind natürlich mehr Rohmaterialen, Spindeln usw. erheischt, als um 100 zu verwenden.	ch11_clean.en-ch11_clean.de
The value of these additional means of production however may rise, fall, remain unaltered, be large or small; it has no influence on the process of creation of surplus-value by means of the labour-powers that put them in motion.	Der Wert dieser zuzusetzenden Produktionsmittel aber mag steigen, fallen, unverändert bleiben, groß oder klein sein, er bleibt ohne irgendeinen Einfluß auf den Verwertungsprozeß der sie bewegenden Arbeitskräfte.	ch11_clean.en-ch11_clean.de
The law demonstrated above now, therefore, takes this form: the masses of value and of surplus-value produced by different capitals – the value of labour-power being given and its degree of exploitation being equal – vary directly as the amounts of the variable constituents of these capitals, i.e., as their constituents transformed into living labour-power.	Das oben konstatierte Gesetz nimmt also die Form an: Die von verschiednen Kapitalen produzierten Massen von Wert und Mehrwert verhalten sich bei gegebnem Wert und gleich großem Exploitationsgrad der Arbeitskraft direkt wie die Größen der variablen Bestandteile dieser Kapitale, d.h. ihrer in lebendige Arbeitskraft umgesetzten Bestandteile.	ch11_clean.en-ch11_clean.de
This law clearly contradicts all experience based on appearance.	Dies Gesetz widerspricht offenbar aller auf den Augenschein gegründeten Erfahrung.	ch11_clean.en-ch11_clean.de
Everyone knows that a cotton spinner, who, reckoning the percentage on the whole of his applied capital, employs much constant and little variable capital, does not, on account of this, pocket less profit or surplus-value than a baker, who relatively sets in motion much variable and little constant capital.	Jedermann weiß, daß ein Baumwollspinner, der, die Prozentteile des angewandten Gesamtkapitals berechnet, relativ viel konstantes und wenig variables Kapital anwendet, deswegen keinen kleinren Gewinn oder Mehrwert erbeutet als ein Bäcker, der relativ viel variables und wenig konstantes Kapital in Bewegung setzt.	ch11_clean.en-ch11_clean.de
For the solution of this apparent contradiction, many intermediate terms are as yet wanted, as from the standpoint of elementary algebra many intermediate terms are wanted to understand that 0/ may represent an actual magnitude.	Zur Lösung dieses scheinbaren Widerspruchs bedarf es noch vieler Mittelglieder, wie es vom Standpunkt der elementaren Algebra vieler Mittelglieder bedarf, um zu verstehn, daß 0/0 eine wirkliche Größe darstellen kann.	ch11_clean.en-ch11_clean.de
Classical economy, although not formulating the law, holds instinctively to it, because it is a necessary consequence of the general law of value.	Obgleich sie das Gesetz nie formuliert hat, hängt die klassische Ökonomie instinktiv daran fest, weil es eine notwendige Konsequenz des Wertgesetzes überhaupt ist.	ch11_clean.en-ch11_clean.de
It tries to rescue the law from collision with contradictory phenomena by a violent abstraction.	Sie sucht es durch gewaltsame Abstraktion vor den Widersprüchen der Erscheinung zu retten.	ch11_clean.en-ch11_clean.de
It will be seen later how the school of Ricardo has come to grief over this stumbling block.	Man wird später sehn, wie die Ricardosche Schule an diesem Stein des Anstoßes gestolpert ist.	ch11_clean.en-ch11_clean.de
Vulgar economy which, indeed, “has really learnt nothing,” here as everywhere sticks to appearances in opposition to the law which regulates and explains them.	Die Vulgärökonomie, die "wirklich auch nichts gelernt hat", pocht hier, wie überall, auf den Schein gegen das Gesetz der Erscheinung.	ch11_clean.en-ch11_clean.de
In opposition to Spinoza, it believes that “ignorance is a sufficient reason.”	Sie glaubt im Gegensatz zu Spinoza, daß "die Unwissenheit ein hinreichender Grund ist".	ch11_clean.en-ch11_clean.de
The labour which is set in motion by the total capital of a society, day in, day out, may be regarded as a single collective working day.	Die Arbeit, die vom Gesamtkapital einer Gesellschaft tagaus, tagein in Bewegung gesetzt wird, kann als ein einziger Arbeitstag betrachtet werden.	ch11_clean.en-ch11_clean.de
If, e.g., the number of labourers is a million, and the average working day of a labourer is 10 hours, the social working day consists of ten million hours.	Ist z.B. die Zahl der Arbeiter eine Million und beträgt der Durchschnittsarbeitstag eines Arbeiters 10 Stunden, so besteht der gesellschaftliche Arbeitstag aus 10 Millionen Stunden.	ch11_clean.en-ch11_clean.de
With a given length of this working day, whether its limits are fixed physically or socially, the mass of surplus-value can only be increased by increasing the number of labourers, i.e., of the labouring population.	Bei gegebner Länge dieses Arbeitstags, seien seine Grenzen physisch oder sozial gezogen, kann die Masse des Mehrwerts nur vermehrt werden durch Vermehrung der Arbeiteranzahl, d.h. der Arbeiterbevölkerung.	ch11_clean.en-ch11_clean.de
The growth of population here forms the mathematical limit to the production of surplus-value by the total social capital.	Das Wachstum der Bevölkrung bildet hier die mathematische Grenze für Produktion des Mehrwerts durch das gesellschaftliche Gesamtkapital. Umgekehrt.	ch11_clean.en-ch11_clean.de
On the contrary, with a given amount of population, this limit is formed by the possible lengthening of the workingday.	Bei gegebner Größe der Bevölkrung wird diese Grenze gebildet durch die mögliche Verlängerung des Arbeitstags.	ch11_clean.en-ch11_clean.de
It will, however, be seen in the following chapter that this law only holds for the form of surplus-value dealt with up to the present.	Man wird im folgenden Kapitel sehn, daß dies Gesetz nur für die bisher behandelte Form des Mehrwerts gilt.	ch11_clean.en-ch11_clean.de
From the treatment of the production of surplus-value, so far, it follows that not every sum of money, or of value, is at pleasure transformable into capital. To effect this transformation, in fact, a certain minimum of money or of exchange-value must be presupposed in the hands of the individual possessor of money or commodities.	Aus der bisherigen Betrachtung der Produktion des Mehrwerts ergibt sich, daß nicht jede beliebige Geld- oder Wertsumme in Kapital verwandelbar, zu dieser Verwandlung vielmehr ein bestimmtes Minimum von Geld oder Tauschwert in der Hand des einzelnen Geld- oder Warenbesitzers vorausgesetzt ist.	ch11_clean.en-ch11_clean.de
The minimum of variable capital is the cost price of a single labour-power, employed the whole year through, day in, day out, for the production of surplus-value.	Das Minimum von variablem Kapital ist der Kostenpreis einer einzelnen Arbeitskraft, die das ganze Jahr durch, tagaus, tagein, zur Gewinnung von Mehrwert vernutzt wird.	ch11_clean.en-ch11_clean.de
If this labourer were in possession of his own means of production, and were satisfied to live as a labourer, he need not work beyond the time necessary for the reproduction of his means of subsistence, say 8 hours a day.	Wäre dieser Arbeiter im Besitz seiner eignen Produktionsmittel und begnügte er sich, als Arbeiter zu leben, so genügte ihm die zur Reproduktion seiner Lebensmittel notwendige Arbeitszeit, sage von 8 Stunden täglich.	ch11_clean.en-ch11_clean.de
He would, besides, only require the means of production sufficient for 8 working hours.	Er brauchte also auch nur Produktionsmittel für 8 Arbeitsstunden.	ch11_clean.en-ch11_clean.de
The capitalist, on the other hand, who makes him do, besides these 8 hours, say 4 hours’ surplus labour, requires an additional sum of money for furnishing the additional means of production.	Der Kapitalist dagegen, der ihn außer diesen 8 Stunden sage 4 Stunden Mehrarbeit verrichten läßt, bedarf einer zusätzlichen Geldsumme zur Beschaffung der zusätzlichen Produktionsmittel.	ch11_clean.en-ch11_clean.de
On our supposition, however, he would have to employ two labourers in order to live, on the surplus-value appropriated daily, as well as, and no better than a labourer, i.e., to be able to satisfy his necessary wants.	Unter unsrer Annahme jedoch müßte er schon zwei Arbeiter anwenden, um von dem täglich angeeigneten Mehrwert wie ein Arbeiter leben, d.h. seine notwendigen Bedürfnisse befriedigen zu können.	ch11_clean.en-ch11_clean.de
In this case the mere maintenance of life would be the end of his production, not the increase of wealth; but this latter is implied in capitalist production.	In diesem Fall wäre bloßer Lebensunterhalt der Zweck seiner Produktion, nicht Vermehrung des Reichtums, und das letztre ist unterstellt bei der kapitalistischen Produktion.	ch11_clean.en-ch11_clean.de
That he may live only twice as well as an ordinary labourer, and besides turn half of the surplus-value produced into capital, he would have to raise, with the number of labourers, the minimum of the capital advanced 8 times.	Damit er nur doppelt so gut lebe wie ein gewöhnlicher Arbeiter und die Hälfte des produzierten Mehrwerts in Kapital zurückverwandle, müßte er zugleich mit der Arbeiterzahl das Minimum des vorgeschoßnen Kapitals um das Achtfache steigern.	ch11_clean.en-ch11_clean.de
Of course he can, like his labourer, take to work himself, participate directly in the process of production, but he is then only a hybrid between capitalist and labourer, a “small master.”	Allerdings kann er selbst, gleich seinem Arbeiter, unmittelbar Hand im Produktionsprozesse anlegen, aber ist dann auch nur ein Mittelding zwischen Kapitalist und Arbeiter, ein "kleiner Meister".	ch11_clean.en-ch11_clean.de
A certain stage of capitalist production necessitates that the capitalist be able to devote the whole of the time during which he functions as a capitalist, i.e., as personified capital, to the appropriation and therefore control of the labour of others, and to the selling of the products of this labour.	Ein gewisser Höhegrad der kapitalistischen Produktion bedingt, daß der Kapitalist die ganze Zeit, während deren er als Kapitalist, d.h. als personifiziertes Kapital funktioniert, zur Aneignung und daher Kontrolle fremder Arbeit und zum Verkauf der Produkte dieser Arbeit verwenden könne.	ch11_clean.en-ch11_clean.de
The guilds of the middle ages therefore tried to prevent by force the transformation of the master of a trade into a capitalist, by limiting the number of labourers that could be employed by one master within a very small maximum.	Die Verwandlung des Handwerksmeisters in den Kapitalisten suchte das Zunftwesen des Mittelalters dadurch gewaltsam zu verhindern, daß es die Arbeiteranzahl, die ein einzelner Meister beschäftigen durfte, auf ein sehr geringes Maximum beschränkte.	ch11_clean.en-ch11_clean.de
The possessor of money or commodities actually turns into a capitalist in such cases only where the minimum sum advanced for production greatly exceeds the maximum of the middle ages.	Der Geld- oder Warenbesitzer verwandelt sich erst wirklich in einen Kapitalisten, wo die für die Produktion vorgeschoßne Minimalsumme weit über dem mittelaltrigen Maximum steht.	ch11_clean.en-ch11_clean.de
Here, as in natural science, is shown the correctness of the law discovered by Hegel (in his “Logic”), that merely quantitative differences beyond a certain point pass into qualitative changes.	Hier, wie in der Naturwissenschaft, bewährt sich die Richtigkeit des von Hegel in seiner "Logik" entdeckten Gesetzes, daß bloß quantitative Verändrungen auf einem gewissen Punkt in qualitative Unterschiede umschlagen.	ch11_clean.en-ch11_clean.de
The minimum of the sum of value that the individual possessor of money or commodities must command, in order to metamorphose himself into a capitalist, changes with the different stages of development of capitalist production, and is at given stages different in different spheres of production, according to their special and technical conditions.	(205a) Das Minimum der Wertsumme, worüber der einzelne Geld- oder Warenbesitzer verfügen muß, um sich in einen Kapitalisten zu entpuppen, wechselt auf verschiednen Entwicklungsstufen der kapitalistischen Produktion und ist, bei gegebner Entwicklungsstufe, verschieden in verschiednen Produktionssphären, je nach ihren besondren technischen Bedingungen.	ch11_clean.en-ch11_clean.de
Certain spheres of production demand, even at the very outset of capitalist production, a minimum of capital that is not as yet found in the hands of single individuals.	Gewisse Produktionssphären erheischen schon in den Anfängen der kapi- talistischen Produktion ein Minimum von Kapital, das sich noch nicht in der Hand einzelner Individuen vorfindet.	ch11_clean.en-ch11_clean.de
This gives rise partly to state subsidies to private persons, as in France in the time of Clobber, and as in many German states up to our own epoch, partly to the formation of societies with legal monopoly for the exploitation of certain branches of industry and commerce, the forerunners of our modern joint stock companies.	Dies veranlaßt teils Staatssubsidien an solche Private, wie in Frankreich zur Zeit Colberts und wie in manchen deutschen Staaten bis in unsre Epoche hinein, teils die Bildung von Gesellschaften mit gesetzlichem Monopol für den Betrieb gewisser Industrie- und Handelszweige - die Vorläufer der modernen Aktiengesellschaften. __________ Wir halten uns nicht beim Detail der Verändrungen auf, die das Verhältnis von Kapitalist und Lohnarbeiter im Verlaufe des Produktionsprozesses erfuhr, also auch nicht bei den weitren Fortbestimmungen des Kapitals selbst. Nur wenige Hauptpunkte seien hier betont.	ch11_clean.en-ch11_clean.de
Within the process of production, as we have seen, capital acquired the command over labour, i.e., over functioning labour-power or the labourer himself.	Innerhalb des Produktionsprozesses entwickelte sich das Kapital zum Kommando über die Arbeit, d.h. über die sich betätigende Arbeitskraft oder den Arbeiter selbst.	ch11_clean.en-ch11_clean.de
Personified capital, the capitalist takes care that the labourer does his work regularly and with the proper degree of intensity.	Das personifizierte Kapital, der Kapitalist, paßt auf, daß der Arbeiter sein Werk ordentlich und mit dem gehörigen Grad von Intensität verrichte.	ch11_clean.en-ch11_clean.de
Capital further developed into a coercive relation, which compels the working class to do more work than the narrow round of its own life-wants prescribes.	Das Kapital entwickelte sich ferner zu einem Zwangsverhältnis, welches die Arbeiterklasse nötigt, mehr Arbeit zu verrichten, als der enge Umkreis ihrer eignen Lebensbedürfnisse vorschrieb.	ch11_clean.en-ch11_clean.de
As a producer of the activity of others, as a pumper-out of surplus labour and exploiter of labour-power, it surpasses in energy, disregard of bounds, recklessness and efficiency, all earlier systems of production based on directly compulsory labour.	Und als Produzent fremder Arbeitsamkeit, als Auspumper von Mehrarbeit und Exploiteur von Arbeitskraft übergipfelt es an Energie, Maßlosigkeit und Wirksamkeit alle frühern auf direkter Zwangsarbeit beruhenden Produktionssysteme.	ch11_clean.en-ch11_clean.de
At first, capital subordinates labour on the basis of the technical conditions in which it historically finds it.	Das Kapital ordnet sich zunächst die Arbeit unter mit den technischen Bedingungen, worin es sie historisch vorfindet.	ch11_clean.en-ch11_clean.de
It does not, therefore, change immediately the mode of production.	Es verändert daher nicht unmittelbar die Produktionsweise.	ch11_clean.en-ch11_clean.de
The production of surplus-value – in the form hitherto considered by us – by means of simple extension of the working day, proved, therefore, to be independent of any change in the mode of production itself.	Die Produktion von Mehrwert in der bisher betrachteten Form, durch einfache Verlängrung des Arbeitstags, erschien daher von jedem Wechsel der Produktionsweise selbst unabhängig.	ch11_clean.en-ch11_clean.de
It was not less active in the old-fashioned bakeries than in the modern cotton factories.	Sie war in der altmodischen Bäckerei nicht minder wirksam als in der modernen Baumwollspinnerei.	ch11_clean.en-ch11_clean.de
If we consider the process of production from the point of view of the simple labour process, the labourer stands in relation to the means of production, not in their quality as capital, but as the mere means and material of his own intelligent productive activity.	Betrachten wir den Produktionsprozeß unter dem Gesichtspunkt des Arbeitsprozesses, so verhielt sich der Arbeiter zu den Produktionsmitteln nicht als Kapital, sondern als bloßem Mittel und Material seiner zweckmäßigen produktiven Tätigkeit.	ch11_clean.en-ch11_clean.de
In tanning, e.g., he deals with the skins as his simple object of labour.	In einer Gerberei z.B. behandelt er die Felle als seinen bloßen Arbeitsgegenstand.	ch11_clean.en-ch11_clean.de
It is not the capitalist whose skin he tans.	Es ist nicht der Kapitalist, dem er das Fell gerbt.	ch11_clean.en-ch11_clean.de
But it is different as soon as we deal with the process of production from the point of view of the process of creation of surplus-value.	Anders, sobald wir den Produktionsprozeß unter dem Gesichtspunkt des Verwertungsprozesses betrachteten.	ch11_clean.en-ch11_clean.de
The means of production are at once changed into means for the absorption of the labour of others.	Die Produktionsmittel verwandelten sich sofort in Mittel zur Einsaugung fremder Arbeit.	ch11_clean.en-ch11_clean.de
It is now no longer the labourer that employs the means of production, but the means of production that employ the labourer.	Es ist nicht mehr der Arbeiter, der die Produktionsmittel anwendet, sondern es sind die Produktionsmittel, die den Arbeiter anwenden.	ch11_clean.en-ch11_clean.de
Instead of being consumed by him as material elements of his productive activity, they consume him as the ferment necessary to their own life-process, and the life-process of capital consists only in its movement as value constantly expanding, constantly multiplying itself.	Statt von ihm als stoffliche Elemente seiner produktiven Tätigkeit verzehrt zu werden, verzehren sie ihn als Ferment ihres eignen Lebensprozesses, und der Lebensprozeß des Kapitals besteht nur in seiner Bewegung als sich selbst verwertender Wert.	ch11_clean.en-ch11_clean.de
Furnaces and workshops that stand idle by night, and absorb no living labour, are “a mere loss” to the capitalist.	Schmelzöfen und Arbeitsgebäude, die des Nachts ruhn und keine lebendige Arbeit einsaugen, sind "reiner Verlust" ("mere loss") für den Kapitalisten.	ch11_clean.en-ch11_clean.de
Hence, furnaces and workshops constitute lawful claims upon the night-labour of the work-people.	Darum konstituieren Schmelzöfen und Arbeitsgebäude einen "Anspruch auf die Nachtarbeit" der Arbeitskräfte.	ch11_clean.en-ch11_clean.de
The simple transformation of money into the material factors of the process of production, into means of production, transforms the latter into a title and a right to the labour and surplus labour of others.	Die bloße Verwandlung des Geldes in gegenständliche Faktoren des Produktionsprozesses, in Produktionsmittel, verwandelt letztre in Rechtstitel und Zwangstitel auf fremde Arbeit und Mehrarbeit.	ch11_clean.en-ch11_clean.de
An example will show, in conclusion, how this sophistication, peculiar to and characteristic of capitalist production, this complete inversion of the relation between dead and living labour, between value and the force that creates value, mirrors itself in the consciousness of capitalists.	Wie diese der kapitalistischen Produktion eigentümliche und sie charakterisierende Verkehrung, ja Verrückung des Verhältnisses von toter und lebendiger Arbeit, von Wert und wertschöpferischer Kraft, sich im Bewußtsein der Kapitalistenköpfe abspiegelt, zeige schließlich noch ein Beispiel.	ch11_clean.en-ch11_clean.de
During the revolt of the English factory lords between 1848 and 1850, “the head of one of the oldest and most respectable houses in the West of Scotland, Messrs. Carlile Sons & Co., of the linen and cotton thread factory at Paisley, a company which has now existed for about a century, which was in operation in 1752, and four generations of the same family have conducted it” ... this “very intelligent gentleman” then wrote a letter in the Glasgow Daily Mail of April 25th, 1849, with the title, “The relay system,” in which among other things the following grotesquely naïve passage occurs: “Let us now ... see what evils will attend the limiting to 10 hours the working of the factory....	Während der englischen Fabrikantenrevolte von 1848-1850 schrieb "der Chef der Leinen- und Baumwollspinnerei zu Paisley, einer der ältesten und respektabelsten Firmen von Westschottland, der Kompagnie Carlile, Söhne und Co., die seit 1752 besteht und Generation nach Generation von derselben Familie geführt wird" - dieser äußerst intelligente Gentleman also schrieb in die "Glasgow Daily Mail" vom 25. April 1849 einen Brief unter dem Titel: "Das Relaissystem", worin u.a. folgende grotesk naive Stelle unterläuft: "Laßt uns nun die Übel betrachten, die aus einer Reduktion der Arbeitszeit von 12 auf 10 Stunden fließen ...	ch11_clean.en-ch11_clean.de
They amount to the most serious damage to the millowner’s prospects and property.	Sie 'belaufen' sich auf die allerernsthafteste Beschädigung der Aussichten und des Eigentums des Fabrikanten.	ch11_clean.en-ch11_clean.de
If he (i.e., his “hands”) worked 12 hours before, and is limited to 10, then every 12 machines or spindles in his establishment shrink to 10, and should the works be disposed of, they will be valued only as 10, so that a sixth part would thus be deducted from the value of every factory in the country.”	Arbeitete er" (d.h. seine "Hände") "12 Stunden und wird er auf 10 beschränkt, dann schrumpfen je 12 Maschinen oder Spindeln seines Etablissements auf 10 zusammen (then every 12 machines or spindles, in his establischment, shrink to 10), und wollte er seine Fabrik verkaufen, so würden sie nur als 10 gewertschätzt werden, so daß so ein sechster Teil vom Wert einer jeden Fabrik im ganzen Lande abgezogen würde."	ch11_clean.en-ch11_clean.de
To this West of Scotland bourgeois brain, inheriting the accumulated capitalistic qualities of “four generations,” the value of the means of production, spindles, &c., is so inseparably mixed up with their property, as capital, to expand their own value, and to swallow up daily a definite quantity of the unpaid labour of others, that the head of the firm of Carlile & Co. actually imagines that if he sells his factory, not only will the value of the spindles be paid to him, but, in addition, their power of annexing surplus-value, not only the labour which is embodied in them, and is necessary to the production of spindles of this kind, but also the surplus labour which they help to pump out daily from the brave Scots of Paisley, and for that very reason he thinks that with the shortening of the working day by 2 hours, the selling-price of 12 spinning machines dwindles to that of 10!	Diesem erbangestammten Kapitalhirn von Westschottland verschwimmt der Wert der Produktionsmittel, Spindeln usw., so sehr mit ihrer Kapitaleigenschaft, sich selbst zu verwerten oder täglich ein bestimmtes Quantum fremder Gratisarbeit einzuschlucken, daß der Chef des Hauses Carlile und Co. in der Tat wähnt, beim Verkauf seiner Fabrik werde ihm nicht nur der Wert der Spindeln gezahlt, sondern obendrein ihre Verwertung, nicht nur die Arbeit, die in ihnen steckt und zur Produktion von Spindeln derselben Art nötig ist, sondern auch die Mehrarbeit, die sie täglich aus den braven Westschotten von Paisley auspumpen helfen, und ebendeshalb, meint er, schrumpfe mit der Verkürzung des Arbeitstags um zwei Stunden der Verkaufspreis von je 12 Spinnmaschinen auf den von je 10 zusammen!	ch11_clean.en-ch11_clean.de

