Chapter 12: The Concept of Relative Surplus-Value That portion of the working day which merely produces an equivalent for the value paid by the capitalist for his labour-power, has, up to this point, been treated by us as a constant magnitude, and such in fact it is, under given conditions of production and at a given stage in the economic development of society.	ZEHNTES KAPITEL Begriff des relativen Mehrwerts Der Teil des Arbeitstags, der bloß ein Äquivalent für den vom Kapital gezahlten Wert der Arbeitskraft produziert, galt uns bisher als konstante Größe, was er in der Tat ist unter gegebnen Produktionsbedingungen, auf einer vorhandnen ökonomischen Entwicklungsstufe der Gesellschaft.	ch12_clean.en-ch12_clean.de
Beyond this, his necessary labour-time, the labourer, we saw, could continue to work for 2, 3, 4, 6, &c., hours.	Über diese seine notwendige Arbeitszeit hinaus konnte der Arbeiter 2, 3, 4, 6 usw. Stunden arbeiten.	ch12_clean.en-ch12_clean.de
The rate of surplus-value and the length of the working day depended on the magnitude of this prolongation.	Von der Größe dieser Verlängrung hingen Rate des Mehrwerts und Größe des Arbeitstags ab.	ch12_clean.en-ch12_clean.de
Though the necessary labour-time was constant, we saw, on the other hand, that the total working day was variable.	War die notwendige Arbeitszeit konstant, so dagegen der Gesamtarbeitstag variabel.	ch12_clean.en-ch12_clean.de
Now suppose we have a working day whose length, and whose apportionment between necessary labour and surplus labour, are given.	Unterstelle jetzt einen Arbeitstag, dessen Größe und dessen Teilung in notwendige Arbeit und Mehrarbeit gegeben sind.	ch12_clean.en-ch12_clean.de
Let the whole line a c, a–b–c represent, for example, a working day of 12 hours; the portion of a b 10 hours of necessary labour, and the portion b c 2 hours of surplus labour.	Die Linie a c, a __________ b __ c, stelle z.B. einen zwölfstündigen Arbeitstag vor, das Stück a b 10 Stunden notwendig Arbeit, das Stück b c 2 Stunden Mehrarbeit.	ch12_clean.en-ch12_clean.de
How now can the production of surplus-value be increased, i.e., how can the surplus labour be prolonged, without, or independently of, any prolongation of a c?	Wie kann nun die Produktion von Mehrwert vergrößert, d.h. die Mehrarbeit verlängert werden, ohne jede weitere Verlängrung oder unabhängig von jeder weiteren Verlängrung von a c?	ch12_clean.en-ch12_clean.de
Although the length of a c is given, b c appears to be capable of prolongation, if not by extension beyond its end c, which is also the end of the working day a c, yet, at all events, by pushing back its starting-point b in the direction of a.	Trotz gegebner Grenzen des Arbeitstags a c scheint b c verlängerbar, wenn nicht durch Ausdehnung über seinen Endpunkt c, der zugleich der Endpunkt des Arbeitstags a c ist, so durch Verschiebung seines Anfangspunkts b in entgegengesetzter Richtung nach a hin.	ch12_clean.en-ch12_clean.de
Assume that b'–b in the line ab'bc is equal to half of b c a–––b'–b––c or to one hour’s labour-time.	Nimm an, b' _ b in a _________ b' _ b __ c sei gleich der Hälfte von b c oder gleich einer Arbeitsstunde.	ch12_clean.en-ch12_clean.de
If now, in a c, the working day of 12 hours, we move the point b to b', b c becomes b' c; the surplus labour increases by one half, from 2 hours to 3 hours, although the working day remains as before at 12 hours.	Wird nun in dem zwölfstündigen Arbeitstag a c der Punkt b nach b' verrückt, so dehnt sich b c aus zu b' c, die Mehrarbeit wächst um die Hälfte, von 2 auf 3 Stunden, obgleich der Arbeitstag nach wie vor nur 12 Stunden zählt.	ch12_clean.en-ch12_clean.de
This extension of the surplus labour-time from b c to b' c, from 2 hours to 3 hours, is, however, evidently impossible, without a simultaneous contraction of the necessary labour-time from a b into a b', from 10 hours to 9 hours.	Diese Ausdehnung der Mehrarbeit von b c auf b' c, von 2 auf 3 Stunden, ist aber offenbar unmöglich ohne gleichzeitige Zusammenziehung der notwendigen Arbeit von a b auf a b', von 10 auf 9 Stunden.	ch12_clean.en-ch12_clean.de
The prolongation of the surplus labour would correspond to a shortening of the necessary labour; or a portion of the labour-time previously consumed, in reality, for the labourer’s own benefit, would be converted into labour-time for the benefit of the capitalist.	Der Verlängrung der Mehrarbeit entspräche die Verkürzung der notwendigen Arbeit, oder ein Teil der Arbeitszeit, die der Arbeiter bisher in der Tat für sich selbst verbraucht, verwandelt sich in Arbeitszeit für den Kapitalisten.	ch12_clean.en-ch12_clean.de
There would be an alteration, not in the length of the working day, but in its division into necessary labour-time and surplus labour-time.	Was verändert, wäre nicht die Länge des Arbeitstags, sondern seine Teilung in notwendige Arbeit und Mehrarbeit.	ch12_clean.en-ch12_clean.de
On the other hand, it is evident that the duration of the surplus labour is given, when the length of the working day, and the value of labour-power, are given.	Andrerseits ist die Größe der Mehrarbeit offenbar selbst gegeben mit gegebner Größe des Arbeitstags und gegebnem Wert der Arbeitskraft.	ch12_clean.en-ch12_clean.de
The value of labour-power, i.e., the labour-time requisite to produce labour-power, determines the labour-time necessary for the reproduction of that value.	Der Wert der Arbeitskraft, d.h. die zu ihrer Produktion erheischte Arbeitszeit, bestimmt die zur Reproduktion ihres Werts notwendige Arbeitszeit.	ch12_clean.en-ch12_clean.de
If one working-hour be embodied in sixpence, and the value of a day’s labour-power be five shillings, the labourer must work 10 hours a day, in order to replace the value paid by capital for his labour-power, or to produce an equivalent for the value of his daily necessary means of subsistence.	Stellt sich eine Arbeitsstunde in einem Goldquantum von einem halben Shilling oder 6 d. dar, und beträgt der Tageswert der Arbeitskraft 5 sh., so muß der Arbeiter täglich 10 Stunden arbeiten, um den ihm vom Kapital gezahlten Tageswert seiner Arbeitskraft zu ersetzen oder ein Äquivalent für den Wert seiner notwendigen täglichen Lebensmittel zu produzieren.	ch12_clean.en-ch12_clean.de
Given the value of these means of subsistence, the value of his labour-power is given; and given the value of his labour-power, the duration of his necessary labour-time is given.	Mit dem Wert dieser Lebensmittel ist der Wert seiner Arbeitskraft , mit dem Wert seiner Arbeitskraft ist die Größe seiner notwendigen Arbeitszeit gegeben.	ch12_clean.en-ch12_clean.de
The duration of the surplus labour, however, is arrived at, by subtracting the necessary labour-time from the total working day.	Die Größe der Mehrarbeit aber wird erhalten durch Subtraktion der notwendigen Arbeitszeit vom Gesamtarbeitstag.	ch12_clean.en-ch12_clean.de
Ten hours subtracted from twelve, leave two, and it is not easy to see, how, under the given conditions, the surplus labour can possibly be prolonged beyond two hours.	Zehn Stunden subtrahiert von zwölf lassen zwei, und es ist nicht abzusehn, wie die Mehrarbeit unter den gegebnen Bedingungen über zwei Stunden hinaus verlängert werden kann.	ch12_clean.en-ch12_clean.de
No doubt, the capitalist can, instead of five shillings, pay the labourer four shillings and sixpence or even less.	Allerdings mag der Kapitalist statt 5 sh. dem Arbeiter nur 4 sh. 6 d. oder noch weniger zahlen.	ch12_clean.en-ch12_clean.de
For the reproduction of this value of four shillings and sixpence, nine hours’ labour-time would suffice; and consequently three hours of surplus labour, instead of two, would accrue to the capitalist, and the surplus-value would rise from one shilling to eighteen-pence.	Zur Reproduktion dieses Werts von 4 sh. 6 d. würden 9 Arbeitsstunden genügen, von dem zwölfstündigen Arbeitstag daher 3 statt 2 Stunden der Mehrarbeit anheimfallen und der Mehrwert selbst von 1 sh. auf 1 sh. 6 d. steigen.	ch12_clean.en-ch12_clean.de
This result, however, would be obtained only by lowering the wages of the labourer below the value of his labour-power.	Dies Resultat wäre jedoch nur erzielt durch Herabdrückung des Lohns des Arbeiters unter den Wert seiner Arbeitskraft.	ch12_clean.en-ch12_clean.de
With the four shillings and sixpence which he produces in nine hours, he commands one-tenth less of the necessaries of life than before, and consequently the proper reproduction of his labour-power is crippled.	Mit den 4 sh. 6 d., die er in 9 Stunden produziert, verfügt er über 1/10 weniger Lebensmittel als vorher, und so findet nur eine verkümmerte Reproduktion seiner Arbeitskraft statt.	ch12_clean.en-ch12_clean.de
The surplus labour would in this case be prolonged only by an overstepping of its normal limits; its domain would be extended only by a usurpation of part of the domain of necessary labour-time.	Die Mehrarbeit würde hier nur verlängert durch Überschreitung ihrer normalen Grenzen, ihre Domäne nur ausgedehnt durch usurpatorischen Abbruch von der Domäne der notwendigen Arbeitszeit.	ch12_clean.en-ch12_clean.de
Despite the important part which this method plays in actual practice, we are excluded from considering it in this place, by our assumption, that all commodities, including labour-power, are bought and sold at their full value.	Trotz der wichtigen Rolle, welche diese Methode in der wirklichen Bewegung des Arbeitslohnes spielt, ist sie hier ausgeschlossen durch die Voraussetzung, daß die Waren, also auch die Arbeitskraft, zu ihrem vollen Wert gekauft und verkauft werden.	ch12_clean.en-ch12_clean.de
Granted this, it follows that the labour-time necessary for the production of labour-power, or for the reproduction of its value, cannot be lessened by a fall in the labourer’s wages below the value of his labour-power, but only by a fall in this value itself.	Dies einmal unterstellt, kann die zur Produktion der Arbeitskraft oder zur Reproduktion ihres Werts notwendige Arbeitszeit nicht abnehmen, weil der Lohn des Arbeiters unter den Wert seiner Arbeitskraft, sondern nur wenn dieser Wert selbst sinkt.	ch12_clean.en-ch12_clean.de
Given the length of the working day, the prolongation of the surplus labour must of necessity originate in the curtailment of the necessary labour-time; the latter cannot arise from the former.	Bei gegebner Länge des Arbeitstags des Arbeitstags muß die Verlängrung der Mehrarbeit aus der Verkürzung der notwendigen Arbeitszeit entspringen, nicht umgekehrt die Verkürzung der notwendigen Arbeitszeit aus der Verlängrung der Mehrarbeit.	ch12_clean.en-ch12_clean.de
In the example we have taken, it is necessary that the value of labour-power should actually fall by one-tenth, in order that the necessary labour-time may be diminished by one-tenth, i.e., from ten hours to nine, and in order that the surplus labour may consequently be prolonged from two hours to three.	In unsrem Beispiel muß der Wert der Arbeitskraft wirklich um 1/10 sinken, damit die notwendige Arbeitszeit um 1/10 abnehme, von 10 auf 9 Stunden, und daher die Mehrarbeit sich von 2 auf 3 Stunden verlängre.	ch12_clean.en-ch12_clean.de
Such a fall in the value of labour-power implies, however, that the same necessaries of life which were formerly produced in ten hours, can now be produced in nine hours.	Eine solche Senkung des Werts der Arbeitskraft um 1/10 bedingt aber ihrerseits, daß dieselbe Masse Lebensmittel, die früher in 10, jetzt in 9 Stunden produziert wird.	ch12_clean.en-ch12_clean.de
But this is impossible without an increase in the productiveness of labour.	Dies ist jedoch unmöglich ohne eine Erhöhung der Produktivkraft der Arbeit.	ch12_clean.en-ch12_clean.de
For example, suppose a shoe-maker, with given tools, makes in one working day of twelve hours, one pair of boots.	Mit gegebnen Mitteln kann ein Schuster z.B. ein Paar Stiefel in einem Arbeitstag von 12 Stunden machen.	ch12_clean.en-ch12_clean.de
If he must make two pairs in the same time, the productiveness of his labour must be doubled; and this cannot be done, except by an alteration in his tools or in his mode of working, or in both.	Soll er in derselben Zeit zwei Paar Stiefel machen, so muß sich die Produktivkraft seiner Arbeit verdoppeln, und sie kann sich nicht verdoppeln ohne eine Änderung in seinen Arbeitsmitteln oder seiner Arbeitsmethode oder beiden zugleich.	ch12_clean.en-ch12_clean.de
Hence, the conditions of production, i.e., his mode of production, and the labour-process itself, must be revolutionised.	Es muß daher eine Revolution in den Produktionsbedingungen seiner Arbeit eintreten, d.h. in seiner Produktionsweise und daher im Arbeitsprozeß selbst.	ch12_clean.en-ch12_clean.de
By increase in the productiveness of labour, we mean, generally, an alteration in the labour-process, of such a kind as to shorten the labour-time socially necessary for the production of a commodity, and to endow a given quantity of labour with the power of producing a greater quantity of use-value.	Unter Erhöhung der Produktivkraft der Arbeit verstehn wir hier überhaupt eine Verändrung im Arbeitsprozeß, wodurch die zur Produktion einer Ware gesellschaftlich erheischte Arbeitszeit verkürzt wird, ein kleinres Quantum Arbeit also die Kraft erwirbt, ein größres Quantum Gebrauchswert zu produzieren.	ch12_clean.en-ch12_clean.de
Hitherto in treating of surplus-value, arising from a simple prolongation of the working day, we have assumed the mode of production to be given and invariable. But when surplus-value has to be produced by the conversion of necessary labour into surplus labour, it by no means suffices for capital to take over the labour-process in the form under which it has been historically handed down, and then simply to prolong the duration of that process.	Während also bei der Produktion des Mehrwerts in der bisher betrachteten Form die Produktionsweise als gegeben unterstellt war, genügt es für die Produktion von Mehrwert durch Verwandlung not- wendiger Arbeit in Mehrarbeit keineswegs, daß das Kapital sich des Arbeitsprozesses in seiner historisch überlieferten oder vorhandnen Gestalt bemächtigt und nur seine Dauer verlängert.	ch12_clean.en-ch12_clean.de
The technical and social conditions of the process, and consequently the very mode of production must be revolutionised, before the productiveness of labour can be increased. By that means alone can the value of labour-power be made to sink, and the portion of the working day necessary for the reproduction of that value, be shortened.	Es muß die technischen und gesellschaftlichen Bedingungen des Arbeitsprozesses, also die Produktionsweise selbst umwälzen, um die Produktivkraft der Arbeit zu erhöhn, durch die Erhöhung der Produktivkraft der Arbeit den Wert der Arbeitskraft zu senken und so den zur Reproduktion dieses Werts notwendigen Teil des Arbeitstags zu verkürzen.	ch12_clean.en-ch12_clean.de
The surplus-value produced by prolongation of the working day, I call absolute surplus-value. On the other hand, the surplus-value arising from the curtailment of the necessary labour-time, and from the corresponding alteration in the respective lengths of the two components of the working day, I call relative surplus-value.	Durch Verlängrung des Arbeitstags produzierten Mehrwert nenne ich absoluten Mehrwert; den Mehrwert dagegen, der aus Verkürzung der notwendigen Arbeitszeit und entsprechender Verändrung im Größenverhältnis der beiden Bestandteile des Arbeitstags entspringt - relativen Mehrwert.	ch12_clean.en-ch12_clean.de
In order to effect a fall in the value of labour-power, the increase in the productiveness of labour must seize upon those branches of industry whose products determine the value of labour-power, and consequently either belong to the class of customary means of subsistence, or are capable of supplying the place of those means.	Um den Wert der Arbeitskraft zu senken, muß die Steigerung der Produktivkraft Industriezweige ergreifen, deren Produkte den Wert der Arbeitskraft bestimmen, also entweder dem Umkreis der gewohnheitsmäßigen Lebensmittel angehören oder sie ersetzen können.	ch12_clean.en-ch12_clean.de
But the value of a commodity is determined, not only by the quantity of labour which the labourer directly bestows upon that commodity, but also by the labour contained in the means of production.	Der Wert einer Ware ist aber nicht nur bestimmt durch das Quantum der Arbeit, welche ihr die letzte Form gibt, sondern ebensowohl durch die in ihren Produktionsmitteln enthaltne Arbeitsmasse.	ch12_clean.en-ch12_clean.de
For instance, the value of a pair of boots depends not only on the cobbler’s labour, but also on the value of the leather, wax, thread, &c. Hence, a fall in the value of labour-power is also brought about by an increase in the productiveness of labour, and by a corresponding cheapening of commodities in those industries which supply the instruments of labour and the raw material, that form the material elements of the constant capital required for producing the necessaries of life.	Z.B. der Wert eines Stiefels nicht nur durch die Schusterarbeit, sondern auch durch den Wert von Leder, Pech, Draht usw. Steigerung der Produktivkraft und entsprechende Verwohlfeilerung der Waren in den Industrien, welche die stofflichen Elemente des konstanten Kapitals, die Arbeitsmittel und das Arbeitsmaterial, zur Erzeugung der notwendigen Lebensmittel liefern, senken also ebenfalls den Wert der Arbeitskraft.	ch12_clean.en-ch12_clean.de
But an increase in the productiveness of labour in those branches of industry which supply neither the necessaries of life, nor the means of production for such necessaries, leaves the value of labour-power undisturbed.	In Produktionszweigen dagegen, die weder notwendige Lebensmittel liefern noch Produktionsmittel zu ihrer Herstellung, läßt die erhöhte Produktivkraft den Wert der Arbeitskraft unberührt.	ch12_clean.en-ch12_clean.de
The cheapened commodity, of course, causes only a pro tanto fall in the value of labour-power, a fall proportional to the extent of that commodity’s employment in the reproduction of labour-power.	Die verwohlfeilerte Ware senkt natürlich den Wert der Arbeitskraft nur pro tanto, d.h. nur im Verhältnis, worin sie in die Reproduktion der Arbeitskraft eingeht.	ch12_clean.en-ch12_clean.de
Shirts, for instance, are a necessary means of subsistence, but are only one out of many.	Hemden z.B. sind ein notwendiges Lebensmittel, aber nur eins von vielen.	ch12_clean.en-ch12_clean.de
	Ihre Verwohlfeilerung vermindert bloß die Ausgabe des Arbeiters für Hemden.	ch12_clean.en-ch12_clean.de
The totality of the necessaries of life consists, however, of various commodities, each the product of a distinct industry; and the value of each of those commodities enters as a component part into the value of labour-power.	Die Gesamtsumme der notwendigen Lebensmittel besteht jedoch nur aus verschiednen Waren, lauter Produkten besondrer Industrien, und der Wert jeder solchen Ware bildet stets einen aliquoten Teil vom Wert der Arbeitskraft.	ch12_clean.en-ch12_clean.de
This latter value decreases with the decrease of the labour-time necessary for its reproduction; the total decrease being the sum of all the different curtailments of labour-time effected in those various and distinct industries.	Dieser Wert nimmt ab mit der zu seiner Reproduktion notwendigen Arbeitszeit, deren Gesamtverkürzung gleich der Summe ihrer Verkürzungen in allen jenen besondren Produktionszweigen ist.	ch12_clean.en-ch12_clean.de
This general result is treated, here, as if it were the immediate result directly aimed at in each individual case.	Wir behandeln dies allgemeine Resultat hier so, als wäre es unmittelbares Resultat und unmittelbarer Zweck in jedem einzelnen Fall.	ch12_clean.en-ch12_clean.de
Whenever an individual capitalist cheapens shirts, for instance, by increasing the productiveness of labour he by no means necessarily aims at reducing the value of labour-power and shortening, pro tanto the necessary labour-time. But it is only in so far as he ultimately contributes to this result, that he assists in raising the general rate of surplus-value.	Wenn ein einzelner Kapitalist durch Steigerung der Produktivkraft der Arbeit z.B. Hemden verwohlfeilert, schwebt ihm keineswegs notwendig der Zweck vor, den Wert der Arbeitskraft und daher die notwendige Arbeitszeit pro tanto zu senken, aber nur soweit er schließlich zu diesem Resultat beiträgt, trägt er bei zur Erhöhung der allgemeinen Rate des Mehrwerts.	ch12_clean.en-ch12_clean.de
The general and necessary tendencies of capital must be distinguished from their forms of manifestation.	Die allgemeinen und notwendigen Tendenzen des Kapitals sind zu unterscheiden von ihren Erscheinungsformen.	ch12_clean.en-ch12_clean.de
It is not our intention to consider, here, the way in which the laws, immanent in capitalist production, manifest themselves in the movements of individual masses of capital, where they assert themselves as coercive laws of competition, and are brought home to the mind and consciousness of the individual capitalist as the directing motives of his operations. But this much is clear; a scientific analysis of competition is not possible, before we have a conception of the inner nature of capital, just as the apparent motions of the heavenly bodies are not intelligible to any but him, who is acquainted with their real motions, motions which are not directly perceptible by the senses.	Die Art und Weise, wie die immanenten Gesetze der kapitalistischen Produktion in der äußern Bewegung der Kapitale erscheinen, sich als Zwangsgesetze der Konkurrenz geltend machen und daher als treibende Motive dem individuellen Kapitalisten zum Bewußtsein kommen, ist jetzt nicht zu betrachten, aber soviel erhellt von vornherein: Wissenschaftliche Analyse der Konkurrenz ist nur möglich, sobald die innere Natur des Kapitals begriffen ist, ganz wie die scheinbare Bewegung der Himmelskörper nur dem verständlich, der ihre wirkliche, aber sinnlich nicht wahrnehmbare Bewegung kennt.	ch12_clean.en-ch12_clean.de
Nevertheless, for the better comprehension of the production of relative surplus-value, we may add the following remarks, in which we assume nothing more than the results we have already obtained.	Dennoch ist zum Verständnis der Produktion des relativen Mehrwerts und bloß auf Grundlage der bereits gewonnenen Resultate folgendes zu bemerken.	ch12_clean.en-ch12_clean.de
If one hour’s labour is embodied in sixpence, a value of six shillings will be produced in a working day of 12 hours.	Stellt sich eine Arbeitsstunde in einem Goldquantum von 6 d. oder 1/2 sh. dar, so wird in zwölfstündigem Arbeitstag ein Wert von 6 sh. produziert.	ch12_clean.en-ch12_clean.de
Suppose, that with the prevailing productiveness of labour, 12 articles are produced in these 12 hours.	Gesetzt, mit der gegebnen Produktivkraft der Arbeit würden 12 Stück Waren in diesen 12 Arbeitsstunden verfertigt.	ch12_clean.en-ch12_clean.de
Let the value of the means of production used up in each article be sixpence. Under these circumstances, each article costs one shilling: sixpence for the value of the means of production, and sixpence for the value newly added in working with those means.	Der Wert der in jedem Stück vernutzten Produktionsmittel, Rohmaterial usw. sei 6 d. Unter diesen Umständen kostet die einzelne Ware 1 sh., nämlich 6 d. für den Wert der Produktionsmittel, 6 d. für den in ihrer Verarbeitung neu zugesetzten Wert.	ch12_clean.en-ch12_clean.de
Now let some one capitalist contrive to double the productiveness of labour, and to produce in the working day of 12 hours, 24 instead of 12 such articles.	Es gelinge nun einem Kapitalisten, die Produktivkraft der Arbeit zu verdoppeln und daher 24 statt 12 Stück dieser Warenart in dem zwölfstündigen Arbeitstag zu produzieren.	ch12_clean.en-ch12_clean.de
The value of the means of production remaining the same, the value of each article will fall to ninepence, made up of sixpence for the value of the means of production and threepence for the value newly added by the labour.	Bei unverändertem Wert der Produktionsmittel sinkt der Wert der einzelnen Ware jetzt auf 9 d., nämlich 6 d. für den Wert der Produktionsmittel, 3 d. für den durch die letzte Arbeit neu zugesetzten Wert.	ch12_clean.en-ch12_clean.de
Despite the doubled productiveness of labour, the day’s labour creates, as before, a new value of six shillings and no more, which, however, is now spread over twice as many articles.	Trotz der verdoppelten Produktivkraft schafft der Arbeitstag nach wie vor nur einen Neuwert von 6 sh., welcher sich jedoch jetzt auf doppelt soviel Produkte verteilt.	ch12_clean.en-ch12_clean.de
Of this value each article now has embodied in it 1/24th, instead of 1/12th, threepence instead of sixpence; or, what amounts to the same thing, only half an hour’s instead of a whole hour’s labour-time, is now added to the means of production while they are being transformed into each article.	Auf jedes einzelne Produkt fällt daher nur noch 1/24 statt 1/12 dieses Gesamtwerts, 3 d. statt 6 d. oder, was dasselbe ist, den Produktionsmitteln wird bei ihrer Verwandlung in Produkt, jedes Stück berechnet, jetzt nur noch eine halbe statt wie früher eine ganze Arbeitsstunde zugesetzt.	ch12_clean.en-ch12_clean.de
The individual value of these articles is now below their social value; in other words, they have cost less labour-time than the great bulk of the same article produced under the average social conditions.	Der individuelle Wert dieser Ware steht nun unter ihrem gesellschaftlichen Wert, d.h., sie kostet weniger Arbeitszeit als der große Haufen derselben Artikel, produziert unter den gesellschaftlichen Durchschnittsbedingungen.	ch12_clean.en-ch12_clean.de
Each article costs, on an average, one shilling, and represents 2 hours of social labour; but under the altered mode of production it costs only ninepence, or contains only 1½ hours’ labour.	Das Stück kostet im Durchschnitt 1 sh. oder stellt 2 Stunden gesellschaftlicher Arbeit dar; mit der veränderten Produktionsweise kostet es nur 9 d. oder enthält nur 11/2 Arbeitsstunden.	ch12_clean.en-ch12_clean.de
The real value of a commodity is, however, not its individual value, but its social value; that is to say, the real value is not measured by the labour-time that the article in each individual case costs the producer, but by the labour-time socially required for its production.	Der wirkliche Wert einer Ware ist aber nicht ihr individueller, sondern ihr gesellschaftlicher Wert, d.h., er wird nicht durch die Arbeitszeit gemessen, die sie im einzelnen Fall dem Produzenten tatsächlich kostet, sondern durch die gesellschaftlich zu ihrer Produktion erheischte Arbeitszeit.	ch12_clean.en-ch12_clean.de
If therefore, the capitalist who applies the new method, sells his commodity at its social value of one shilling, he sells it for threepence above its individual value, and thus realises an extra surplus-value of threepence. On the other hand, the working day of 12 hours is, as regards him, now represented by 24 articles instead of 12. Hence, in order to get rid of the product of one working day, the demand must be double what it was, i.e., the market must become twice as extensive.	Verkauft also der Kapitalist, der die neue Methode anwendet, seine Ware zu ihrem gesellschaftlichen Wert von 1 sh., so verkauft er sie 3 d. über ihrem individuellen Wert und realisiert so einen Extramehrwert von 3 d. Andrerseits stellt sich aber der zwölfstündige Arbeitstag jetzt für ihn in 24 Stück Ware dar statt früher in 12. Um also das Produkt eines Arbeitstags zu verkaufen, bedarf er doppelten Absatzes oder eines zweifach größern Markts.	ch12_clean.en-ch12_clean.de
Other things being equal, his commodities can command a more extended market only by a diminution of their prices.	Unter sonst gleichbleibenden Umständen erobern seine Waren nur größern Marktraum durch Kontraktion ihrer Preise.	ch12_clean.en-ch12_clean.de
He will therefore sell them above their individual but under their social value, say at tenpence each.	Er wird sie daher über ihrem individuellen, aber unter ihrem gesellschaftliche Wert verkaufen, sage zu 10 d. das Stück.	ch12_clean.en-ch12_clean.de
By this means he still squeezes an extra surplus-value of one penny out of each.	So schlägt er an jedem einzelnen Stück immer noch einen Extramehrwert von 1 d. heraus.	ch12_clean.en-ch12_clean.de
This augmentation of surplus-value is pocketed by him, whether his commodities belong or not to the class of necessary means of subsistence that participate in determining the general value of labour-power.	Diese Steigerung des Mehrwerts findet für ihn statt, ob oder ob nicht seine Ware dem Umkreis der notwendigen Lebensmittel angehört und daher bestimmend in den allgemeinen Wert der Arbeitskraft eingeht.	ch12_clean.en-ch12_clean.de
Hence, independently of this latter circumstance, there is a motive for each individual capitalist to cheapen his commodities, by increasing the productiveness of labour.	Vom letztren Umstand abgesehn, existiert also für jeden einzelnen Kapitalisten das Motiv, die Ware durch erhöhte Produktivkraft der Arbeit zu verwohlfeilern.	ch12_clean.en-ch12_clean.de
Nevertheless, even in this case, the increased production of surplus-value arises from the curtailment of the necessary labour-time, and from the corresponding prolongation of the surplus labour.	Indes entspringt selbst in diesem Fall die gesteigerte Produktion von Mehrwert aus der Verkürzung der notwendigen Arbeitszeit und entsprechender Verlängrung der Mehrarbeit.	ch12_clean.en-ch12_clean.de
Let the necessary labour-time amount to 10 hours, the value of a day’s labour-power to five shillings, the surplus labour-time to 2 hours, and the daily surplus-value to one shilling.	(3a) Die notwendige Arbeitszeit betrage 10 Stunden oder der Tageswert der Arbeitskraft 5 sh., die Mehrarbeit 2 Stunden, der täglich produzierte Mehrwert daher 1 sh.	ch12_clean.en-ch12_clean.de
But the capitalist now produces 24 articles, which he sells at tenpence a-piece, making twenty shillings in all.	Unser Kapitalist produziert aber jetzt 24 Stück, die er zu 10 d. per Stück oder zusammen zu 20 sh. verkauft.	ch12_clean.en-ch12_clean.de
Since the value of the means of production is twelve shillings, 14 2/ of these articles merely replace the constant capital advanced.	Da der Wert der Produktionsmittel gleich 12 Schilling, ersetzen 142/5 Stück Ware nur das vorgeschoßne konstante Kapital.	ch12_clean.en-ch12_clean.de
The labour of the 12 hours’ working day is represented by the remaining 9 3/ articles.	Der zwölfstündige Arbeitstag stellt sich in den übrigbleibenden 93/5 Stück dar.	ch12_clean.en-ch12_clean.de
Since the price of the labour-power is five shillings, 6 articles represent the necessary labour-time, and 3 3/ articles the surplus labour.	Da der Preis der Arbeitskraft = 5 sh., stellt sich im Produkt von 6 Stück die notwendige Arbeitszeit dar und in 33/5 Stück die Mehrarbeit.	ch12_clean.en-ch12_clean.de
The ratio of the necessary labour to the surplus labour, which under average social conditions was 5:1, is now only 5:3. The same result may be arrived at in the following way.	Das Verhältnis der notwendigen Arbeit zur Mehrarbeit, welches unter den gesellschaftlichen Durchschnittsbedingungen 5 : 1 betrug, beträgt jetzt nur noch 5 : 3. Dasselbe Resultat erhält man so: Der Produktenwert des zwölfstündigen Arbeitstags ist 20 sh.	ch12_clean.en-ch12_clean.de
The value of the product of the working day of 12 hours is twenty shillings.	Davon gehören 12 sh. dem nur wieder erscheinenden Wert der Produktionsmittel.	ch12_clean.en-ch12_clean.de
Of this sum, twelve shillings belong to the value of the means of production, a value that merely re-appears.	Bleiben also 8 sh. als Geldausdruck des Werts, worin sich der Arbeitstag darstellt.	ch12_clean.en-ch12_clean.de
There remain eight shillings, which are the expression in money, of the value newly created during the working day.		ch12_clean.en-ch12_clean.de
This sum is greater than the sum in which average social labour of the same kind is expressed: twelve hours of the latter labour are expressed by six shillings only.	Dieser Geldausdruck ist höher als der Geldausdruck der gesellschaftlichen Durchschnittsarbeit von derselben Sorte, wovon sich 12 Stunden nur in 6 sh. ausdrücken.	ch12_clean.en-ch12_clean.de
The exceptionally productive labour operates as intensified labour; it creates in equal periods of time greater values than average social labour of the same kind. (See Ch. I. Sect 2. p. 44.) But our capitalist still continues to pay as before only five shillings as the value of a day’s labour-power.	Die Arbeit von ausnahmsweiser Produktivkraft wirkt als potenzierte Arbeit oder schafft in gleichen Zeiträumen höhere Werte als die gesellschaftliche Durchschnittsarbeit derselben Art. Aber unser Kapitalist zahlt nach wie vor nur 5 sh. für den Tageswert der Arbeitskraft.	ch12_clean.en-ch12_clean.de
Hence, instead of 10 hours, the labourer need now work only 7½ hours, in order to reproduce this value.	Der Arbeiter bedarf daher, statt früher 10, jetzt nur noch 71/2 Stunden zur Reproduktion dieses Werts.	ch12_clean.en-ch12_clean.de
His surplus labour is, therefore, increased by 2½ hours, and the surplus-value he produces grows from one, into three shillings.	Seine Mehrarbeit wächst daher um 21/2 Stunden, der von ihm produzierte Mehrwert von 1 auf 3 sh.	ch12_clean.en-ch12_clean.de
Hence, the capitalist who applies the improved method of production, appropriates to surplus labour a greater portion of the working day, than the other capitalists in the same trade.	Der Kapitalist, der die verbesserte Produktionsweise anwendet, eignet sich daher einen größern Teil des Arbeitstags für die Mehrarbeit an als die übrigen Kapitalisten in demselben Geschäft.	ch12_clean.en-ch12_clean.de
He does individually, what the whole body of capitalists engaged in producing relative surplus-value, do collectively.	Er tut im einzelnen, was das Kapital bei der Produktion des relativen Mehrwerts im großen und ganzen tut.	ch12_clean.en-ch12_clean.de
On the other hand, however, this extra surplus-value vanishes, so soon as the new method of production has become general, and has consequently caused the difference between the individual value of the cheapened commodity and its social value to vanish.	Andrerseits aber verschwindet jener Extramehrwert, sobald die neue Produktionsweise sich verallgemeinert und damit die Differenz zwischen dem individuellen Wert der wohlfeiler produzierten Waren und ihrem gesellschaftliche Wert verschwindet.	ch12_clean.en-ch12_clean.de
The law of the determination of value by labour-time, a law which brings under its sway the individual capitalist who applies the new method of production, by compelling him to sell his goods under their social value, this same law, acting as a coercive law of competition, forces his competitors to adopt the new method.	Dasselbe Gesetz der Wertbestimmung durch die Arbeitszeit, das dem Kapitalisten mit der neuen Methode in der Form fühlbar wird, daß er seine Ware unter ihrem gesellschaftlichen Wert verkaufen muß, treibt seine Mitbewerber als Zwangsgesetz der Konkurrenz zur Einführung der neuen Produktionsweise.	ch12_clean.en-ch12_clean.de
The general rate of surplus-value is, therefore, ultimately affected by the whole process, only when the increase in the productiveness of labour, has seized upon those branches of production that are connected with, and has cheapened those commodities that form part of, the necessary means of subsistence, and are therefore elements of the value of labour-power.	Die allgemeine Rate des Mehrwerts wird also durch den ganzen Prozeß schließlich nur berührt, wenn die Erhöhung der Produktivkraft der Arbeit Produktionszweige ergriffen, also Waren verwohlfeilert hat, die in den Kreis der notwendigen Lebensmittel eingehn, daher Elemente des Werts der Arbeitskraft bilden.	ch12_clean.en-ch12_clean.de
The value of commodities is in inverse ratio to the productiveness of labour.	Der Wert der Waren steht in umgekehrtem Verhältnis zur Produktivkraft der Arbeit.	ch12_clean.en-ch12_clean.de
And so, too, is the value of labour-power, because it depends on the values of commodities.	Ebenso, weil durch Warenwerte bestimmt, der Wert der Arbeitskraft.	ch12_clean.en-ch12_clean.de
Relative surplus-value is, on the contrary, directly proportional to that productiveness.	Dagegen steht der relative Mehrwert in direktem Verhältnis zur Produktivkraft der Arbeit.	ch12_clean.en-ch12_clean.de
It rises with rising and falls with falling productiveness.	Er steigt mit steigender und fällt mit fallender Produktivkraft.	ch12_clean.en-ch12_clean.de
The value of money being assumed to be constant, an average social working day of 12 hours always produces the same new value, six shillings, no matter how this sum may be apportioned between surplus-value and wages.	Ein gesellschaftlicher Durchschnittsarbeitstag von 12 Stunden, Geldwert als gleichbleibend vorausgesetzt, produziert stets dasselbe Wertprodukt von 6 sh., wie diese Wertsumme sich immer verteile zwischen Äquivalent für den Wert der Arbeitskraft und Mehrwert.	ch12_clean.en-ch12_clean.de
But if, in consequence of increased productiveness, the value of the necessaries of life fall, and the value of a day’s labour-power be thereby reduced from five shillings to three, the surplus-value increases from one shilling to three.	Fällt aber infolge gesteigerter Produktivkraft der Wert der täglichen Lebensmittel und daher der Tageswert der Arbeitskraft von 5 sh. auf 3 sh., so wächst der Mehrwert von 1 sh. auf 3 sh.	ch12_clean.en-ch12_clean.de
Ten hours were necessary for the reproduction of the value of the labour-power; now only six are required.	Um den Wert der Arbeitskraft zu reproduzieren, waren 10 und sind jetzt nur noch 6 Arbeitsstunden nötig.	ch12_clean.en-ch12_clean.de
Four hours have been set free, and can be annexed to the domain of surplus labour.	Vier Arbeitsstunden sind frei geworden und können der Domäne der Mehrarbeit annexiert werden.	ch12_clean.en-ch12_clean.de
Hence there is immanent in capital an inclination and constant tendency, to heighten the productiveness of labour, in order to cheapen commodities, and by such cheapening to cheapen the labourer himself.	Es ist daher der immanente Trieb und die beständige Tendenz des Kapitals, die Produktivkraft der Arbeit zu steigern, um die Ware und durch die Verwohlfeilerung der Ware den Arbeiter selbst zu verwohlfeilern.	ch12_clean.en-ch12_clean.de
The value of a commodity is, in itself, of no interest to the capitalist.	Der absolute Wert der Ware ist dem Kapitalisten, der sie produziert, an und für sich gleichgültig.	ch12_clean.en-ch12_clean.de
What alone interests him, is the surplus-value that dwells in it, and is realisable by sale.	Ihn interessiert nur der in ihr steckende und im Verkauf realisierbare Mehrwert.	ch12_clean.en-ch12_clean.de
Realisation of the surplus-value necessarily carries with it the refunding of the value that was advanced.	Realisierung von Mehrwert schließt von selbst Ersatz des vorgeschoßnen Werts ein.	ch12_clean.en-ch12_clean.de
Now, since relative surplus-value increases in direct proportion to the development of the productiveness of labour, while, on the other hand, the value of commodities diminishes in the same proportion; since one and the same process cheapens commodities, and augments the surplus-value contained in them; we have here the solution of the riddle: why does the capitalist, whose sole concern is the production of exchange-value, continually strive to depress the exchange-value of commodities? A riddle with which Quesnay, one of the founders of Political Economy, tormented his opponents, and to which they could give him no answer.	Da nun der relative Mehrwert in direktem Verhältnis zur Entwicklung der Produktivkraft der Arbeit wächst, während der Wert der Waren in umgekehrtem Verhältnis zur selben Entwicklung fällt, da also derselbe identische Prozeß die Waren verwohlfeilert und den in ihnen enthaltnen Mehrwert steigert, löst sich das Rätsel, daß der Kapitalist, dem es nur um die Produktion von Tauschwert zu tun ist, den Tauschwert der Waren beständig zu senken strebt, ein Widerspruch, womit einer der Gründer der politischen Ökonomie, Quesnay, seine Gegner quälte und worauf sie ihm die Antwort schuldig blieben.	ch12_clean.en-ch12_clean.de
“You acknowledge,” he says, “that the more expenses and the cost of labour can, in the manufacture of industrial products, be reduced without injury to production, the more advantageous is such reduction, because it diminishes the price of the finished article.	"Ihr gebt zu", sagt Qeusnay, "daß, je mehr man, ohne Nachteil für die Produktion, Kosten oder kostspielige Arbeiten in der Fabrikation industrieller Produkte ersparen kann, desto vorteilhafter diese Ersparung, weil sie den Preis des Machwerks vermindert.	ch12_clean.en-ch12_clean.de
And yet, you believe that the production of wealth, which arises from the labour of the workpeople, consists in the augmentation of the exchange-value of their products.”	Und trotzdem glaubt ihr, daß die Produktion des Reichtums, der aus den Arbeiten der Industriellen herkommt, in der Vermehrung des Tauschwerts ihres Machwerks besteht."	ch12_clean.en-ch12_clean.de
The shortening of the working day is, therefore, by no means what is aimed at, in capitalist production, when labour is economised by increasing its productiveness.	Ökonomie der Arbeit durch Entwicklung der Produktivkraft der Arbeit bezweckt in der kapitalistischen Produktion also durchaus nicht Verkürzung des Arbeitstags.	ch12_clean.en-ch12_clean.de
It is only the shortening of the labour-time, necessary for the production of a definite quantity of commodities, that is aimed at.	Sie bezweckt nur Verkürzung der für Produktion eines bestimmten Warenquantums notwendigen Arbeitszeit.	ch12_clean.en-ch12_clean.de
The fact that the workman, when the productiveness of his labour has been increased, produces, say 10 times as many commodities as before, and thus spends one-tenth as much labour-time on each, by no means prevents him from continuing to work 12 hours as before, nor from producing in those 12 hours 1, articles instead of 120.	Daß der Arbeiter bei gesteigerter Produktivkraft seiner Arbeit in einer Stunde z.B. 10mal mehr Ware früher produziert, also für jedes Stück Ware 10mal weniger Arbeitszeit braucht, verhindert durchaus nicht, ihn nach wie vor 12 Stunden arbeiten und in den 12 Stunden 1.200 statt früher 120 Stück produzieren zu lassen.	ch12_clean.en-ch12_clean.de
Nay, more, his working day may be prolonged at the same time, so as to make him produce, say 1, articles in 14 hours. In the treatises, therefore, of economists of the stamp of MacCulloch, Ure, Senior, and tutti quanti [the like], we may read upon one page, that the labourer owes a debt of gratitude to capital for developing his productiveness, because the necessary labour-time is thereby shortened, and on the next page, that he must prove his gratitude by working in future for 15 hours instead of 10.	Ja, sein Arbeitstag mag gleichzeitig verlängert werden, so daß er jetzt in 14 Stunden 1.400 Stück produziert usw. Man kann daher bei Ökonomen vom Schlag eines MacCulloch, Ure, Senior und tutti quanti auf einer Seite lesen, daß der Arbeiter dem Kapital für die Entwicklung der Produktivkräfte Dank schuldet, weil sie die notwendige Arbeitszeit verkürzt, und auf der nächsten Seite, daß er diesen Dank beweisen muß, indem er statt 10 künftig 15 Stunden arbeitet.	ch12_clean.en-ch12_clean.de
The object of all development of the productiveness of labour, within the limits of capitalist production, is to shorten that part of the working day, during which the workman must labour for his own benefit, and by that very shortening, to lengthen the other part of the day, during which he is at liberty to work gratis for the capitalist.	Die Entwicklung der Produktivkraft der Arbeit, innerhalb der kapitalistischen Produktion, bezweckt, den Teil des Arbeitstags, den der Arbeiter für sich selbst arbeiten muß, zu verkürzen, um grade dadurch den andren Teil des Arbeitstags, den er für den Kapitalisten umsonst arbeiten kann, zu verlängern.	ch12_clean.en-ch12_clean.de
How far this result is also attainable, without cheapening commodities, will appear from an examination of the particular modes of producing relative surplus-value, to which examination we now proceed.	Wieweit dies Resultat auch ohne Verwohlfeilerung der Waren erreichbar, wird sich zeigen in den besondren Produktionsmethoden des relativen Mehrwerts, zu deren Betrachtung wir jetzt übergehn.	ch12_clean.en-ch12_clean.de

