Chapter 14: Division of Labour and Manufacture Section 1: Two-Fold Origin of Manufacture That co-operation which is based on division of labour, assumes its typical form in manufacture, and is the prevalent characteristic form of the capitalist process of production throughout the manufacturing period properly so called.	ZWÖLFTES KAPITEL Teilung der Arbeit und Manufaktur 1. Doppelter Ursprung der Manufaktur Die auf Teilung der Arbeit beruhende Kooperation schafft sich ihre klassische Gestalt in der Manufaktur.	ch14_clean.en-ch14_clean.de
That period, roughly speaking, extends from the middle of the 16th to the last third of the 18th century.	Als charakteristische Form des kapitalistischen Produktionsprozesses herrscht sie vor während der eigentlichen Manufakturperiode, die, rauh angeschlagen, von Mitte des 16. Jahrhunderts bis zum letzten Drittel des achtzehnten währt.	ch14_clean.en-ch14_clean.de
Manufacture takes its rise in two ways: (1.)	Die Manufaktur entspringt auf doppelte Weise.	ch14_clean.en-ch14_clean.de
By the assemblage, in one workshop under the control of a single capitalist, of labourers belonging to various independent handicrafts, but through whose hands a given article must pass on its way to completion.	Entweder werden Arbeiter von verschiedenartigen, selbständigen Handwerken, durch deren Hände ein Produkt bis zu seiner letzten Reife laufen muß, in eine Werkstatt unter dem Kommando desselben Kapitalisten vereinigt.	ch14_clean.en-ch14_clean.de
A carriage, for example, was formerly the product of the labour of a great number of independent artificers, such as wheelwrights, harness-makers, tailors, locksmiths, upholsterers, turners, fringe-makers, glaziers, painters, polishers, gilders, &c. In the manufacture of carriages, however, all these different artificers are assembled in one building where they work into one another’s hands.	Z.B. eine Kutsche war das Gesamtprodukt der Arbeiten einer großen Anzahl unabhängiger Handwerker, wie Stellmacher, Sattler, Schneider, Schlosser, Gürtler, Drechsler, Posamentierer, Glaser, Maler, Lackierer, Vergolder usw. Die Kutschenmanufaktur vereinigt alle diese verschiednen Handwerker in ein Arbeitshaus, wo sie einander gleichzeitig in die Hand arbeiten.	ch14_clean.en-ch14_clean.de
It is true that a carriage cannot be gilt before it has been made.	Man kann eine Kutsche zwar nicht vergolden, bevor sie gemacht ist.	ch14_clean.en-ch14_clean.de
But if a number of carriages are being made simultaneously, some may be in the hands of the gilders while others are going through an earlier process.	Werden aber viele Kutschen gleichzeitig gemacht, so kann ein Teil beständig vergoldet werden, während ein andrer Teil eine frühre Phase des Produktionsprozesses durchläuft.	ch14_clean.en-ch14_clean.de
So far, we are still in the domain of simple co-operation, which finds its materials ready to hand in the shape of men and things.	Soweit stehn wir noch auf dem Boden der einfachen Kooperation, die ihr Material an Menschen und Dingen vorfindet.	ch14_clean.en-ch14_clean.de
But very soon an important change takes place.	Indes tritt sehr bald eine wesentliche Veränderung ein.	ch14_clean.en-ch14_clean.de
The tailor, the locksmith, and the other artificers, being now exclusively occupied in carriage-making, each gradually loses, through want of practice, the ability to carry on, to its full extent, his old handicraft.	Der Schneider, Schlosser, Gürtler usw., der nur im Kutschenmachen beschäftigt ist, verliert nach und nach mit der Gewohnheit auch die Fähigkeit, sein altes Handwerk in seiner ganzen Ausdehnung zu betreiben.	ch14_clean.en-ch14_clean.de
But, on the other hand, his activity now confined in one groove, assumes the form best adapted to the narrowed sphere of action.	Andrerseits erhält sein vereinseitigtes Tun jetzt die zweckmäßigste Form für die verengte Wirkungssphäre.	ch14_clean.en-ch14_clean.de
At first, carriage manufacture is a combination of various independent handicrafts.	Ursprünglich erschien die Kutschenmanufaktur als eine Kombination selbständiger Handwerke.	ch14_clean.en-ch14_clean.de
By degrees, it becomes the splitting up of carriage-making into its various detail processes, each of which crystallises into the exclusive function of a particular workman, the manufacture, as a whole, being carried on by the men in conjunction.	Sie wird allmählich Teilung der Kutschenproduktion in ihre verschiednen Sonderoperationen, wovon jede einzelne zur ausschließlichen Funktion eines Arbeiters kristallisiert und deren Gesamtheit vom Verein dieser Teilarbeiter verrichtet wird.	ch14_clean.en-ch14_clean.de
In the same way, cloth manufacture, as also a whole series of other manufactures, arose by combining different handicrafts together under the control of a single capitalist.	Ebenso entstand die Tuchmanufaktur und eine ganze Reihe andrer Manufakturen aus der Kombination verschiedner Handwerke unter Kommando desselben Kapitals.	ch14_clean.en-ch14_clean.de
(2.)	Die Manufaktur entspringt aber auch auf entgegengesetztem Wege.	ch14_clean.en-ch14_clean.de
Manufacture also arises in a way exactly the reverse of this namely, by one capitalist employing simultaneously in one workshop a number of artificers, who all do the same, or the same kind of work, such as making paper, type, or needles.	Es werden viele Handwerker, die dasselbe oder Gleichartiges tun, z.B. Papier oder Typen oder Nadeln machen, von demselben Kapital gleichzeitig in derselben Werkstatt beschäftigt.	ch14_clean.en-ch14_clean.de
This is co-operation in its most elementary form.	Es ist dies Kooperation in der einfachsten Form.	ch14_clean.en-ch14_clean.de
Each of these artificers (with the help, perhaps, of one or two apprentices), makes the entire commodity, and he consequently performs in succession all the operations necessary for its production.	Jeder dieser Handwerker (vielleicht mit einem oder zwei Gesellen) macht die ganze Ware und vollbringt also die verschiednen, zu ihrer Herstellung erheischten Operationen der Reihe nach.	ch14_clean.en-ch14_clean.de
He still works in his old handicraft-like way.	Er arbeitet in seiner alten handwerksmäßigen Weise fort.	ch14_clean.en-ch14_clean.de
But very soon external circumstances cause a different use to be made of the concentration of the workmen on one spot, and of the simultaneousness of their work.	Indes veranlassen bald äußere Umstände, die Konzentration der Arbeiter in demselben Raum und die Gleichzeitigkeit ihrer Arbeiten anders zu vernutzen.	ch14_clean.en-ch14_clean.de
An increased quantity of the article has perhaps to be delivered within a given time.	Es soll z.B. ein größeres Quantum fertiger Ware in einer bestimmten Zeitfrist geliefert werden.	ch14_clean.en-ch14_clean.de
The work is therefore re-distributed.	Die Arbeit wird daher verteilt.	ch14_clean.en-ch14_clean.de
Instead of each man being allowed to perform all the various operations in succession, these operations are changed into disconnected, isolated ones, carried on side by side; each is assigned to a different artificer, and the whole of them together are performed simultaneously by the co-operating workmen.	Statt die verschiednen Operationen von demselben Handwerker in einer zeitlichen Reihenfolge verrichten zu lassen, werden sie voneinander losgelöst, isoliert, räumlich nebeneinander gestellt, jede derselben einem andren Handwerker zugewiesen und alle zusammen von den Kooperierenden gleichzeitig ausgeführt.	ch14_clean.en-ch14_clean.de
This accidental repartition gets repeated, develops advantages of its own, and gradually ossifies into a systematic division of labour.	Diese zufällige Verteilung wiederholt sich, zeigt ihre eigentümlichen Vorteile und verknöchert nach und nach zur systematischen Teilung der Arbeit.	ch14_clean.en-ch14_clean.de
The commodity, from being the individual product of an independent artificer, becomes the social product of a union of artificers, each of whom performs one, and only one, of the constituent partial operations.	Aus dem indivi- duellen Produkt eines selbständigen Handwerkers, der vielerlei tut, verwandelt sich die Ware in das gesellschaftliche Produkt eines Vereins von Handwerkern, von denen jeder fortwährend nur eine und dieselbe Teiloperation verrichtet.	ch14_clean.en-ch14_clean.de
The same operations which, in the case of a papermaker belonging to a German Guild, merged one into the other as the successive acts of one artificer, became in the Dutch paper manufacture so many partial operations carried on side by side by numerous co-operating labourers.	Dieselben Operationen, die ineinander flossen als sukzessive Verrichtungen des deutschen zünftigen Papiermachers, verselbständigten sich in der holländischen Papiermanufaktur zu nebeneinander laufenden Teiloperationen vieler kooperierenden Arbeiter.	ch14_clean.en-ch14_clean.de
The needlemaker of the Nuremberg Guild was the cornerstone on which the English needle manufacture was raised.	Der zünftige Nadler von Nürnberg bildet das Grundelement der englischen Nadelmanufaktur.	ch14_clean.en-ch14_clean.de
But while in Nuremberg that single artificer performed a series of perhaps 20 operations one after another, in England it was not long before there were 20 needlemakers side by side, each performing one alone of those 20 operations, and in consequence of further experience, each of those 20 operations was again split up, isolated, and made the exclusive function of a separate workman.	Während aber jener eine Nadler eine Reihe von vielleicht 20 Operationen nacheinander durchlief, verrichteten hier bald 20 Nadler nebeneinander, jeder nur eine der 20 Operationen, die infolge von Erfahrungen noch viel weiter gespaltet, isoliert und zu ausschließlichen Funktionen einzelner Arbeiter verselbständigt wurden.	ch14_clean.en-ch14_clean.de
The mode in which manufacture arises, its growth out of handicrafts, is therefore two-fold.	Die Ursprungsweise der Manufaktur, ihre Herausbildung aus dem Handwerk ist also zwieschlächtig.	ch14_clean.en-ch14_clean.de
On the one hand, it arises from the union of various independent handicrafts, which become stripped of their independence and specialised to such an extent as to be reduced to mere supplementary partial processes in the production of one particular commodity.	Einerseits geht sie von der Kombination verschiedenartiger, selbständiger Handwerke aus, die bis zu dem Punkt verunselbständigt und vereinseitigt werden, wo sie nur noch einander ergänzende Teiloperationen im Produktionsprozeß einer und derselben Ware bilden.	ch14_clean.en-ch14_clean.de
On the other hand, it arises from the co-operation of artificers of one handicraft; it splits up that particular handicraft into its various detail operations, isolating, and making these operations independent of one another up to the point where each becomes the exclusive function of a particular labourer.	Andrerseits geht sie von der Kooperation gleichartiger Handwerker aus, zersetzt dasselbe individuelle Handwerk in seine verschiednen besondren Operationen und isoliert und verselbständigt diese bis zu dem Punkt, wo jede derselben zur ausschließlichen Funktion eines besondren Arbeiters wird.	ch14_clean.en-ch14_clean.de
On the one hand, therefore, manufacture either introduces division of labour into a process of production, or further develops that division; on the other hand, it unites together handicrafts that were formerly separate.	Einerseits führt daher die Manufaktur Teilung der Arbeit in einen Produktionsprozeß ein oder entwickelt sie weiter, andrerseits kombiniert sie früher geschiedne Handwerke.	ch14_clean.en-ch14_clean.de
But whatever may have been its particular starting-point, its final form is invariably the same a productive mechanism whose parts are human beings.	Welches aber immer ihr besondrer Ausgangspunkt, ihre Schlußgestalt ist dieselbe - ein Produktionsmechanismus, dessen Organe Menschen sind.	ch14_clean.en-ch14_clean.de
For a proper understanding of the division of labour in manufacture, it is essential that the following points be firmly grasped. First, the decomposition of a process of production into its various successive steps coincides, here, strictly with the resolution of a handicraft into its successive manual operations.	Zum richtigen Verständnis der Teilung der Arbeit in der Manufaktur ist es wesentlich, folgende Punkte festzuhalten: Zunächst fällt die Analyse des Produktionsprozesses in seine besondren Phasen hier ganz und gar zusammen mit der Zersetzung einer handwerksmäßigen Tätigkeit in ihre verschiednen Teiloperationen.	ch14_clean.en-ch14_clean.de
Whether complex or simple, each operation has to be done by hand, retains the character of a handicraft, and is therefore dependent on the strength, skill, quickness, and sureness, of the individual workman in handling his tools.	Zusammengesetzt oder einfach, die Verrichtung bleibt handwerksmäßig und daher abhängig von Kraft, Geschick, Schnelle, Sicherheit des Einzelarbeiters in Handhabung seines Instruments.	ch14_clean.en-ch14_clean.de
The handicraft continues to be the basis.	Das Handwerk bleibt die Basis.	ch14_clean.en-ch14_clean.de
This narrow technical basis excludes a really scientific analysis of any definite process of industrial production, since it is still a condition that each detail process gone through by the product must be capable of being done by hand and of forming, in its way, a separate handicraft.	Diese enge technische Basis schließt wirklich wissenschaftliche Analyse des Produktionsprozesses aus, da jeder Teilprozeß, den das Produkt durchmacht, als handwerksmäßige Teilarbeit ausführbar sein muß.	ch14_clean.en-ch14_clean.de
It is just because handicraft skill continues, in this way, to be the foundation of the process of production, that each workman becomes exclusively assigned to a partial function, and that for the rest of his life, his labour-power is turned into the organ of this detail function.	Eben weil das handwerksmäßige Geschick so die Grundlage des Produktionsprozesses bleibt, wird jeder Arbeiter ausschließ- lich einer Teilfunktion angeeignet und seine Arbeitskraft in das lebenslängliche Organ dieser Teilfunktion verwandelt.	ch14_clean.en-ch14_clean.de
Secondly, this division of labour is a particular sort of co-operation, and many of its disadvantages spring from the general character of co-operation, and not from this particular form of it.	Endlich ist diese Teilung der Arbeit eine besondre Art der Kooperation, und manche ihrer Vorteile entspringen aus dem allgemeinen Wesen, nicht aus dieser besondren Form der Kooperation.	ch14_clean.en-ch14_clean.de
Section 2: The Detail Labourer and his Implements If we now go more into detail, it is, in the first place, clear that a labourer who all his life performs one and the same simple operation, converts his whole body into the automatic, specialised implement of that operation. Consequently, he takes less time in doing it, than the artificer who performs a whole series of operations in succession.	2. Der Teilarbeiter und sein Werkzeug Gehn wir nun näher auf das einzelne ein, so ist zunächst klar, daß ein Arbeiter, der lebenslang eine und dieselbe einfache Operation verrichtet, seinen ganzen Körper in ihr automatisch einseitiges Organ verwandelt und daher weniger Zeit dazu verbraucht als der Handwerker, der eine ganze Reihe von Operationen abwechselnd ausführt.	ch14_clean.en-ch14_clean.de
But the collective labourer, who constitutes the living mechanism of manufacture, is made up solely of such specialised detail labourers.	Der kombinierte Gesamtarbeiter, der den lebendigen Mechanismus der Manufaktur bildet, besteht aber aus lauter solchen einseitigen Teilarbeitern.	ch14_clean.en-ch14_clean.de
Hence, in comparison with the independent handicraft, more is produced in a given time, or the productive power of labour is increased.	Im Vergleich zum selbständigen Handwerk wird daher mehr in weniger Zeit produziert oder die Produktivkraft der Arbeiter gesteigert.	ch14_clean.en-ch14_clean.de
Moreover, when once this fractional work is established as the exclusive function of one person, the methods it employs become perfected.	Auch vervollkommnet sich die Methode der Teilarbeit, nachdem sie zur ausschließlichen Funktion einer Person verselbständigt ist.	ch14_clean.en-ch14_clean.de
The workman’s continued repetition of the same simple act, and the concentration of his attention on it, teach him by experience how to attain the desired effect with the minimum of exertion.	Die stete Wiederholung desselben beschränkten Tuns und die Konzentration der Aufmerksamkeit auf dieses Beschränkte lehren erfahrungsmäßig den bezweckten Nutzeffekt mit geringstem Kraftaufwand erreichen.	ch14_clean.en-ch14_clean.de
But since there are always several generations of labourers living at one time, and working together at the manufacture of a given article, the technical skill, the tricks of the trade thus acquired, become established, and are accumulated and handed down.	Da aber immer verschiedne Arbeitergenerationen gleichzeitig zusammenleben und in denselben Manufakturen zusammenwirken, befestigen, häufen und übertragen sich bald die so gewonnenen technischen Kunstgriffe.	ch14_clean.en-ch14_clean.de
Manufacture, in fact, produces the skill of the detail labourer, by reproducing, and systematically driving to an extreme within the workshop, the naturally developed differentiation of trades which it found ready to hand in society at large.	Die Manufaktur produziert in der Tat die Virtuosität des Detailarbeiters, indem sie die naturwüchsige Sonderung der Gewerbe, die sie in der Gesellschaft vorfand, im Innern der Werkstatt reproduziert und systematisch zum Extrem treibt.	ch14_clean.en-ch14_clean.de
On the other hand, the conversion of fractional work into the life-calling of one man, corresponds to the tendency shown by earlier societies, to make trades hereditary; either to petrify them into castes, or whenever definite historical conditions beget in the individual a tendency to vary in a manner incompatible with the nature of castes, to ossify them into guilds.	Andrerseits entspricht ihre Verwandlung der Teilarbeit in den Lebensberuf eines Menschen dem Trieb früherer Gesellschaften, die Gewerbe erblich zu machen, sie in Kasten zu versteinern oder in Zünfte zu verknöchern, falls bestimmte historische Bedingungen dem Kastenwesen widersprechende Variabilität des Individuums erzeugen.	ch14_clean.en-ch14_clean.de
Castes and guilds arise from the action of the same natural law, that regulates the differentiation of plants and animals into species and varieties, except that, when a certain degree of development has been reached, the heredity of castes and the exclusiveness of guilds are ordained as a law of society.	Kasten und Zünfte entspringen aus demselben Naturgesetz, welches die Sonderung von Pflanzen und Tieren in Arten und Unterarten regelt, nur daß auf einem gewissen Entwicklungsgrad die Erblichkeit der Kasten oder die Ausschließlichkeit der Zünfte als gesellschaftliches Gesetz dekretiert wird.	ch14_clean.en-ch14_clean.de
“The muslins of Dakka in fineness, the calicoes and other piece goods of Coromandel in brilliant and durable colours, have never been surpassed.	"Die Musline von Dakka sind an Feinheit, die Kattune und andre Zeuge von Koromandel an Pracht und Dauerhaftigkeit der Farben niemals übertroffen worden.	ch14_clean.en-ch14_clean.de
Yet they are produced without capital, machinery, division of labour, or any of those means which give such facilities to the manufacturing interest of Europe.	Und dennoch werden sie produziert ohne Kapital, Maschinerie, Teilung der Arbeit oder irgendeins der andren Mittel, die der Fabrikation in Europa so viele Vorteile bieten.	ch14_clean.en-ch14_clean.de
The weaver is merely a detached individual, working a web when ordered of a customer, and with a loom of the rudest construction, consisting sometimes of a few branches or bars of wood, put roughly together.	Der Weber ist ein vereinzeltes Individuum, der das Gewebe auf Bestellung eines Kunden verfertigt und mit einem Webstuhl von der einfachsten Konstruktion, manchmal nur bestehend aus hölzernen, roh zusammengefügten Stangen.	ch14_clean.en-ch14_clean.de
There is even no expedient for rolling up the warp; the loom must therefore be kept stretched to its full length, and becomes so inconveniently large, that it cannot be contained within the hut of the manufacturer, who is therefore compelled to ply his trade in the open air, where it is interrupted by every vicissitude of the weather.”	Er besitzt nicht einmal einen Apparat zum Aufziehn der Kette, der Webstuhl muß daher in seiner ganzen Länge ausgestreckt bleiben und wird so unförmlich und weit, daß er keinen Raum findet in der Hütte des Produzenten, der seine Arbeit daher in freier Luft verrichten muß, wo sie durch jede Wetterändrung unterbrochen wird."	ch14_clean.en-ch14_clean.de
It is only the special skill accumulated from generation to generation, and transmitted from father to son, that gives to the Hindu, as it does to the spider, this proficiency.	Es ist nur das von Generation auf Generation gehäufte und von Vater auf Sohn vererbte Sondergeschick, das dem Hindu wie der Spinne diese Virtuosität verleiht.	ch14_clean.en-ch14_clean.de
And yet the work of such a Hindu weaver is very complicated, compared with that of a manufacturing labourer.	Und dennoch verrichtet ein solcher indischer Weber sehr komplizierte Arbeit, verglichen mit der Mehrzahl der Manufakturarbeiter.	ch14_clean.en-ch14_clean.de
An artificer, who performs one after another the various fractional operations in the production of a finished article, must at one time change his place, at another his tools.	Ein Handwerker, der die verschiednen Teilprozesse in der Produktion eines Machwerks nacheinander ausführt, muß bald den Platz, bald die Instrumente wechseln.	ch14_clean.en-ch14_clean.de
The transition from one operation to another interrupts the flow of his labour, and creates, so to say, gaps in his working day.	Der Übergang von einer Operation zur andren unterbricht den Fluß seiner Arbeit und bildet gewissermaßen Poren in seinem Arbeitstag.	ch14_clean.en-ch14_clean.de
These gaps close up so soon as he is tied to one and the same operation all day long; they vanish in proportion as the changes in his work diminish.	Diese Poren verdichten sich, sobald er den ganzen Tag eine und dieselbe Operation kontinuierlich verrichtet, oder sie verschwinden in dem Maße, wie der Wechsel seiner Operation abnimmt.	ch14_clean.en-ch14_clean.de
The resulting increased productive power is owing either to an increased expenditure of labour-power in a given time i.e., to increased intensity of labour or to a decrease in the amount of labour-power unproductively consumed.	Die gesteigerte Produktivität ist hier entweder der zunehmenden Ausgabe von Arbeitskraft in einem gegebnen Zeitraum geschuldet, also wachsender Intensität der Arbeit oder einer Abnahme des unproduktiven Verzehrs von Arbeitskraft.	ch14_clean.en-ch14_clean.de
The extra expenditure of power, demanded by every transition from rest to motion, is made up for by prolonging the duration of the normal velocity when once acquired.	Der Überschuß von Kraftaufwand nämlich, den jeder Übergang aus der Ruhe in die Bewegung erheischt, kompensiert sich bei längrer Fortdauer der einmal erreichten Normalgeschwindigkeit.	ch14_clean.en-ch14_clean.de
On the other hand, constant labour of one uniform kind disturbs the intensity and flow of a man’s animal spirits, which find recreation and delight in mere change of activity.	Andrerseits zerstört die Kontinuität gleichförmiger Arbeit die Spann- und Schwungkraft der Lebensgeister, die im Wechsel der Tätigkeit selbst ihre Erholung und ihren Reiz finden.	ch14_clean.en-ch14_clean.de
The productiveness of labour depends not only on the proficiency of the workman, but on the perfection of his tools.	Die Produktivität der Arbeit hängt nicht nur von der Virtuosität des Arbeiters ab, sondern auch von der Vollkommenheit seiner Werkzeuge.	ch14_clean.en-ch14_clean.de
Tools of the same kind, such as knives, drills, gimlets, hammers, &c., may be employed in different processes; and the same tool may serve various purposes in a single process.	Werkzeuge derselben Art, wie Schneider-, Bohr-, Stoß-, Schlaginstrumente usw., werden in verschiednen Arbeitsprozessen gebraucht, und in demselben Arbeitsprozeß dient dasselbe Instrument zu verschiednen Verrichtungen.	ch14_clean.en-ch14_clean.de
But so soon as the different operations of a labour-process are disconnected the one from the other, and each fractional operation acquires in the hands of the detail labourer a suitable and peculiar form, alterations become necessary in the implements that previously served more than one purpose.	Sobald jedoch die verschiednen Operationen eines Arbeitsprozesses voneinander losgelöst sind und jede Teiloperation in der Hand des Teilarbeiters eine möglichst entsprechende und daher ausschließliche Form gewinnt, werden Verändrungen der vorher zu verschiednen Zwecken dienenden Werkzeuge notwendig.	ch14_clean.en-ch14_clean.de
The direction taken by this change is determined by the difficulties experienced in consequence of the unchanged form of the implement.	Die Richtung ihres Formwechsels ergibt sich aus der Erfahrung der besondren Schwierigkeiten, welche die unveränderte Form in den Weg legt.	ch14_clean.en-ch14_clean.de
Manufacture is characterised by the differentiation of the instruments of labour a differentiation whereby implements of a given sort acquire fixed shapes, adapted to each particular application, and by the specialisation of those instruments, giving to each special implement its full play only in the hands of a specific detail labourer.	Die Differenzierung der Arbeitsinstrumente, wodurch Instrumente derselben Art besondre feste Formen für jede besondre Nutzanwendung erhalten, und ihre Spezialisierung, wodurch jedes solches Sonderinstrument nur in der Hand spezifischer Teilarbeiter in seinem ganzen Umfang wirkt, charakterisieren die Manufaktur.	ch14_clean.en-ch14_clean.de
In Birmingham alone 500 varieties of hammers are produced, and not only is each adapted to one particular process, but several varieties often serve exclusively for the different operations in one and the same process.	Zu Birmingham allein produziert man etwa 500 Varietäten von Hämmern, wovon jeder nicht nur für einen besondren Produktionsprozeß, sondern eine Anzahl Varietäten oft nur für verschiedne Operationen in demselben Prozeß dient.	ch14_clean.en-ch14_clean.de
The manufacturing period simplifies, improves, and multiplies the implements of labour, by adapting them to the exclusively special functions of each detail labourer.	Die Manufakturperiode vereinfacht, verbessert und vermannigfacht die Arbeitswerkzeuge durch deren Anpassung an die ausschließlichen Sonderfunktionen der Teilarbeiter.	ch14_clean.en-ch14_clean.de
It thus creates at the same time one of the material conditions for the existence of machinery, which consists of a combination of simple instruments.	Sie schafft damit zu- gleich eine der materiellen Bedingungen der Maschinerie, die aus einer Kombination einfacher Instrumente besteht.	ch14_clean.en-ch14_clean.de
The detail labourer and his implements are the simplest elements of manufacture.	Der Detailarbeiter und sein Instrument bilden die einfachen Elemente der Manufaktur.	ch14_clean.en-ch14_clean.de
Let us now turn to its aspect as a whole.	Wenden wir uns jetzt zu ihrer Gesamtgestalt.	ch14_clean.en-ch14_clean.de
Section 3: The Two Fundamental Forms of Manufacture: Heterogeneous Manufacture, Serial Manufacture The organisation of manufacture has two fundamental forms which, in spite of occasional blending, are essentially different in kind, and, moreover, play very distinct parts in the subsequent transformation of manufacture into modern industry carried on by machinery.	3. Die beiden Grundformen der Manufaktur - heterogene Manufaktur und organische Manufaktur Die Gliederung der Manufaktur besitzt zwei Grundformen, die trotz gelegentlicher Verschlingung zwei wesentlich verschiedne Arten bilden und namentlich auch bei der spätren Verwandlung der Manufaktur in die maschinenartig betriebne, große Industrie eine ganz verschiedne Rolle spielen.	ch14_clean.en-ch14_clean.de
This double character arises from the nature of the article produced.	Dieser Doppelcharakter entspringt aus der Natur des Machwerks selbst.	ch14_clean.en-ch14_clean.de
This article either results from the mere mechanical fitting together of partial products made independently, or owes its completed shape to a series of connected processes and manipulations.	Es wird entweder gebildet durch bloß mechanische Zusammensetzung selbständiger Teilprodukte oder verdankt seine fertige Gestalt einer Reihenfolge zusammenhängender Prozesse und Manipulationen.	ch14_clean.en-ch14_clean.de
A locomotive, for instance, consists of more than 5, independent parts.	Eine Lokomotive z.B. besteht aus mehr als 5.000 selbständigen Teilen.	ch14_clean.en-ch14_clean.de
It cannot, however, serve as an example of the first kind of genuine manufacture, for it is a structure produced by modern mechanical industry.	Sie kann jedoch nicht als Beispiel der ersten Art der eigentlichen Manufaktur gelten, weil sie ein Gebilde der großen Industrie ist.	ch14_clean.en-ch14_clean.de
But a watch can; and William Petty used it to illustrate the division of labour in manufacture.	Wohl aber die Uhr, an welcher auch William Petty die manufakturmäßige Teilung der Arbeit veranschaulicht.	ch14_clean.en-ch14_clean.de
Formerly the individual work of a Nuremberg artificer, the watch has been transformed into the social product of an immense number of detail labourers, such as mainspring makers, dial makers, spiral spring makers, jewelled hole makers, ruby lever makers, hand makers, case makers, screw makers, gilders, with numerous subdivisions, such as wheel makers (brass and steel separate), pin makers, movement makers, acheveur de pignon (fixes the wheels on the axles, polishes the facets, &c.), pivot makers, planteur de finissage (puts the wheels and springs in the works), finisseur de barillet (cuts teeth in the wheels, makes the holes of the right size, &c.), escapement makers, cylinder makers for cylinder escapements, escapement wheel makers, balance wheel makers, raquette makers (apparatus for regulating the watch), the planteur d’échappement (escapement maker proper); then the repasseur de barillet (finishes the box for the spring, &c.), steel polishers, wheel polishers, screw polishers, figure painters, dial enamellers (melt the enamel on the copper), fabricant de pendants (makes the ring by which the case is hung), finisseur de charnière (puts the brass hinge in the cover, &c.), faiseur de secret (puts in the springs that open the case), graveur, ciseleur, polisseur de boîte, &c., &c., and last of all the repasseur, who fits together the whole watch and hands it over in a going state.	Aus dem individuellen Werk eines Nürnberger Handwerkers verwandelte sich die Uhr in das gesellschaftliche Produkt einer Unzahl von Teilarbeitern, wie Rohwerkmacher, Uhrfedermacher, Zifferblattmacher, Spiralfedermacher, Steinloch- und Rubinhebelmacher, Zeigermacher, Gehäusemacher, Schraubenmacher, Vergolder, mit vielen Unterabteilungen, wie z.B. Räderfabrikant (Messing- und Stahlräder wieder geschieden), Triebmacher, Zeigerwerkmacher, acheveur de pignon (befestigt die Räder auf den Trieben, poliert die facettes usw.), Zapfenmacher, planteur de finissage (setzt verschiedne Räder und Triebe in das Werk), finisseur de barillet (läßt Zähne einschneiden, macht die Löcher zur richtigen Weite, härtet Stellung und Gesperr), Hemmungmacher, bei der Zylinderhemmung wieder Zylindermacher, Steigradmacher, Unruhe- macher, Requettemacher (das Rückwerk, woran die Uhr reguliert wird), planteur d'échappement (eigentliche Hemmungmacher); dann der repasseur de barillet (macht Federhaus und Stellung ganz fertig), Stahlpolierer, Räderpolierer, Schraubenpolierer, Zahlenmaler, Blattmacher (schmilzt das Email auf das Kupfer), fabricant de pendants (macht bloß die Bügel des Gehäuses), finisseur de charnière (steckt den Messingstift in die Mitte des Gehäuses etc.), faiseur de secret (macht die Federn im Gehäuse, die den Deckel aufspringen machen), graveur, ciseleur, polisseur de boîte <Polierer des Gehäuses> usw., usw., endlich der repasseur, der die ganze Uhr zusammensetzt und sie gehend abliefert.	ch14_clean.en-ch14_clean.de
Only a few parts of the watch pass through several hands; and all these membra disjecta come together for the first time in the hand that binds them into one mechanical whole.	Nur wenige Teile der Uhr laufen durch verschiedne Hände, und alle diese membra disjecta sammeln sich erst in der Hand, die sie schließlich in ein mechanisches Ganzes verbindet.	ch14_clean.en-ch14_clean.de
This external relation between the finished product, and its various and diverse elements makes it, as well in this case as in the case of all similar finished articles, a matter of chance whether the detail labourers are brought together in one workshop or not.	Dies äußerliche Verhältnis des fertigen Produkts zu seinen verschiedenartigen Elementen läßt hier, wie bei ähnlichem Machwerk, die Kombination der Teilarbeiter in derselben Werkstatt zufällig.	ch14_clean.en-ch14_clean.de
The detail operations may further be carried on like so many independent handicrafts, as they are in the Cantons of Vaud and Neufchâtel; while in Geneva there exist large watch manufactories where the detail labourers directly co-operate under the control of a single capitalist.	Die Teilarbeiten können selbst wieder als voneinander unabhängige Handwerke betrieben werden, wie im Kanton Waadt und Neuchâtel, während in Genf z.B. große Uhrenmanufakturen bestehn, d.h. unmittelbare Kooperation der Teilarbeiter unter dem Kommando eines Kapitals stattfindet.	ch14_clean.en-ch14_clean.de
And even in the latter case the dial, the springs, and the case, are seldom made in the factory itself.	Auch im letztren Fall werden Zifferblatt, Feder und Gehäuse selten in der Manufaktur selbst verfertigt.	ch14_clean.en-ch14_clean.de
To carry on the trade as a manufacture, with concentration of workmen, is, in the watch trade, profitable only under exceptional conditions, because competition is greater between the labourers who desire to work at home, and because the splitting up of the work into a number of heterogeneous processes, permits but little use of the instruments of labour in common, and the capitalist, by scattering the work, saves the outlay on workshops, &c.	Der kombinierte manufakturmäßige Betrieb ist hier nur unter ausnahmsweisen Verhältnissen profitlich, weil die Konkurrenz unter den Arbeitern, die zu Hause arbeiten wollen, am größten ist, die Zersplittrung der Produktion in eine Masse heterogener Prozesse wenig Verwendung gemeinschaftlicher Arbeitsmittel erlaubt und der Kapitalist bei der zerstreuten Fabrikation die Auslage für Arbeitsgebäude usw. erspart.	ch14_clean.en-ch14_clean.de
Nevertheless the position of this detail labourer who, though he works at home, does so for a capitalist (manufacturer, établisseur), is very different from that of the independent artificer, who works for his own customers.	Indes ist auch die Stellung dieser Detailarbeiter, die zu Hause, aber für einen Kapitalisten (Fabrikant, établisseur) arbeiten, ganz und gar verschieden von der des selbständigen Handwerkers, welcher für seine eignen Kunden arbeitet.	ch14_clean.en-ch14_clean.de
The second kind of manufacture, its perfected form, produces articles that go through connected phases of development, through a series of processes step by step, like the wire in the manufacture of needles, which passes through the hands of 72 and sometimes even 92 different detail workmen.	Die zweite Art der Manufaktur, ihre vollendete Form, produziert Machwerke, die zusammenhängende Entwicklungsphasen, eine Reihenfolge von Stufenprozessen durchlaufen, wie z.B. der Draht in der Nähnadelmanufaktur die Hände von 72 und selbst 92 spezifischen Teilarbeitern durchläuft.	ch14_clean.en-ch14_clean.de
In so far as such a manufacture, when first started, combines scattered handicrafts, it lessens the space by which the various phases of production are separated from each other.	Soweit solche Manufaktur ursprünglich zerstreute Handwerke kombiniert, vermindert sie die räumliche Trennung zwischen den besondren Produktionsphasen des Machwerks.	ch14_clean.en-ch14_clean.de
The time taken in passing from one stage to another is shortened, so is the labour that effectuates this passage.	Die Zeit seines Übergangs aus einem Stadium in das andre wird verkürzt, ebenso die Arbeit, welche diese Übergänge vermittelt.	ch14_clean.en-ch14_clean.de
In comparison with a handicraft, productive power is gained, and this gain is owing to the general co-operative character of manufacture.	Im Vergleich zum Handwerk wird so Produktivkraft gewonnen, und zwar entspringt dieser Gewinn aus dem allgemeinen kooperativen Charakter der Manufaktur.	ch14_clean.en-ch14_clean.de
On the other hand, division of labour, which is the distinguishing principle of manufacture, requires the isolation of the various stages of production and their independence of each other.	Andrerseits bedingt ihr eigentümliches Prinzip der Teilung der Arbeit eine Isolierung der verschiednen Produktionsphasen, die als ebenso viele handwerksmäßige Teilarbeiten gegeneinander verselbständigt sind.	ch14_clean.en-ch14_clean.de
The establishment and maintenance of a connexion between the isolated functions necessitates the incessant transport of the article from one hand to another, and from one process to another.	Die Herstellung und Erhaltung des Zusammenhangs zwischen den isolierten Funktionen ernötigt beständigen Transport des Machwerks aus einer Hand in die andre und aus einem Prozeß in den andren.	ch14_clean.en-ch14_clean.de
From the standpoint of modern mechanical industry, this necessity stands forth as a characteristic and costly disadvantage, and one that is immanent in the principle of manufacture.	Vom Standpunkt der großen Industrie tritt dies als eine charakteristische, kostspielige und dem Prinzip der Manufaktur immanente Beschränktheit hervor.	ch14_clean.en-ch14_clean.de
If we confine our attention to some particular lot of raw materials, of rags, for instance, in paper manufacture, or of wire in needle manufacture, we perceive that it passes in succession through a series of stages in the hands of the various detail workmen until completion.	Betrachtet man ein bestimmtes Quantum Rohmaterial, z.B. von Lumpen in der Papiermanufaktur oder von Draht in der Nadelmanufaktur, so durchläuft es in den Händen der verschiednen Teilarbeiter eine zeitliche Stufenfolge von Produktionsphasen bis zu seiner Schlußgestalt.	ch14_clean.en-ch14_clean.de
On the other hand, if we look at the workshop as a whole, we see the raw material in all the stages of its production at the same time.	Betrachtet man dagegen die Werkstatt als einen Gesamtmechanismus, so befindet sich das Rohmaterial gleichzeitig in allen seinen Produktionsphasen auf einmal.	ch14_clean.en-ch14_clean.de
The collective labourer, with one set of his many hands armed with one kind of tools, draws the wire, with another set, armed with different tools, he, at the same time, straightens it, with another, he cuts it, with another, points it, and so on.	Mit einem Teil seiner vielen instrumentbewaffneten Hände zieht der aus den Detailarbeiten kombinierte Gesamtarbeiter den Draht, während er gleichzeitig mit andren Händen und Werkzeugen ihn streckt, mit andren schneidet, spitzt etc. Aus einem zeitlichen Nacheinander sind die verschiednen Stufenprozesse in ein räumliches Nebeneinander verwandelt.	ch14_clean.en-ch14_clean.de
The different detail processes, which were successive in time, have become simultaneous, go on side by side in space.	Daher Lieferung von mehr fertiger Ware in demselben Zeitraum.	ch14_clean.en-ch14_clean.de
Hence, production of a greater quantum of finished commodities in a given time. This simultaneity, it is true, is due to the general co-operative form of the process as a whole; but Manufacture not only finds the conditions for co-operation ready to hand, it also, to some extent, creates them by the sub-division of handicraft labour.	Jene Gleichzeitigkeit entspringt zwar aus der allgemeinen kooperativen Form des Gesamtprozesses, aber die Manufaktur findet nicht nur die Bedingungen der Kooperation vor, sondern schafft sie teilweise erst durch die Zerlegung der handwerksmäßigen Tätigkeit.	ch14_clean.en-ch14_clean.de
On the other hand, it accomplishes this social organisation of the labour-process only by riveting each labourer to a single fractional detail.	Andrerseits erreicht sie diese gesellschaftliche Organisation des Arbeitsprozesses nur durch Festschmieden desselben Arbeiters an dasselbe Detail.	ch14_clean.en-ch14_clean.de
Since the fractional product of each detail labourer is, at the same time, only a particular stage in the development of one and the same finished article, each labourer, or each group of labourers, prepares the raw material for another labourer or group.	Da das Teilprodukt jedes Teilarbeiters zugleich nur eine besondre Entwicklungsstufe desselben Machwerks ist, liefert ein Arbeiter dem andren oder eine Arbeitergruppe der andern ihr Rohmaterial.	ch14_clean.en-ch14_clean.de
The result of the labour of the one is the starting-point for the labour of the other.	Das Arbeitsresultat des einen bildet den Ausgangspunkt für die Arbeit des andren.	ch14_clean.en-ch14_clean.de
The one workman therefore gives occupation directly to the other.	Der eine Arbeiter beschäftigt daher hier unmittelbar den andren.	ch14_clean.en-ch14_clean.de
The labour-time necessary in each partial process, for attaining the desired effect, is learnt by experience; and the mechanism of Manufacture, as a whole, is based on the assumption that a given result will be obtained in a given time.	Die notwendige Arbeitszeit zur Erreichung des bezweckten Nutzeffekts in jedem Teilprozeß wird erfahrungsmäßig festgestellt, und der Gesamtmechanismus der Manufaktur beruht auf der Voraussetzung, daß in gegebner Arbeitszeit ein gegebnes Resultat erzielt wird.	ch14_clean.en-ch14_clean.de
It is only on this assumption that the various supplementary labour-processes can proceed uninterruptedly, simultaneously, and side by side.	Nur unter dieser Voraussetzung können die verschiednen, einander ergänzenden Arbeitsprozesse ununterbrochen, gleichzeitig und räumlich nebeneinander fortgehn.	ch14_clean.en-ch14_clean.de
It is clear that this direct dependence of the operations, and therefore of the labourers, on each other, compels each one of them to spend on his work no more than the necessary time, and thus a continuity, uniformity, regularity, order, and even intensity of labour, of quite a different kind, is begotten than is to be found in an independent handicraft or even in simple co-operation.	Es ist klar, daß diese unmittelbare Abhängigkeit der Arbeiten und daher der Arbeiter voneinander jeden einzelnen zwingt, nur die notwendige Zeit zu seiner Funktion zu verwenden, und so eine ganz andre Kontinuität, Gleichförmigkeit, Regelmäßigkeit, Ordnung und namentlich auch Intensität der Arbeit erzeugt wird als im unabhängigen Handwerk oder selbst der einfachen Kooperation.	ch14_clean.en-ch14_clean.de
The rule, that the labour-time expended on a commodity should not exceed that which is socially necessary for its production, appears, in the production of commodities generally, to be established by the mere effect of competition; since, to express ourselves superficially, each single producer is obliged to sell his commodity at its market-price.	Daß auf eine Ware nur die zu ihrer Herstellung gesellschaftlich notwendige Arbeitszeit verwandt wird, erscheint bei der Warenproduktion überhaupt als äußrer Zwang der Konkurrenz, weil, oberflächlich ausgedrückt, jeder einzelne Produzent die Ware zu ihrem Marktpreis verkaufen muß.	ch14_clean.en-ch14_clean.de
In Manufacture, on the contrary, the turning out of a given quantum of product in a given time is a technical law of the process of production itself.	Lieferung von gegebnem Produktenquantum in gegebner Arbeitszeit wird dagegen in der Manufaktur technisches Gesetz des Produktionsprozesses selbst.	ch14_clean.en-ch14_clean.de
Different operations take, however, unequal periods, and yield therefore, in equal times unequal quantities of fractional products.	Verschiedne Operationen bedürfen jedoch ungleicher Zeitlängen und liefern daher in gleichen Zeiträumen ungleiche Quanta von Teilprodukten.	ch14_clean.en-ch14_clean.de
If, therefore, the same labourer has, day after day, to perform the same operation, there must be a different number of labourers for each operation; for instance, in type manufacture, there are four founders and two breakers to one rubber: the founder casts 2, type an hour, the breaker breaks up 4,000, and the rubber polishes 8,000.	Soll also derselbe Arbeiter tagaus, tagein stets nur dieselbe Operation verrichten, so müssen für verschiedne Operationen verschiedne Verhältniszahlen von Arbeitern verwandt werden, z.B. 4 Gießer und 2 Abbrecher auf einen Frottierer in einer Typenmanufaktur, wo der Gießer stündlich 2.000 Typen gießt, der Abbrecher 4.000 abbricht und der Frottierer 8.000 blank reibt.	ch14_clean.en-ch14_clean.de
Here we have again the principle of co-operation in its simplest form, the simultaneous employment of many doing the same thing; only now, this principle is the expression of an organic relation.	Hier kehrt das Prinzip der Kooperation in seiner einfachsten Form zurück, gleichzeitige Beschäftigung vieler, die Gleichartiges tun, aber jetzt als Ausdruck eines organischen Verhältnisses.	ch14_clean.en-ch14_clean.de
The division of labour, as carried out in Manufacture, not only simplifies and multiplies the qualitatively different parts of the social collective labourer, but also creates a fixed mathematical relation or ratio which regulates the quantitative extent of those parts i.e., the relative number of labourers, or the relative size of the group of labourers, for each detail operation.	Die manufakturmäßige Teilung der Arbeit vereinfacht und vermannigfacht also nicht nur die qualitativ unterschiednen Organe des gesellschaftlichen Gesamtarbeiters, sondern schafft auch ein mathematisch festes Verhältnis für den quantitativen Umfang dieser Organe, d.h. für die relative Arbeiterzahl oder relative Größe der Arbeitergruppen in jeder Sonderfunktion.	ch14_clean.en-ch14_clean.de
It develops, along with the qualitative sub-division of the social labour-process, a quantitative rule and proportionality for that process.	Sie entwickelt mit der qualitativen Gliederung die quantitative Regel und Proportionalität des gesellschaftlichen Arbeitsprozesses.	ch14_clean.en-ch14_clean.de
When once the most fitting proportion has been experimentally established for the numbers of the detail labourers in the various groups when producing on a given scale, that scale can be extended only by employing a multiple of each particular group.	Ist die passendste Verhältniszahl der verschiednen Gruppen von Teilarbeitern erfahrungsmäßig festgesetzt für eine bestimmte Stufenleiter der Produktion, so kann man diese Stufenleiter nur ausdehnen, indem man ein Multipel jeder besondren Arbeitergruppe verwendet.	ch14_clean.en-ch14_clean.de
There is this to boot, that the same individual can do certain kinds of work just as well on a large as on a small scale; for instance, the labour of superintendence, the carriage of the fractional product from one stage to the next, &c. The isolation of such functions, their allotment to a particular labourer, does not become advantageous till after an increase in the number of labourers employed; but this increase must affect every group proportionally.	Es kommt hinzu, daß dasselbe Individuum gewisse Arbeiten ebensogut auf größerer als kleinerer Staffel ausführt, z.B. die Arbeit der Oberaufsicht, den Transport der Teilprodukte aus einer Produktionsphase in die andre usw. Die Verselbständigung dieser Funktionen oder ihre Zuweisung an besondre Arbeiter wird also erst vorteilhaft mit Vergrößrung der beschäftigten Arbeiterzahl, aber diese Vergrößrung muß sofort alle Gruppen proportionell ergreifen.	ch14_clean.en-ch14_clean.de
The isolated group of labourers to whom any particular detail function is assigned, is made up of homogeneous elements, and is one of the constituent parts of the total mechanism.	Die einzelne Gruppe, eine Anzahl von Arbeitern, die dieselbe Teilfunktion verrichten, besteht aus homogenen Elementen und bildet ein besondres Organ des Gesamtmechanismus.	ch14_clean.en-ch14_clean.de
In many manufactures, however, the group itself is an organised body of labour, the total mechanism being a repetition or multiplication of these elementary organisms.	In verschiednen Manufakturen jedoch ist die Gruppe selbst ein gegliederter Arbeitskörper, während der Gesamtmechanismus durch die Wiederholung oder Vervielfältigung dieser produktiven Elementarorganismen gebildet wird.	ch14_clean.en-ch14_clean.de
Take, for instance, the manufacture of glass bottles.	Nehmen wir z.B. die Manufaktur von Glasflaschen.	ch14_clean.en-ch14_clean.de
It may be resolved into three essentially different stages.	Sie zerfällt in drei wesentlich unterschiedne Phasen.	ch14_clean.en-ch14_clean.de
First, the preliminary stage, consisting of the preparation of the components of the glass, mixing the sand and lime, &c., and melting them into a fluid mass of glass.		ch14_clean.en-ch14_clean.de
Various detail labourers are employed in this first stage, as also in the final one of removing the bottles from the drying furnace, sorting and packing them, &c.	Erstens die vorbereitende Phase, wie Bereitung der Glaskomposition, Mengung von Sand, Kalk usw. und Schmelzung dieser Komposition zu einer flüssigen Glasmasse.	ch14_clean.en-ch14_clean.de
In the middle, between these two stages, comes the glass melting proper, the manipulation of the fluid mass.	In der ersten Phase sind verschiedne Teilarbeiter beschäftigt, ebenso in der Schlußphase, der Entfernung der Flaschen aus den Trockenöfen, ihrer Sortierung, Verpackung usw. Zwischen beiden Phasen steht in der Mitte die eigentliche Glasmacherei oder Verarbeitung der flüssigen Glasmasse.	ch14_clean.en-ch14_clean.de
At each mouth of the furnace, there works a group, called “the hole,” consisting of one bottlemaker or finisher, one blower, one gatherer, one putter-up or whetter-off, and one taker-in.	An demselben Munde eines Glasofens arbeitet eine Gruppe, die in England das "hole" (Loch) heißt und aus einem bottle maker oder finischer, einem blower, einem gatherer, einem putter up oder whetter off und einem taker in <Flaschenmacher oder Fertigmacher, einem Bläser, einem Anfänger, einem Aufstapler oder Absprenger und einem Abträger> zusammengesetzt ist.	ch14_clean.en-ch14_clean.de
These five detail workers are so many special organs of a single working organism that acts only as a whole, and therefore can operate only by the direct co-operation of the whole five.	Diese fünf Teilarbeiter bilden ebenso viele Sonderorgane eines einzigen Arbeitskörpers, der nur als Einheit, also nur durch unmittelbare Kooperation der fünf wirken kann.	ch14_clean.en-ch14_clean.de
The whole body is paralysed if but one of its members be wanting.	Fehlt ein Glied des fünfteiligen Körpers, so ist er paralysiert.	ch14_clean.en-ch14_clean.de
But a glass furnace has several openings (in England from 4 to 6), each of which contains an earthenware melting-pot full of molten glass, and employs a similar five-membered group of workers.	Derselbe Glasofen hat aber verschiedne Öffnungen, in England z.B. 4-6, deren jede einen irdenen Schmelztiegel mit flüssigem Glas birgt und wovon jede eine eigne Arbeitergruppe von derselben fünfgliedrigen Form beschäftigt.	ch14_clean.en-ch14_clean.de
The organisation of each group is based on division of labour, but the bond between the different groups is simple co-operation, which, by using in common one of the means of production, the furnace, causes it to be more economically consumed.	Die Gliederung jeder einzelnen Gruppe beruht hier unmittelbar auf der Teilung der Arbeit, während das Band zwischen den verschiednen gleichartigen Gruppen einfache Kooperation ist, die eins der Produktionsmittel, hier den Glasofen, durch gemeinsamen Konsum ökonomischer verbraucht.	ch14_clean.en-ch14_clean.de
Such a furnace, with its 4- groups, constitutes a glass house; and a glass manufactory comprises a number of such glass houses, together with the apparatus and workmen requisite for the preparatory and final stages.	Ein solcher Glasofen mit seinen 4-6 Gruppen bildet eine Glashütte, und eine Glasmanufaktur umfaßt eine Mehrzahl solcher Hütten, zugleich mit den Vorrichtungen und Arbeitern für die einleitenden und abschließenden Produktionsphasen.	ch14_clean.en-ch14_clean.de
Finally, just as Manufacture arises in part from the combination of various handicrafts, so, too, it develops into a combination of various manufactures.	Endlich kann die Manufaktur, wie sie teilweis aus der Kombination verschiedner Handwerke entspringt, sich zu einer Kombination verschiedner Manufakturen entwickeln.	ch14_clean.en-ch14_clean.de
The larger English glass manufacturers, for instance, make their own earthenware melting-pots, because, on the quality of these depends, to a great extent, the success or failure of the process.	Die größren englischen Glashütten z.B. fabrizieren ihre irdenen Schmelztiegel selbst, weil von deren Güte das Gelingen oder Mißlingen des Produkts wesentlich abhängt.	ch14_clean.en-ch14_clean.de
The manufacture of one of the means of production is here united with that of the product.	Die Manufaktur eines Produktionsmittels wird hier mit der Manufaktur des Produkts verbunden.	ch14_clean.en-ch14_clean.de
On the other hand, the manufacture of the product may be united with other manufactures, of which that product is the raw material, or with the products of which it is itself subsequently mixed.	Umgekehrt kann die Manufaktur des Produkts verbunden werden mit Manufakturen, worin es selbst wieder als Rohmaterial dient oder mit deren Produkten es später zusammengesetzt wird.	ch14_clean.en-ch14_clean.de
Thus, we find the manufacture of flint glass combined with that of glass cutting and brass founding; the latter for the metal settings of various articles of glass.	So findet man z.B. die Manufaktur von Flintglas kombiniert mit der Glasschleiferei und der Gelbgießerei, letztre für die metallische Einfassung mannigfacher Glasartikel.	ch14_clean.en-ch14_clean.de
The various manufactures so combined form more or less separate departments of a larger manufacture, but are at the same time independent processes, each with its own division of labour.	Die verschiednen kombinierten Manufakturen bilden dann mehr oder minder räumlich getrennte Departemente einer Gesamtmanufaktur, zugleich voneinander unabhängige Produktionsprozesses, jeder mit eigner Teilung der Arbeit.	ch14_clean.en-ch14_clean.de
In spite of the many advantages offered by this combination of manufactures, it never grows into a complete technical system on its own foundation.	Trotz mancher Vorteile, welche die kombinierte Manufaktur bietet, gewinnt sie, auf eigner Grundlage, keine wirklich technische Einheit.	ch14_clean.en-ch14_clean.de
That happens only on its transformation into an industry carried on by machinery.	Diese entsteht erst bei ihrer Verwandlung in den maschinenmäßigen Betrieb.	ch14_clean.en-ch14_clean.de
Early in the manufacturing period, the principle of lessening the necessary labour-time in the production of commodities16, was accepted and formulated: and the use of machines, especially for certain simple first processes that have to be conducted on a very large scale, and with the application of great force, sprang up here and there.	Die Manufakturperiode, welche Verminderung der zur Warenproduktion notwendigen Arbeitszeit bald als bewußtes Prinzip ausspricht , entwickelt sporadisch auch den Gebrauch von Maschinen, namentlich für gewisse einfache erste Prozesse, die massenhaft und mit großem Kraftaufwand auszuführen sind.	ch14_clean.en-ch14_clean.de
Thus, at an early period in paper manufacture, the tearing up of the rags was done by paper-mills; and in metal works, the pounding of the ores was effected by stamping mills.	So wird z.B. bald in der Papiermanufaktur das Zermalmen der Lumpen durch Papiermühlen und in der Metallurgie das Zerstoßen der Erze durch sogenannte Pochmühlen verrichtet.	ch14_clean.en-ch14_clean.de
The Roman Empire had handed down the elementary form of all machinery in the water-wheel.	Die elementarische Form aller Maschinerie hatte das römische Kaiserreich überliefert in der Wassermühle.	ch14_clean.en-ch14_clean.de
The handicraft period bequeathed to us the great inventions of the compass, of gunpowder, of type-printing, and of the automatic clock.	Die Handwerksperiode vermachte die großen Erfindungen des Kompasses, des Pulvers, der Buchdruckerei und der automatischen Uhr.	ch14_clean.en-ch14_clean.de
But, on the whole, machinery played that subordinate part which Adam Smith assigns to it in comparison with division of labour.	Im großen und ganzen jedoch spielt die Maschinerie jene Nebenrolle, die Adam Smith ihr neben der Teilung der Arbeit anweist.	ch14_clean.en-ch14_clean.de
The sporadic use of machinery in the 17th century was of the greatest importance, because it supplied the great mathematicians of that time with a practical basis and stimulant to the creation of the science of mechanics.	Sehr wichtig wurde die sporadische Anwendung der Maschinerie im 17. Jahrhundert, weil sie den großen Mathematikern jener Zeit praktische Anhaltspunkte und Reizmittel zur Schöpfung der modernen Mechanik darbot.	ch14_clean.en-ch14_clean.de
The collective labourer, formed by the combination of a number of detail labourers, is the machinery specially characteristic of the manufacturing period.	Die spezifische Maschinerie der Manufakturperiode bleibt der aus vielen Teilarbeitern kombinierte Gesamtarbeiter selbst.	ch14_clean.en-ch14_clean.de
The various operations that are performed in turns by the producer of a commodity, and coalesce one with another during the progress of production, lay claim to him in various ways.	Die verschiednen Operationen, die der Produzent einer Ware abwechselnd verrichtet und die sich im Ganzen seines Arbeitsprozesses verschlingen, nehmen ihn verschiedenartig in Anspruch.	ch14_clean.en-ch14_clean.de
In one operation he must exert more strength, in another more skill, in another more attention; and the same individual does not possess all these qualities in an equal degree.	In der einen muß er mehr Kraft entwickeln, in der andren mehr Gewandtheit, in der dritten mehr geistige Aufmerksamkeit usw., und dasselbe Individuum besitzt diese Eigenschaften nicht in gleichem Grad.	ch14_clean.en-ch14_clean.de
After Manufacture has once separated, made independent, and isolated the various operations, the labourers are divided, classified, and grouped according to their predominating qualities.	Nach der Trennung, Verselbständigung und Isolierung der verschiednen Operationen werden die Arbeiter ihren vorwiegenden Eigenschaften gemäß geteilt, klassifiziert und gruppiert.	ch14_clean.en-ch14_clean.de
If their natural endowments are, on the one hand, the foundation on which the division of labour is built up, on the other hand, Manufacture, once introduced, develops in them new powers that are by nature fitted only for limited and special functions.	Bilden ihre Naturbesonderheiten die Grundlage, worauf sich die Teilung der Arbeit pfropft, so entwickelt die Manufaktur, einmal eingeführt, Arbeitskräfte, die von Natur nur zu einseitiger Sonderfunktion taugen.	ch14_clean.en-ch14_clean.de
The collective labourer now possesses, in an equal degree of excellence, all the qualities requisite for production, and expends them in the most economical manner, by exclusively employing all his organs, consisting of particular labourers, or groups of labourers, in performing their special functions.	Der Gesamtarbeiter besitzt jetzt alle produktiven Eigenschaften in gleich hohem Grad der Virtuosität und verausgabt sie zugleich aufs ökonomischste, indem er alle seine Organe, individualisiert in besondren Arbeitern oder Arbeitergruppen, ausschließlich zu ihren spezifischen Funktionen verwendet.	ch14_clean.en-ch14_clean.de
The one-sidedness and the deficiencies of the detail labourer become perfections when he is a part of the collective labourer.	Die Einseitigkeit und selbst die Unvollkommenheit des Teilarbeiters werden zu seiner Vollkommenheit als Glied des Gesamtarbeiters.	ch14_clean.en-ch14_clean.de
The habit of doing only one thing converts him into a never failing instrument, while his connexion with the whole mechanism compels him to work with the regularity of the parts of a machine.	Die Gewohnheit einer einseitigen Funktion verwandelt ihn in ihr naturgemäß sicher wirkendes Organ, während der Zusammenhang des Gesamtmechanismus ihn zwingt, mit der Regelmäßigkeit eines Maschinenteils zu wirken.	ch14_clean.en-ch14_clean.de
Since the collective labourer has functions, both simple and complex, both high and low, his members, the individual labour-powers, require different degrees of training, and must therefore have different values.	Da die verschiednen Funktionen des Gesamtarbeiters einfacher oder zusammengesetzter, niedriger oder höher, erheischen seine Organe, die individuellen Arbeitskräfte, sehr verschiedne Grade der Ausbildung und besitzen daher sehr verschiedne Werte.	ch14_clean.en-ch14_clean.de
Manufacture, therefore, develops a hierarchy of labour-powers, to which there corresponds a scale of wages.	Die Manufaktur entwickelt also eine Hierarchie der Arbeitskräfte, der eine Stufenleiter der Arbeitslöhne entspricht.	ch14_clean.en-ch14_clean.de
If, on the one hand, the individual labourers are appropriated and annexed for life by a limited function; on the other hand, the various operations of the hierarchy are parcelled out among the labourers according to both their natural and their acquired capabilities.	Wird einerseits der individuelle Arbeiter einer einseitigen Funktion angeeignet und lebenslang annexiert, so werden ebensosehr die verschiednen Arbeitsverrichtungen jener Hierarchie der natürlichen und erworbnen Geschicklichkeiten angepaßt.	ch14_clean.en-ch14_clean.de
Every process of production, however, requires certain simple manipulations, which every man is capable of doing.	Jeder Produktionsprozeß bedingt indes gewisse einfache Hantierungen, deren jeder Mensch, wie er geht und steht, fähig ist.	ch14_clean.en-ch14_clean.de
They too are now severed from their connexion with the more pregnant moments of activity, and ossified into exclusive functions of specially appointed labourers.	Auch sie werden jetzt von ihrem flüssigen Zusammenhang mit den inhaltvollern Momenten der Tätigkeit losgelöst und zu ausschließlichen Funktionen verknöchert.	ch14_clean.en-ch14_clean.de
Hence, Manufacture begets, in every handicraft that it seizes upon, a class of so-called unskilled labourers, a class which handicraft industry strictly excluded.	Die Manufaktur erzeugt daher in jedem Handwerk, das sie ergreift, eine Klasse sogenannter ungeschickter Arbeiter, die der Handwerksbetrieb streng ausschloß.	ch14_clean.en-ch14_clean.de
If it develops a one-sided speciality into a perfection, at the expense of the whole of a man’s working capacity, it also begins to make a speciality of the absence of all development.	Wenn sie die durchaus vereinseitigte Spezialität auf Kosten des ganzen Arbeitsvermögens zur Virtuosität entwickelt, beginnt sie auch schon den Mangel aller Entwicklung zu einer Spezialität zu machen.	ch14_clean.en-ch14_clean.de
Alongside of the hierarchic gradation there steps the simple separation of the labourers into skilled and unskilled.	Neben die hierarchische Abstufung tritt die einfache Scheidung der Arbeiter in geschickte und ungeschickte.	ch14_clean.en-ch14_clean.de
For the latter, the cost of apprenticeship vanishes; for the former, it diminishes, compared with that of artificers, in consequence of the functions being simplified.	Für letztre fallen die Erlernungskosten ganz weg, für erstre sinken sie, im Vergleich zum Handwerker, infolge vereinfachter Funktion.	ch14_clean.en-ch14_clean.de
In both cases the value of labour-power falls.	In beiden Fällen sinkt der Wert der Arbeitskraft.	ch14_clean.en-ch14_clean.de
An exception to this law holds good whenever the decomposition of the labour-process begets new and comprehensive functions, that either had no place at all, or only a very modest one, in handicrafts.	Ausnahme findet statt, soweit die Zersetzung des Arbeitsprozesses neue zusammenfassende Funktionen erzeugt, die im Handwerksbetrieb gar nicht oder nicht in demselben Umfang vorkamen.	ch14_clean.en-ch14_clean.de
The fall in the value of labour-power, caused by the disappearance or diminution of the expenses of apprenticeship, implies a direct increase of surplus-value for the benefit of capital; for everything that shortens the necessary labour-time required for the reproduction of labour-power, extends the domain of surplus labour.	Die relative Entwertung der Arbeitskraft, die aus dem Wegfall oder der Verminderung der Erlernungskosten entspringt, schließt unmittelbar höhere Verwertung des Kapitals ein, denn alles, was die zur Reproduktion der Arbeitskraft notwendige Zeit verkürzt, verlängert die Domäne der Mehrarbeit.	ch14_clean.en-ch14_clean.de
Section 4: Division of Labour in Manufacture, and Division of Labour in Society We first considered the origin of Manufacture, then its simple elements, then the detail labourer and his implements, and finally, the totality of the mechanism.	4. Teilung der Arbeit innerhalb der Manufaktur und Teilung der Arbeit innerhalb der Gesellschaft Wir betrachteten erst den Ursprung der Manufaktur, dann ihre einfachen Elemente, den Teilarbeiter und sein Werkzeug, endlich ihren Gesamtmechanismus.	ch14_clean.en-ch14_clean.de
We shall now lightly touch upon the relation between the division of labour in manufacture, and the social division of labour, which forms the foundation of all production of commodities.	Wir berühren jetzt kurz das Verhältnis zwischen der manufakturmäßigen Teilung der Arbeit und der gesellschaftlichen Teilung der Arbeit, welche die allgemeine Grundlage aller Warenproduktion bildet.	ch14_clean.en-ch14_clean.de
If we keep labour alone in view, we may designate the separation of social production into its main divisions or genera – viz., agriculture, industries, &c., as division of labour in general, and the splitting up of these families into species and sub-species, as division of labour in particular, and the division of labour within the workshop as division of labour in singular or in detail.	Hält man nur die Arbeit selbst im Auge, so kann man die Trennung der gesellschaftlichen Produktion in ihre großen Gattungen, wie Agrikultur, Industrie usw., als Teilung der Arbeit im allgemeinen, die Sonderung dieser Produktionsgattungen in Arten und Unterarten als Teilung der Arbeit im besondren, und die Teilung der Arbeit innerhalb einer Werkstatt als Teilung der Arbeit im einzelnen bezeichnen.	ch14_clean.en-ch14_clean.de
Division of labour in a society, and the corresponding tying down of individuals to a particular calling, develops itself, just as does the division of labour in manufacture, from opposite starting-points.	Die Teilung der Arbeit innerhalb der Gesellschaft und die entsprechende Beschränkung der Individuen auf besondre Berufssphären entwickelt sich, wie die Teilung der Arbeit innerhalb der Manufaktur, von entgegengesetzten Ausgangspunkten.	ch14_clean.en-ch14_clean.de
Within a family, and after further development within a tribe, there springs up naturally a division of labour, caused by differences of sex and age, a division that is consequently based on a purely physiological foundation, which division enlarges its materials by the expansion of the community, by the increase of population, and more especially, by the conflicts between different tribes, and the subjugation of one tribe by another.	Innerhalb einer Familie (50a), weiter entwickelt eines Stammes, entspringt eine naturwüchsige Teilung der Arbeit aus den Geschlechts- und Alterverschiedenheiten, also auf rein physiologischer Grundlage, die mit der Ausdehnung des Gemeinwesens, der Zunahme der Bevölkerung und namentlich dem Konflikt zwischen verschiednen Stämmen und der Unterjochung eines Stamms durch den andren ihr Material ausweitet.	ch14_clean.en-ch14_clean.de
On the other hand, as I have before remarked, the exchange of products springs up at the points where different families, tribes, communities, come in contact; for, in the beginning of civilisation, it is not private individuals but families, tribes, &c., that meet on an independent footing.	Andrerseits, wie ich früher bemerkt , entspringt der Produktenaustausch an den Punkten, wo verschiedne Familien, Stämme, Gemeinwesen in Kontakt kommen, denn nicht Privatpersonen sondern Familien, Stämme usw. treten sich in den Anfängen der Kultur selbständig gegenüber.	ch14_clean.en-ch14_clean.de
Different communities find different means of production, and different means of subsistence in their natural environment.	Verschiedne Gemeinwesen finden verschiedne Produktionsmittel und verschiedne Lebensmittel in ihrer Naturumgebung vor.	ch14_clean.en-ch14_clean.de
Hence, their modes of production, and of living, and their products are different.	Ihre Produktionsweise, Lebensweise und Produkte sind daher verschieden.	ch14_clean.en-ch14_clean.de
It is this spontaneously developed difference which, when different communities come in contact, calls forth the mutual exchange of products, and the consequent gradual conversion of those products into commodities.	Es ist diese naturwüchsige Verschiedenheit, die bei dem Kontakt der Gemeinwesen den Austausch der wechselseitigen Produkte und daher die allmähliche Verwandlung dieser Produkte in Waren hervorruft.	ch14_clean.en-ch14_clean.de
Exchange does not create the differences between the spheres of production, but brings what are already different into relation, and thus converts them into more or less inter-dependent branches of the collective production of an enlarged society.	Der Austausch schafft nicht den Unterschied der Produktionssphären, sondern setzt die unterschiednen in Beziehung und verwandelt sie so in mehr oder minder voneinander abhängige Zweige einer gesellschaftlichen Gesamtproduktion.	ch14_clean.en-ch14_clean.de
In the latter case, the social division of labour arises from the exchange between spheres of production, that are originally distinct and independent of one another.	Hier entsteht die gesellschaftliche Teilung der Arbeit durch den Austausch ursprünglich verschiedner, aber voneinander unabhängiger Produktionssphären.	ch14_clean.en-ch14_clean.de
In the former, where the physiological division of labour is the starting-point, the particular organs of a compact whole grow loose, and break off, principally owing to the exchange of commodities with foreign communities, and then isolate themselves so far, that the sole bond, still connecting the various kinds of work, is the exchange of the products as commodities.	Dort, wo die physiologische Teilung der Arbeit den Ausgangspunkt bildet, lösen sich die besondren Organe eines unmittelbar zusammengehörigen Ganzen voneinander ab, zersetzen sich, zu welchem Zersetzungsprozeß der Warenaustausch mit fremden Gemeinwesen den Hauptanstoß gibt, und verselbständigen sich bis zu dem Punkt, wo der Zusammenhang der verschiednen Arbeiten durch den Austausch der Produkte als Waren vermittelt wird.	ch14_clean.en-ch14_clean.de
In the one case, it is the making dependent what was before independent; in the other case, the making independent what was before dependent.	Es ist in dem einen Fall Verunselbständigung der früher Selbständigen, in dem andren Verselbständigung der früher Unselbständigen.	ch14_clean.en-ch14_clean.de
The foundation of every division of labour that is well developed, and brought about by the exchange of commodities, is the separation between town and country.	Die Grundlage aller entwickelten und durch Warenaustausch vermittelten Teilung der Arbeit ist die Scheidung von Stadt und Land.	ch14_clean.en-ch14_clean.de
It may be said, that the whole economic history of society is summed up in the movement of this antithesis. We pass it over, however, for the present.	Man kann sagen, daß die ganze ökonomische Geschichte der Gesellschaft sich in der Bewegung dieses Gegensatzes resümiert, auf den wir jedoch hier nicht weiter eingehn.	ch14_clean.en-ch14_clean.de
Just as a certain number of simultaneously employed labourers are the material pre-requisites for division of labour in manufacture, so are the number and density of the population, which here correspond to the agglomeration in one workshop, a necessary condition for the division of labour in society.	Wie für die Teilung der Arbeit innerhalb der Manufaktur eine gewisse Anzahl gleichzeitig angewandter Arbeiter die materielle Voraussetzung bildet, so für die Teilung der Arbeit innerhalb der Gesellschaft die Größe der Bevölkerung und ihre Dichtigkeit, die hier an die Stelle der Agglomeration in derselben Werkstatt tritt.	ch14_clean.en-ch14_clean.de
Nevertheless, this density is more or less relative.	Indes ist diese Dichtigkeit etwas Relatives.	ch14_clean.en-ch14_clean.de
A relatively thinly populated country, with well-developed means of communication, has a denser population than a more numerously populated country, with badly-developed means of communication; and in this sense the Northern States of the American Union, for instance, are more thickly populated than India.	Ein relativ spärlich bevölkertes Land mit entwickelten Kommunikationsmitteln besitzt eine dichtere Bevölkerung als ein mehr bevölkertes Land mit unentwickelten Kommunikationsmitteln, und in dieser Art sind z.B. die nördlichen Staaten der amerikanischen Union dichter bevölkert als Indien.	ch14_clean.en-ch14_clean.de
Since the production and the circulation of commodities are the general pre-requisites of the capitalist mode of production, division of labour in manufacture demands, that division of labour in society at large should previously have attained a certain degree of development.	Da Warenproduktion und Warenzirkulation die allgemeine Voraussetzung der kapitalistischen Produktionsweise, erheischt manufakturmäßige Teilung der Arbeit eine schon bis zu gewissem Entwicklungsgrad gereifte Teilung der Arbeit im Innern der Gesellschaft.	ch14_clean.en-ch14_clean.de
Inversely, the former division reacts upon and develops and multiplies the latter.	Umgekehrt entwickelt und vervielfältigt die manufakturmäßige Teilung der Arbeit rückwirkend jene gesellschaftliche Teilung der Arbeit.	ch14_clean.en-ch14_clean.de
Simultaneously, with the differentiation of the instruments of labour, the industries that produce these instruments, become more and more differentiated.	Mit der Differenzierung der Arbeitsinstrumente differenzieren sich mehr und mehr die Gewerbe, welche diese Instrumente produzieren.	ch14_clean.en-ch14_clean.de
If the manufacturing system seize upon an industry, which, previously, was carried on in connexion with others, either as a chief or as a subordinate industry, and by one producer, these industries immediately separate their connexion, and become independent.	Ergreift der manufakturmäßige Betrieb ein Gewerb, das bisher als Haupt- oder Nebengewerb mit andren zusammenhing und von demselben Produzenten ausgeführt wurde, so findet sofort Scheidung und gegenseitige Verselbständigung statt.	ch14_clean.en-ch14_clean.de
If it seize upon a particular stage in the production of a commodity, the other stages of its production become converted into so many independent industries.	Ergreift er eine besondre Produktionsstufe einer Ware, so verwandeln sich ihre verschiednen Produktionsstufen in verschiedne unabhängige Gewerbe.	ch14_clean.en-ch14_clean.de
It has already been stated, that where the finished article consists merely of a number of parts fitted together, the detail operations may re-establish themselves as genuine and separate handicrafts.	Es ward bereits angedeutet, daß, wo das Machwerk ein bloß mechanisch zusammengesetztes Ganze von Teilprodukten, die Teilarbeiten sich selbst wieder zu eignen Handwerken verselbständigen können.	ch14_clean.en-ch14_clean.de
In order to carry out more perfectly the division of labour in manufacture, a single branch of production is, according to the varieties of its raw material, or the various forms that one and the same raw material may assume, split up into numerous, and to some extent, entirely new manufactures.	Um die Teilung der Arbeiter vollkommner innerhalb einer Manufaktur auszuführen, wird derselbe Produktionszweig, je nach der Verschiedenheit seiner Rohstoffe oder der verschiednen Formen, die derselbe Rohstoff erhalten kann, in verschiedne, zum Teil ganz neue Manufakturen gespaltet.	ch14_clean.en-ch14_clean.de
Accordingly, in France alone, in the first half of the 18th century, over 100 different kinds of silk stuffs were woven, and, in Avignon, it was law, that “every apprentice should devote himself to only one sort of fabrication, and should not learn the preparation of several kinds of stuff at once.”	So wurden bereits in der ersten Hälfte des 18. Jahrhunderts in Frankreich allein über 100 verschiedenartige Seidenzeuge gewebt, und in Avignon z.B. war es Gesetz, daß "jeder Lehrling sich immer nur einer Fabrikationsart widmen und nicht die Verfertigung mehrerer Zeugarten zugleich lernen durfte".	ch14_clean.en-ch14_clean.de
The territorial division of labour, which confines special branches of production to special districts of a country, acquires fresh stimulus from the manufacturing system, which exploits every special advantage.	Die territoriale Teilung der Arbeit, welche besondre Produktionszweige an besondre Distrikte eines Landes bannt, erhält neuen Anstoß durch den manufakturmäßigen Betrieb, der alle Besonderheiten ausbeutet.	ch14_clean.en-ch14_clean.de
The Colonial system and the opening out of the markets of the world, both of which are included in the general conditions of existence of the manufacturing period, furnish rich material for developing the division of labour in society.	Reiches Material zur Teilung der Arbeit innerhalb der Gesellschaft liefert der Manufakturperiode die Erweiterung des Weltmarkts und das Kolonialsystem, die zum Umkreis ihrer allgemeinen Existenzbedingungen gehören.	ch14_clean.en-ch14_clean.de
It is not the place, here, to go on to show how division of labour seizes upon, not only the economic, but every other sphere of society, and everywhere lays the foundation of that all engrossing system of specialising and sorting men, that development in a man of one single faculty at the expense of all other faculties, which caused A. Ferguson, the master of Adam Smith, to exclaim: “We make a nation of Helots, and have no free citizens.”	Es ist hier nicht der Ort, weiter nachzuweisen, wie sie neben der ökonomischen jede andre Sphäre der Gesellschaft ergreift und überall die Grundlage zu jener Ausbildung des Fachwesens, der Spezialitäten, und einer Parzellierung des Menschen legt, die schon A. Ferguson, den Lehrer A. Smiths, in den Ausruf ausbrechen ließ: "Wir machen eine Nation von Heloten, und es gibt keine Freien unter uns."	ch14_clean.en-ch14_clean.de
But, in spite of the numerous analogies and links connecting them, division of labour in the interior of a society, and that in the interior of a workshop, differ not only in degree, but also in kind.	Trotz der zahlreichen Analogien jedoch und der Zusammenhänge zwischen der Teilung der Arbeit im Innern der Gesellschaft und der Teilung innerhalb einer Werkstatt sind beide nicht nur graduell, sondern wesentlich unterschieden.	ch14_clean.en-ch14_clean.de
The analogy appears most indisputable where there is an invisible bond uniting the various branches of trade.	Am schlagendsten scheint die Analogie unstreitig, wo ein innres Band verschiedne Geschäftszweige verschlingt.	ch14_clean.en-ch14_clean.de
For instance the cattle-breeder produces hides, the tanner makes the hides into leather, and the shoemaker, the leather into boots.	Der Viehzüchter z.B. produziert Häute, der Gerber verwandelt die Häute in Leder, der Schuster das Leder in Stiefel.	ch14_clean.en-ch14_clean.de
Here the thing produced by each of them is but a step towards the final form, which is the product of all their labours combined.	Jeder produziert hier ein Stufenprodukt, und die letzte fertige Gestalt ist das kombinierte Produkt ihrer Sonderarbeiten.	ch14_clean.en-ch14_clean.de
There are, besides, all the various industries that supply the cattle-breeder, the tanner, and the shoemaker with the means of production.	Es kommen hinzu die mannigfachen Arbeitszweige, die dem Viehzüchter, Gerber, Schuster Produktionsmittel liefern.	ch14_clean.en-ch14_clean.de
Now it is quite possible to imagine, with Adam Smith, that the difference between the above social division of labour, and the division in manufacture, is merely subjective, exists merely for the observer, who, in a manufacture, can see with one glance, all the numerous operations being performed on one spot, while in the instance given above, the spreading out of the work over great areas, and the great number of people employed in each branch of labour, obscure the connexion.	Man kann sich nun mit A. Smith einbilden, diese gesellschaftliche Teilung der Arbeit unterscheide sich von der manufakturmäßigen nur subjektiv, nämlich für den Beobachter, der hier die mannigfachen Teilarbeiten auf einen Blick räumlich zusammensieht, während dort ihre Zerstreuung über große Flächen und die große Zahl der in jedem Sonderzweig Beschäftigten den Zusammenhang verdunklen.	ch14_clean.en-ch14_clean.de
But what is it that forms the bond between the independent labours of the cattle-breeder, the tanner, and the shoemaker?	Was aber stellt den Zusammenhang her zwischen den unabhängigen Arbeiten von Viehzüchter, Gerber, Schuster?	ch14_clean.en-ch14_clean.de
It is the fact that their respective products are commodities.	Das Dasein ihrer respektiven Produkte als Waren.	ch14_clean.en-ch14_clean.de
What, on the other hand, characterises division of labour in manufactures?	Was charakterisiert dagegen die manufakturmäßige Teilung der Arbeit?	ch14_clean.en-ch14_clean.de
The fact that the detail labourer produces no commodities.	Daß der Teilarbeiter keine Ware produziert.	ch14_clean.en-ch14_clean.de
It is only the common product of all the detail labourers that becomes a commodity.	Erst das gemeinsame Produkt der Teilarbeiter verwandelt sich in Ware.	ch14_clean.en-ch14_clean.de
Division of labour in society is brought about by the purchase and sale of the products of different branches of industry, while the connexion between the detail operations in a workshop, is due to the sale of the labour-power of several workmen to one capitalist, who applies it as combined labour-power.	(58a) Die Teilung der Arbeit im Innern der Gesellschaft ist vermittelt durch den Kauf und Verkauf der Produkte verschiedner Arbeitszweige, der Zusammenhang der Teilarbeiten in der Manufaktur durch den Verkauf verschiedner Arbeitskräfte an denselben Kapitalisten, der sie als kombinierte Arbeitskraft verwendet.	ch14_clean.en-ch14_clean.de
The division of labour in the workshop implies concentration of the means of production in the hands of one capitalist; the division of labour in society implies their dispersion among many independent producers of commodities.	Die manufakturmäßige Teilung der Arbeit unterstellt Konzentration der Produktionsmittel in der Hand eines Kapitalisten, die gesellschaftliche Teilung der Arbeit Zersplitterung der Produktionsmittel unter viele voneinander unabhängige Warenproduzenten.	ch14_clean.en-ch14_clean.de
While within the workshop, the iron law of proportionality subjects definite numbers of workmen to definite functions, in the society outside the workshop, chance and caprice have full play in distributing the producers and their means of production among the various branches of industry.	Statt daß in der Manufaktur das eherne Gesetz der Verhältniszahl oder Proportionalität bestimmte Arbeitermassen unter bestimmte Funktionen subsumiert, treiben Zufall und Willkür ihr buntes Spiel in der Verteilung der Warenproduzenten und ihrer Produktionsmittel unter die verschiednen gesellschaftlichen Arbeitszweige.	ch14_clean.en-ch14_clean.de
The different spheres of production, it is true, constantly tend to an equilibrium: for, on the one hand, while each producer of a commodity is bound to produce a use-value, to satisfy a particular social want, and while the extent of these wants differs quantitatively, still there exists an inner relation which settles their proportions into a regular system, and that system one of spontaneous growth; and, on the other hand, the law of the value of commodities ultimately determines how much of its disposable working-time society can expend on each particular class of commodities.	Zwar suchen sich die verschiednen Produktionssphären beständig ins Gleichgewicht zu setzen, indem einerseits jeder Warenproduzent einen Gebrauchswert produzieren, also ein besondres gesellschaftliches Bedürfnis befriedigen muß, der Umfang dieser Bedürfnisse aber quantitativ verschieden ist und ein innres Band die verschiednen Bedürfnismassen zu einem naturwüchsigen System verkettet; indem andrerseits das Wertgesetz der Waren bestimmt, wieviel die Gesellschaft von ihrer ganzen disponiblen Arbeitszeit auf die Produktion jeder besondren Warenart verausgaben kann.	ch14_clean.en-ch14_clean.de
But this constant tendency to equilibrium, of the various spheres of production, is exercised, only in the shape of a reaction against the constant upsetting of this equilibrium.	Aber diese beständige Tendenz der verschiednen Produktionssphären, sich ins Gleichgewicht zu setzen, betätigt sich nur als Reaktion gegen die beständige Aufhebung dieses Gleichgewichts.	ch14_clean.en-ch14_clean.de
The a priori system on which the division of labour, within the workshop, is regularly carried out, becomes in the division of labour within the society, an a posteriori, nature-imposed necessity, controlling the lawless caprice of the producers, and perceptible in the barometrical fluctuations of the market-prices.	Die bei der Teilung der Arbeit im Innern der Werkstatt a priori und planmäßig befolgte Regel wirkt bei der Teilung der Arbeit im Innern der Gesellschaft nur a posteriori als innre, stumme, im Barometerwechsel der Marktpreise wahrnehmbare, die regellose Willkür der Warenproduzenten überwältigende Naturnotwendigkeit.	ch14_clean.en-ch14_clean.de
Division of labour within the workshop implies the undisputed authority of the capitalist over men, that are but parts of a mechanism that belongs to him. The division of labour within the society brings into contact independent commodity-producers, who acknowledge no other authority but that of competition, of the coercion exerted by the pressure of their mutual interests; just as in the animal kingdom, the bellum omnium contra omnes [war of all against all – Hobbes] more or less preserves the conditions of existence of every species.	Die manufakturmäßige Teilung der Arbeit unterstellt die unbedingte Autorität des Kapitalisten über Menschen, die bloße Glieder eines ihm gehörigen Gesamtmechanismus bilden; die gesellschaftliche Teilung der Arbeit stellt unabhängige Warenproduzenten einander gegenüber, die keine andre Autorität anerkennen als die der Konkurrenz, den Zwang, den der Druck ihrer wechselseitigen Interessen auf sie ausübt, wie auch im Tierreich das bellum omnium contra omnes <der Krieg aller gegen alle> die Existenzbedingungen aller Arten mehr oder minder erhält.	ch14_clean.en-ch14_clean.de
The same bourgeois mind which praises division of labour in the workshop, life-long annexation of the labourer to a partial operation, and his complete subjection to capital, as being an organisation of labour that increases its productiveness that same bourgeois mind denounces with equal vigour every conscious attempt to socially control and regulate the process of production, as an inroad upon such sacred things as the rights of property, freedom and unrestricted play for the bent of the individual capitalist.	Dasselbe bürgerliche Bewußtsein, das die manufakturmäßige Teilung der Arbeit, die lebenslängliche Annexation des Arbeiters an eine Detailverrichtung und die unbedingte Unterordnung der Teilarbeiter unter das Kapital als eine Organisation der Arbeit feiert, welche ihre Produktivkraft steigre, denunziert daher ebenso laut jede bewußte gesellschaftliche Kontrolle und Reglung des gesellschaftliche Produktionsprozesses als einen Eingriff in die unveretzlichen Eigentumsrechte, Freiheit und sich selbst bestimmende "Genialität" des individuellen Kapitalisten.	ch14_clean.en-ch14_clean.de
It is very characteristic that the enthusiastic apologists of the factory system have nothing more damning to urge against a general organisation of the labour of society, than that it would turn all society into one immense factory.	Es ist sehr charakteristisch, daß die begeisterten Apologeten des Fabriksystems nichts Ärgres gegen jede allgemeine Organisation der gesellschaftlichen Arbeit zu sagen wissen, als daß sie die ganze Gesellschaft in eine Fabrik verwandeln würde.	ch14_clean.en-ch14_clean.de
If, in a society with capitalist production, anarchy in the social division of labour and despotism in that of the workshop are mutual conditions the one of the other, we find, on the contrary, in those earlier forms of society in which the separation of trades has been spontaneously developed, then crystallised, and finally made permanent by law, on the one hand, a specimen of the organisation of the labour of society, in accordance with an approved and authoritative plan, and on the other, the entire exclusion of division of labour in the workshop, or at all events a mere dwarflike or sporadic and accidental development of the same.	Wenn die Anarchie der gesellschaftlichen und die Despotie der manufakturmäßigen Arbeitsteilung einander in der Gesellschaft der kapitalistischen Produktionsweise bedingen, bieten dagegen frühere Gesellschaftsformen, worin die Besonderung der Gewerbe sich naturwüchsig entwickelt, dann kristallisiert und endlich gesetzlich befestigt hat, einerseits das Bild einer plan- und autoritätsmäßigen Organisation der gesellschaftlichen Arbeit, während sie anderseits die Teilung der Arbeit innerhalb der Werkstatt ganz ausschließen oder nur auf einem Zwergmaßstab oder nur sporadisch und zufällig entwickeln.	ch14_clean.en-ch14_clean.de
Those small and extremely ancient Indian communities, some of which have continued down to this day, are based on possession in common of the land, on the blending of agriculture and handicrafts, and on an unalterable division of labour, which serves, whenever a new community is started, as a plan and scheme ready cut and dried.	Jene uraltertümlichen, kleinen indischen Gemeinwesen z.B., die zum Teil noch fortexistieren, beruhn auf gemeinschaftlichem Besitz des Grund und Bodens, auf unmittelbarer Verbindung von Agrikultur und Handwerk und auf einer festen Teilung der Arbeit, die bei Anlage neuer Gemeinwesen als gegebner Plan und Grundriß dient.	ch14_clean.en-ch14_clean.de
Occupying areas of from 100 up to several thousand acres, each forms a compact whole producing all it requires.	Sie bilden sich selbst genügende Produktionsganze, deren Produktionsgebiet von 100 bis auf einige 1.000 Acres wechselt.	ch14_clean.en-ch14_clean.de
The chief part of the products is destined for direct use by the community itself, and does not take the form of a commodity. Hence, production here is independent of that division of labour brought about, in Indian society as a whole, by means of the exchange of commodities.	Die Hauptmasse der Produkte wird für den unmittelbaren Selbstbedarf der Gemeinde produziert, nicht als Ware, und die Produktion selbst ist daher unabhängig von der durch Warenaustausch vermittelten Teilung der Arbeit im großen und ganzen der indischen Gesellschaft.	ch14_clean.en-ch14_clean.de
It is the surplus alone that becomes a commodity, and a portion of even that, not until it has reached the hands of the State, into whose hands from time immemorial a certain quantity of these products has found its way in the shape of rent in kind.	Nur der Überschuß der Produkte verwandelt sich in Ware, zum Teil selbst wieder erst in der Hand des Staats, dem ein bestimmtes Quantum seit undenklichen Zeiten als Naturalrente zufließt.	ch14_clean.en-ch14_clean.de
The constitution of these communities varies in different parts of India.	Verschiedne Teile Indiens besitzen verschiedne Formen des Gemeinwesens.	ch14_clean.en-ch14_clean.de
In those of the simplest form, the land is tilled in common, and the produce divided among the members. At the same time, spinning and weaving are carried on in each family as subsidiary industries.	In der einfachsten Form bebaut die Gemeinde das Land gemeinschaftlich und verteilt seine Produkte unter ihre Glieder, während jede Familie Spinnen, Weben usw. als häusliches Nebengewerb treibt.	ch14_clean.en-ch14_clean.de
Side by side with the masses thus occupied with one and the same work, we find the “chief inhabitant,” who is judge, police, and tax-gatherer in one; the book-keeper, who keeps the accounts of the tillage and registers everything relating thereto; another official, who prosecutes criminals, protects strangers travelling through and escorts them to the next village; the boundary man, who guards the boundaries against neighbouring communities; the water-overseer, who distributes the water from the common tanks for irrigation; the Brahmin, who conducts the religious services; the schoolmaster, who on the sand teaches the children reading and writing; the calendar-Brahmin, or astrologer, who makes known the lucky or unlucky days for seed-time and harvest, and for every other kind of agricultural work; a smith and a carpenter, who make and repair all the agricultural implements; the potter, who makes all the pottery of the village; the barber, the washerman, who washes clothes, the silversmith, here and there the poet, who in some communities replaces the silversmith, in others the schoolmaster.	Neben dieser gleichartig beschäftigten Masse finden wir den "Haupteinwohner", Richter, Polizei und Steuereinnehmer in einer Person; den Buchhalter, der die Rechnung über den Ackerbau führt und alles darauf Bezügliche katastriert und registriert; einen Beamten, der Verbrecher verfolgt und fremde Reisende beschützt und von einem Dorf zum andren geleitet; den Grenzmann, der die Grenzen der Gemeinde gegen die Nachbargemeinden bewacht; den Wasseraufseher, der das Wasser aus den gemeinschaftlichen Wasserbehältern zu Ackerbauzwecken verteilt; den Braminen, der die Funktionen des religiösen Kultus verrichtet; den Schulmeister, der die Gemeindekinder im Sand schreiben und lesen lehrt; den Kalenderbraminen, der als Astrolog die Zeiten für Saat, Ernte und die guten und bösen Stunden für alle besondren Ackerbauarbeiten angibt; einen Schmied und einen Zimmermann, welche alle Ackerbauwerkzeuge verfertigen und ausbessern; den Töpfer, der alle Gefäße für das Dorf macht; den Barbier, den Wäscher für die Reinigung der Kleider, den Silberschmied, hier und da den Poeten, der in einigen Gemeinden den Silberschmied, in andren den Schulmeister ersetzt.	ch14_clean.en-ch14_clean.de
This dozen of individuals is maintained at the expense of the whole community.	Dies Dutzend Personen wird auf Kosten der ganzen Gemeinde erhalten.	ch14_clean.en-ch14_clean.de
If the population increases, a new community is founded, on the pattern of the old one, on unoccupied land.	Wächst die Bevölkerung, so wird eine neue Gemeinde nach dem Muster der alten auf unbebautem Boden angesiedelt.	ch14_clean.en-ch14_clean.de
The whole mechanism discloses a systematic division of labour; but a division like that in manufactures is impossible, since the smith and the carpenter, &c., find an unchanging market, and at the most there occur, according to the sizes of the villages, two or three of each, instead of one.	Der Gemeindemechanismus zeigt planmäßige Teilung der Arbeit, aber ihre manufakturmäßige Teilung ist unmöglich, indem der Markt für Schmied, Zimmermann usw. unverändert bleibt und höchstens, je nach dem Größenunterschied der Dörfer, statt eines Schmieds, Töpfers usw. ihrer zwei oder drei vorkommen.	ch14_clean.en-ch14_clean.de
The law that regulates the division of labour in the community acts with the irresistible authority of a law of Nature, at the same time that each individual artificer, the smith, the carpenter, and so on, conducts in his workshop all the operations of his handicraft in the traditional way, but independently, and without recognising any authority over him.	Das Gesetz, das die Teilung der Gemeindearbeit regelt, wirkt hier mit der unverbrüchlichen Autorität eines Naturgesetzes, während jeder besondre Handwerker, wie Schmied usw., nach überlieferter Art, aber selbständig und ohne Anerkennung irgendeiner Autorität in seiner Werkstatt, alle zu seinem Fach gehörigen Operationen verrichtet.	ch14_clean.en-ch14_clean.de
The simplicity of the organisation for production in these self-sufficing communities that constantly reproduce themselves in the same form, and when accidentally destroyed, spring up again on the spot and with the same name this simplicity supplies the key to the secret of the unchangeableness of Asiatic societies, an unchangeableness in such striking contrast with the constant dissolution and refounding of Asiatic States, and the never-ceasing changes of dynasty.	Der einfache produktive Organismus dieser selbstgenügenden Gemeinwesen, die sich beständig in derselben Form reproduzieren und, wenn zufällig zerstört, an demselben Ort, mit demselben Namen, wieder aufbauen , liefert den Schlüssel zum Geheimnis der Unveränderlichkeit asiatischer Gesellschaften, so auffallend kontrastiert durch die beständige Auflösung und Neubildung asiatischer Staaten und rastlosen Dynastenwechsel.	ch14_clean.en-ch14_clean.de
The structure of the economic elements of society remains untouched by the storm-clouds of the political sky.	Die Struktur der ökonomischen Grundelemente der Gesellschaft bleibt von den Stürmen der politischen Wolkenregion unberührt.	ch14_clean.en-ch14_clean.de
The rules of the guilds, as I have said before, by limiting most strictly the number of apprentices and journeymen that a single master could employ, prevented him from becoming a capitalist.	Die Zunftgesetze, wie schon früher bemerkt, verhinderten planmäßig, durch äußerste Beschränkung der Gesellenzahl, die ein einzelner Zunftmeister beschäftigen durfte, seine Verwandlung in einen Kapitalisten.	ch14_clean.en-ch14_clean.de
Moreover, he could not employ his journeymen in many other handicrafts than the one in which he was a master.	Ebenso konnte er Gesellen nur beschäftigen in dem ausschließlichen Handwerk, worin er selbst Meister war.	ch14_clean.en-ch14_clean.de
The guilds zealously repelled every encroachment by the capital of merchants, the only form of free capital with which they came in contact.	Die Zunft wehrte eifersüchtig jeden Übergriff des Kaufmannskapitals ab, der einzig freien Form des Kapitals, die ihr gegenüberstand.	ch14_clean.en-ch14_clean.de
A merchant could buy every kind of commodity, but labour as a commodity he could not buy.	Der Kaufmann konnte alle Waren kaufen, nur nicht die Arbeit als Ware.	ch14_clean.en-ch14_clean.de
He existed only on sufferance, as a dealer in the products of the handicrafts.	Er war nur geduldet als Verleger der Handwerksprodukte.	ch14_clean.en-ch14_clean.de
If circumstances called for a further division of labour, the existing guilds split themselves up into varieties, or founded new guilds by the side of the old ones; all this, however, without concentrating various handicrafts in a single workshop.	Riefen äußere Umstände eine fortschreitende Teilung der Arbeit hervor, so zerspalteten sich bestehende Zünfte in Unterarten oder lagerten sich neue Zünfte neben die alten hin, jedoch ohne Zusammenfassung verschiedner Handwerke in einer Werkstatt.	ch14_clean.en-ch14_clean.de
Hence, the guild organisation, however much it may have contributed by separating, isolating, and perfecting the handicrafts, to create the material conditions for the existence of manufacture, excluded division of labour in the workshop.	Die Zunftorganisation, sosehr ihre Besondrung, Isolierung und Ausbildung der Gewerbe zu den materiellen Existenzbedingungen der Manufakturperiode gehören, schloß daher die manufakturmäßige Teilung der Arbeit aus.	ch14_clean.en-ch14_clean.de
On the whole, the labourer and his means of production remained closely united, like the snail with its shell, and thus there was wanting the principal basis of manufacture, the separation of the labourer from his means of production, and the conversion of these means into capital.	Im großen und ganzen blieben der Arbeiter und seine Produktionsmittel miteinander verbunden wie die Schnecke mit dem Schneckenhaus, und so fehlte die erste Grundlage der Manufaktur, die Verselbständigung der Produktionsmittel als Kapital gegenüber dem Arbeiter.	ch14_clean.en-ch14_clean.de
While division of labour in society at large, whether such division be brought about or not by exchange of commodities, is common to economic formations of society the most diverse, division of labour in the workshop, as practised by manufacture, is a special creation of the capitalist mode of production alone.	Während die Teilung der Arbeit im Ganzen einer Gesellschaft, ob vermittelt oder unvermittelt durch den Warenaustausch, den verschiedenartigsten ökonomischen Gesellschaftsformationen angehört, ist die manufakturmäßige Teilung der Arbeit eine ganz spezifische Schöpfung der kapitalistischen Produktionsweise.	ch14_clean.en-ch14_clean.de
Section 5: The Capitalistic Character of Manufacture An increased number of labourers under the control of one capitalist is the natural starting-point, as well of co-operation generally, as of manufacture in particular.	5. Der kapitalistische Charakter der Manufaktur Eine größere Arbeiteranzahl unter dem Kommando desselben Kapitals bildet den naturwüchsigen Ausgangspunkt, wie der Kooperation überhaupt, so der Manufaktur.	ch14_clean.en-ch14_clean.de
But the division of labour in manufacture makes this increase in the number of workmen a technical necessity.	Umgekehrt entwickelt die manufakturmäßige Teilung der Arbeit das Wachstum der angewandten Arbeiterzahl zur technischen Notwendigkeit.	ch14_clean.en-ch14_clean.de
The minimum number that any given capitalist is bound to employ is here prescribed by the previously established division of labour.	Das Arbeiterminimum, das ein einzelner Kapitalist anwenden muß, ist ihm jetzt durch die vorhandne Teilung der Arbeit vorgeschrieben.	ch14_clean.en-ch14_clean.de
On the other hand, the advantages of further division are obtainable only by adding to the number of workmen, and this can be done only by adding multiples of the various detail groups.	Andrerseits sind die Vorteile weitrer Teilung bedingt durch weitere Vermehrung der Arbeiteranzahl, die nur noch in Vielfachen ausführbar.	ch14_clean.en-ch14_clean.de
But an increase in the variable component of the capital employed necessitates an increase in its constant component, too, in the workshops, implements, &c., and, in particular, in the raw material, the call for which grows quicker than the number of workmen.	Mit dem variablen muß aber auch der konstante Bestandteil des Kapitals wachsen, neben dem Umfang der gemeinsamen Produktionsbedingungen, wie Baulichkeiten, Öfen usw., namentlich auch und viel rascher als die Arbeiteranzahl, das Rohmaterial.	ch14_clean.en-ch14_clean.de
The quantity of it consumed in a given time, by a given amount of labour, increases in the same ratio as does the productive power of that labour in consequence of its division.	Seine Masse, verzehrt in gegebner Zeit durch gegebnes Arbeitsquantum, nimmt in demselben Verhältnis zu wie die Produktivkraft der Arbeit infolge ihrer Teilung.	ch14_clean.en-ch14_clean.de
Hence, it is a law, based on the very nature of manufacture, that the minimum amount of capital, which is bound to be in the hands of each capitalist, must keep increasing; in other words, that the transformation into capital of the social means of production and subsistence must keep extending.	Wachsender Minimalumfang von Kapital in der Hand der einzelnen Kapitalisten oder wachsende Verwandlung der gesellschaftlichen Lebensmittel und Produktionsmittel in Kapital ist also ein aus dem technischen Charakter der Manufaktur entspringendes Gesetz.	ch14_clean.en-ch14_clean.de
In manufacture, as well as in simple co-operation, the collective working organism is a form of existence of capital.	Wie in der einfachen Kooperation ist in der Manufaktur der funktionierende Arbeitskörper eine Existenzform des Kapitals.	ch14_clean.en-ch14_clean.de
The mechanism that is made up of numerous individual detail labourers belongs to the capitalist.	Der aus vielen individuellen Teilarbeitern zusammengesetzte gesellschaftliche Produktionsmechanismus gehört dem Kapitalisten.	ch14_clean.en-ch14_clean.de
Hence, the productive power resulting from a combination of labours appears to be the productive power of capital.	Die aus der Kombination der Arbeiten entspringende Produktivkraft erscheint daher als Produktivkraft des Kapitals.	ch14_clean.en-ch14_clean.de
Manufacture proper not only subjects the previously independent workman to the discipline and command of capital, but, in addition, creates a hierarchic gradation of the workmen themselves.	Die eigentliche Manufaktur unterwirft nicht nur den früher selbständigen Arbeiter dem Kommando und der Disziplin des Kapitals, sondern schafft überdem eine hierarchische Gliederung unter den Arbeitern selbst.	ch14_clean.en-ch14_clean.de
While simple co-operation leaves the mode of working by the individual for the most part unchanged, manufacture thoroughly revolutionises it, and seizes labour-power by its very roots.	Während die einfache Kooperation die Arbeitsweise der einzelnen im großen und ganzen unverändert läßt, revolutioniert die Manufaktur sie von Grund aus und ergreift die individuelle Arbeitskraft an ihrer Wurzel.	ch14_clean.en-ch14_clean.de
It converts the labourer into a crippled monstrosity, by forcing his detail dexterity at the expense of a world of productive capabilities and instincts; just as in the States of La Plata they butcher a whole beast for the sake of his hide or his tallow.	Sie verkrüppelt den Arbeiter in eine Abnormität, indem sie sein Detailgeschick treibhausmäßig fördert durch Unterdrückung einer Welt von produktiven Trieben und Anlagen, wie man in den La-Plata-Staaten ein ganzes Tier abschlachtet, um sein Fell oder seinen Talg zu erbeuten.	ch14_clean.en-ch14_clean.de
Not only is the detail work distributed to the different individuals, but the individual himself is made the automatic motor of a fractional operation, and the absurd fable of Menenius Agrippa, which makes man a mere fragment of his own body, becomes realised.	Die besondren Teilarbeiten werden nicht nur unter verschiedne Individuen verteilt, sondern das Individuum selbst wird geteilt, in das automatische Triebwerk einer Teilarbeit verwandelt und die abgeschmackte Fabel des Menenius Agrippa verwirklicht, die einen Menschen als bloßes Fragment seines eignen Körpers darstellt.	ch14_clean.en-ch14_clean.de
If, at first, the workman sells his labour-power to capital, because the material means of producing a commodity fail him, now his very labour-power refuses its services unless it has been sold to capital.	Wenn der Arbeiter ursprünglich seine Arbeitskraft an das Kapital verkauft, weil ihm die materiellen Mittel zur Produktion einer Ware fehlen, versagt jetzt seine individuelle Arbeitskraft selbst ihren Dienst, sobald sie nicht an das Kapital verkauft wird.	ch14_clean.en-ch14_clean.de
Its functions can be exercised only in an environment that exists in the workshop of the capitalist after the sale.	Sie funktioniert nur noch in einem Zusammenhang, der erst nach ihrem Verkauf existiert, in der Werkstatt des Kapitalisten.	ch14_clean.en-ch14_clean.de
By nature unfitted to make anything independently, the manufacturing labourer develops productive activity as a mere appendage of the capitalist’s workshop.	Seiner natürlichen Beschaffenheit nach verunfähigt, etwas Selbständiges zu machen, entwickelt der Manufakturarbeiter produktive Tätigkeit nur noch als Zubehör zur Werkstatt des Kapitalisten.	ch14_clean.en-ch14_clean.de
As the chosen people bore in their features the sign manual of Jehovah, so division of labour brands the manufacturing workman as the property of capital.	Wie dem auserwählten Volk auf der Stirn geschrieben stand, daß es das Eigentum Jehovas, so drückt die Teilung der Arbeit dem Manufakturarbeiter einen Stempel auf, der ihn zum Eigentum des Kapitals brandmarkt.	ch14_clean.en-ch14_clean.de
The knowledge, the judgement, and the will, which, though in ever so small a degree, are practised by the independent peasant or handicraftsman, in the same way as the savage makes the whole art of war consist in the exercise of his personal cunning these faculties are now required only for the workshop as a whole.	Die Kenntnisse, die Einsicht und der Wille, die der selbständige Bauer oder Handwerker, wenn auch auf kleinem Maßstab, entwickelt, wie der Wilde alle Kunst des Kriegs als persönliche List ausübt, sind jetzt nur noch für das Ganze der Werkstatt erheischt.	ch14_clean.en-ch14_clean.de
Intelligence in production expands in one direction, because it vanishes in many others.	Die geistigen Potenzen der Produktion erweitern ihren Maßstab auf der einen Seite, weil sie auf vielen Seiten verschwinden.	ch14_clean.en-ch14_clean.de
What is lost by the detail labourers, is concentrated in the capital that employs them.	Was die Teilarbeiter verlieren, konzentriert sich ihnen gegenüber im Kapital.	ch14_clean.en-ch14_clean.de
It is a result of the division of labour in manufactures, that the labourer is brought face to face with the intellectual potencies of the material process of production, as the property of another, and as a ruling power.	Es ist ein Produkt der manufakturmäßigen Teilung der Arbeit, ihnen die geistigen Potenzen des materiellen Produktionsprozesses als fremdes Eigentum und sie beherrschende Macht gegenüberzustellen.	ch14_clean.en-ch14_clean.de
This separation begins in simple co-operation, where the capitalist represents to the single workman, the oneness and the will of the associated labour.	Dieser Scheidungsprozeß beginnt in der einfachen Kooperation, wo der Kapitalist den einzelnen Arbeitern gegenüber die Einheit und den Willen des gesellschaftlichen Arbeitskörpers vertritt.	ch14_clean.en-ch14_clean.de
It is developed in manufacture which cuts down the labourer into a detail labourer.	Er entwickelt sich in der Manufaktur, die den Arbeiter zum Teilarbeiter verstümmelt.	ch14_clean.en-ch14_clean.de
It is completed in modern industry, which makes science a productive force distinct from labour and presses it into the service of capital.	Er vollendet sich in der großen Industrie, welche die Wissenschaft als selbständige Produktionspotenz von der Arbeit trennt und in den Dienst des Kapitals preßt.	ch14_clean.en-ch14_clean.de
In manufacture, in order to make the collective labourer, and through him capital, rich in social productive power, each labourer must be made poor in individual productive powers.	In der Manufaktur ist die Bereicherung des Gesamtarbeiters und daher des Kapitals an gesellschaftlicher Produktivkraft bedingt durch die Verarmung des Arbeiters an individuellen Produktivkräften.	ch14_clean.en-ch14_clean.de
“Ignorance is the mother of industry as well as of superstition.	"Die Unwissenheit ist die Mutter der Industrie wie des Aberglaubens.	ch14_clean.en-ch14_clean.de
Reflection and fancy are subject to err; but a habit of moving the hand or the foot is independent of either.	Nachdenken und Einbildungskraft sind dem Irrtum unterworfen; aber die Gewohnheit, den Fuß oder die Hand zu bewegen, hängt weder von dem einen noch von der andren ab.	ch14_clean.en-ch14_clean.de
Manufactures, accordingly, prosper most where the mind is least consulted, and where the workshop may ... be considered as an engine, the parts of which are men.”	Manufakturen prosperieren also da am meisten, wo man am meisten sich des Geistes entschlägt, in der Art, daß die Werkstatt als eine Maschine betrachtet werden kann, deren Teile Menschen sind."	ch14_clean.en-ch14_clean.de
As a matter of fact, some few manufacturers in the middle of the 18th century preferred, for certain operations that were trade secrets, to employ half-idiotic persons.	In der Tat wandten einige Manufakturen in der Mitte des 18. Jahrhunderts für gewisse einfache Operationen, welche aber Fabrikgeheimnisse bildeten, mit Vorliebe halbe Idioten an.	ch14_clean.en-ch14_clean.de
“The understandings of the greater part of men,” says Adam Smith, “are necessarily formed by their ordinary employments.	"Der Geist der großen Mehrzahl der Menschen", sagt A. Smith, "entwickelt sich notwendig aus und an ihren Alltagsverrichtungen.	ch14_clean.en-ch14_clean.de
The man whose whole life is spent in performing a few simple operations ... has no occasion to exert his understanding...	Ein Mensch, der sein ganzes Leben in der Verrichtung weniger einfacher Operationen verausgabt ... hat keine Gelegenheit, seinen Verstand zu üben ...	ch14_clean.en-ch14_clean.de
He generally becomes as stupid and ignorant as it is possible for a human creature to become.”	Er wird im allgemeinen so stupid und unwissend, wie es für eine menschliche Kreatur möglich ist."	ch14_clean.en-ch14_clean.de
After describing the stupidity of the detail labourer he goes on: “The uniformity of his stationary life naturally corrupts the courage of his mind...	Nachdem Smith den Stumpfsinn des Teilarbeiters geschildert, fährt er fort: "Die Einförmigkeit seines stationären Lebens verdirbt natürlich auch den Mut seines Geistes ...	ch14_clean.en-ch14_clean.de
It corrupts even the activity of his body and renders him incapable of exerting his strength with vigour and perseverance in any other employments than that to which he has been bred.	Sie zerstört selbst die Energie seines Körpers und verunfähigt ihn, seine Kraft schwunghaft und ausdauernd anzuwenden, außer in der Detailbeschäftigung, wozu er herangezogen ist.	ch14_clean.en-ch14_clean.de
His dexterity at his own particular trade seems in this manner to be acquired at the expense of his intellectual, social, and martial virtues.	Sein Geschick in seinem besondren Gewerke scheint so erworben auf Kosten seiner intellektuellen, sozialen und kriegerischen Tugenden.	ch14_clean.en-ch14_clean.de
But in every improved and civilised society, this is the state into which the labouring poor, that is, the great body of the people, must necessarily fall.”	Aber in jeder industriellen und zivilisierten Gesellschaft ist dies der Zustand, worin der arbeitende Arme (the labouring poor), d.h. die große Masse des Volks notwendig verfallen muß."	ch14_clean.en-ch14_clean.de
For preventing the complete deterioration of the great mass of the people by division of labour, A. Smith recommends education of the people by the State, but prudently, and in homeopathic doses.	Um die aus der Teilung der Arbeit entspringende völlige Verkümmerung der Volksmasse zu verhindern, empfiehlt A. Smith Volksunterricht von Staats wegen, wenn auch in vorsichtig homöopathischen Dosen.	ch14_clean.en-ch14_clean.de
G. Garnier, his French translator and commentator, who, under the first French Empire, quite naturally developed into a senator, quite as naturally opposes him on this point.	Konsequent polemisiert dagegen sein französischer Übersetzer und Kommentator, G. Garnier, der sich unter dem ersten französischen Kaisertum naturgemäß zum Senator entpuppte.	ch14_clean.en-ch14_clean.de
Education of the masses, he urges, violates the first law of the division of labour, and with it “our whole social system would be proscribed.”	Volksunterricht verstoße wider die ersten Gesetze der Teilung der Arbeit und mit demselben "proskribiere man unser ganzes Gesellschaftssystem".	ch14_clean.en-ch14_clean.de
"Like all other divisions of labour,” he says, “that between hand labour and head labour 48 is more pronounced and decided in proportion as society (he rightly uses this word, for capital, landed property and their State) becomes richer.	"Wie alle andren Teilungen der Arbeit", sagte er, "wird die zwischen Handarbeit und Verstandesarbeit ausgesprochner und entschiedner im Maße, wie die Gesellschaft" (er wendet richtig diesen Ausdruck an für das Kapital, das Grundeigentum und ihren Staat) "reicher wird.	ch14_clean.en-ch14_clean.de
This division of labour, like every other, is an effect of past, and a cause of future progress... ought the government then to work in opposition to this division of labour, and to hinder its natural course?	Gleich jeder andren ist diese Teilung der Arbeit eine Wirkung vergangner und eine Ursache künftiger Fortschritte ... Darf die Regierung denn dieser Teilung der Arbeit entgegenwirken und sie in ihrem naturgemäßen Gang aufhalten?	ch14_clean.en-ch14_clean.de
Ought it to expend a part of the public money in the attempt to confound and blend together two classes of labour, which are striving after division and separation?”	Darf sie einen Teil der Staatseinnahme zum Versuch verwenden, zwei Klassen von Arbeit, die ihre Teilung und Trennung erstreben, zu verwirren und zu vermischen?"	ch14_clean.en-ch14_clean.de
Some crippling of body and mind is inseparable even from division of labour in society as a whole.	Eine gewisse geistige und körperliche Verkrüppelung ist unzertrennlich selbst von der Teilung der Arbeit im ganzen und großen der Gesellschaft.	ch14_clean.en-ch14_clean.de
Since, however, manufacture carries this social separation of branches of labour much further, and also, by its peculiar division, attacks the individual at the very roots of his life50, it is the first to afford the materials for, and to give a start to, industrial pathology.	Da aber die Manufakturperiode diese gesellschaftliche Zerspaltung der Arbeitszweige viel weiter führt, andrerseits erst mit der ihr eigentümlichen Teilung das Individuum an seiner Lebenswurzel ergreift, liefert sie auch zuerst das Material und den Anstoß zur industriellen Pathologie.	ch14_clean.en-ch14_clean.de
“To subdivide a man is to execute him, if he deserves the sentence, to assassinate him if he does not...	"Einen Menschen unterabteilen, heißt ihn hinrichten, wenn er das Todesurteil verdient, ihn meuchelmorden, wenn er es nicht verdient.	ch14_clean.en-ch14_clean.de
The subdivision of labour is the assassination of a people.” 51 Co-operation based on division of labour, in other words, manufacture, commences as a spontaneous formation.	Die Unterabteilung der Arbeit ist der Meuchelmord eines Volks." Die auf Teilung der Arbeit beruhende Kooperation oder die Manufaktur ist in ihren Anfängen ein naturwüchsiges Gebild.	ch14_clean.en-ch14_clean.de
So soon as it attains some consistence and extension, it becomes the recognised methodical and systematic form of capitalist production.	Sobald sie einige Konsistenz und Breite des Daseins gewonnen, wird sie zur bewußten, planmäßigen und systematischen Form der kapitalistischen Produktionsweise.	ch14_clean.en-ch14_clean.de
History shows how the division of labour peculiar to manufacture, strictly so called, acquires the best adapted form at first by experience, as it were behind the backs of the actors, and then, like the guild handicrafts, strives to hold fast that form when once found, and here and there succeeds in keeping it for centuries.	Die Geschichte der eigentlichen Manufaktur zeigt, wie die ihr eigentümliche Teilung der Arbeit zunächst erfahrungsmäßig, gleichsam hinter dem Rücken der handelnden Personen, die sachgemäßen Formen gewinnt, dann aber, gleich dem zünftigen Handwerke, die einmal gefundne Form traditionell festzuhalten strebt und in einzelnen Fällen jahrhundertlang festhält.	ch14_clean.en-ch14_clean.de
Any alteration in this form, except in trivial matters, is solely owing to a revolution in the instruments of labour.	Ändert sich diese Form, so, außer in Nebendingen, immer nur infolge einer Revolution der Arbeitsinstrumente.	ch14_clean.en-ch14_clean.de
Modern manufacture wherever it arises I do not here allude to modern industry based on machinery either finds the disjecta membra poetae ready to hand, and only waiting to be collected together, as is the case in the manufacture of clothes in large towns, or it can easily apply the principle of division, simply by exclusively assigning the various operations of a handicraft (such as book-binding) to particular men.	Die moderne Manufaktur - ich spreche hier nicht von der auf Maschinerie beruhenden großen Industrie - findet entweder, wie z.B. die Kleidermanufaktur, in den großen Städten, wo sie entsteht, die disjecta membra poetae <zerstreuten Glieder des Dichters> bereits fertig vor und hat sie nur aus ihrer Zerstreuung zu sammeln, oder das Prinzip der Teilung liegt auf flacher Hand, indem einfach die verschiednen Verrichtungen der handwerksmäßigen Produktion (z.B. beim Buchbinden) besondren Arbeitern ausschließlich angeeignet werden.	ch14_clean.en-ch14_clean.de
In such cases, a week’s experience is enough to determine the proportion between the numbers of the hands necessary for the various functions.	Es kostet noch keine Woche Erfahrung, in solchen Fällen die Verhältniszahl zwischen den für jede Funktion nötigen Händen zu finden.	ch14_clean.en-ch14_clean.de
By decomposition of handicrafts, by specialisation of the instruments of labour, by the formation of detail labourers, and by grouping and combining the latter into a single mechanism, division of labour in manufacture creates a qualitative gradation, and a quantitative proportion in the social process of production; it consequently creates a definite organisation of the labour of society, and thereby develops at the same time new productive forces in the society.	Die manufakturmäßige Teilung der Arbeit schafft durch Analyse der handwerksmäßigen Tätigkeit, Spezifizierung der Arbeitsinstrumente, Bildung der Teilarbeiter, ihre Gruppierung und Kombination in einem Gesamtmechanismus, die qualitative Gliederung und quantitative Proportionalität gesellschaftlicher Produktionsprozesse, also eine bestimmte Organisation gesellschaftlicher Arbeit und entwickelt damit zugleich neue, gesellschaftliche Produktivkraft der Arbeit.	ch14_clean.en-ch14_clean.de
In its specific capitalist form and under the given conditions, it could take no other form than a capitalistic one manufacture is but a particular method of begetting relative surplus-value, or of augmenting at the expense of the labourer the self-expansion of capital usually called social wealth, “Wealth of Nations,” &c.	Als spezifisch kapitalistische Form des gesellschaftlichen Produktionsprozesses - und auf den vorgefundnen Grundlagen konnte sie sich nicht anders als in der kapitalistischen Form entwickeln - ist sie nur eine besondre Methode, relativen Mehrwert zu erzeugen oder die Selbstverwertung des Kapitals - was man gesellschaftlichen Reichtum, "Wealth of Nations" usw. nennt - auf Kosten der Arbeiter zu erhöhn.	ch14_clean.en-ch14_clean.de
It increases the social productive power of labour, not only for the benefit of the capitalist instead of for that of the labourer, but it does this by crippling the individual labourers.	Sie entwickelt die gesellschaftliche Produktivkraft der Arbeit nicht nur für den Kapitalisten, statt für den Arbeiter, sondern durch die Verkrüpplung des individuellen Arbeiters.	ch14_clean.en-ch14_clean.de
It creates new conditions for the lordship of capital over labour.	Sie produziert neue Bedingungen der Herrschaft des Kapitals über die Arbeit.	ch14_clean.en-ch14_clean.de
If, therefore, on the one hand, it presents itself historically as a progress and as a necessary phase in the economic development of society, on the other hand, it is a refined and civilised method of exploitation.	Wenn sie daher einerseits als historischer Fortschritt und notwendiges Entwicklungsmoment im ökonomischen Bildungsprozeß der Gesellschaft erscheint, so andrerseits als ein Mittel zivilisierter und raffinierter Exploitation.	ch14_clean.en-ch14_clean.de
Political Economy, which as an independent science, first sprang into being during the period of manufacture, views the social division of labour only from the standpoint of manufacture, and sees in it only the means of producing more commodities with a given quantity of labour, and, consequently, of cheapening commodities and hurrying on the accumulation of capital.	Die politische Ökonomie, die als eigne Wissenschaft erst in der Manufakturperiode aufkommt, betrachtet die gesellschaftliche Teilung der Arbeit überhaupt nur vom Standpunkt der manufakturmäßigen Teilung der Arbeit , als Mittel, mit demselben Quantum Arbeit mehr Ware zu produzieren, daher die Waren zu verwohlfeilern und die Akkumulation des Kapitals zu beschleunigen.	ch14_clean.en-ch14_clean.de
In most striking contrast with this accentuation of quantity and exchange-value, is the attitude of the writers of classical antiquity, who hold exclusively by quality and use-value.	Im strengsten Gegensatz zu dieser Akzentuierung der Quantität und des Tauschwerts halten sich die Schriftsteller des klassischen Altertums ausschließlich an Qualität und Gebrauchswert.	ch14_clean.en-ch14_clean.de
In consequence of the separation of the social branches of production, commodities are better made, the various bents and talents of men select a suitable field, and without some restraint no important results can be obtained anywhere.	In- folge der Scheidung der gesellschaftlichen Produktionszweige werden die Waren besser gemacht, die verschiednen Triebe und Talente der Menschen wählen sich entsprechende Wirkungssphären , und ohne Beschränkung ist nirgendwo Bedeutendes zu leisten.	ch14_clean.en-ch14_clean.de
Hence both product and producer are improved by division of labour.	Also Produkt und Produzent werden verbessert durch die Teilung der Arbeit.	ch14_clean.en-ch14_clean.de
If the growth of the quantity produced is occasionally mentioned, this is only done with reference to the greater abundance of use-values.	Wird gelegentlich auch das Wachstum der Produktenmasse erwähnt, so nur mit Bezug auf die größre Fülle des Gebrauchswerts.	ch14_clean.en-ch14_clean.de
There is not a word alluding to exchange-value or to the cheapening of commodities.	Es wird mit keiner Silbe des Tauschwerts, der Verwohlfeilerung der Waren gedacht.	ch14_clean.en-ch14_clean.de
This aspect, from the standpoint of use-value alone, is taken as well by Plato, who treats division of labour as the foundation on which the division of society into classes is based, as by Xenophon58, who with characteristic bourgeois instinct, approaches more nearly to division of labour within the workshop.	Dieser Standpunkt des Gebrauchswerts herrscht sowohl bei Plato , der die Teilung der Arbeit als Grundlage der gesellschaftlichen Scheidung der Stände behandelt, als bei Xenophon , der mit seinem charakteristisch bürgerlichen Instinkt schon der Teilung der Arbeit innerhalb einer Werkstatt näher rückt.	ch14_clean.en-ch14_clean.de
Plato’s Republic, in so far as division of labour is treated in it, as the formative principle of the State, is merely the Athenian idealisation of the Egyptian system of castes, Egypt having served as the model of an industrial country to many of his contemporaries also, amongst others to Isocrates, and it continued to have this importance to the Greeks of the Roman Empire.	Platos Republik, soweit in ihr die Teilung der Arbeit als das gestaltende Prinzip des Staats entwickelt wird, ist nur atheniensische Idealisierung des ägyptischen Kastenwesens, wie Ägypten als industrielles Musterland auch andren seiner Zeitgenossen gilt, z.B. dem Isokrates , und diese Be- deutung selbst noch für die Griechen der römischen Kaiserzeit behielt.	ch14_clean.en-ch14_clean.de
During the manufacturing period proper, i.e., the period during which manufacture is the predominant form taken by capitalist production, many obstacles are opposed to the full development of the peculiar tendencies of manufacture.	Während der eigentlichen Manufakturperiode, d.h. der Periode, worin die Manufaktur die herrschende Form der kapitalistischen Produktionsweise, stößt die volle Ausführung ihrer eignen Tendenzen auf vielseitige Hindernisse.	ch14_clean.en-ch14_clean.de
Although manufacture creates, as we have already seen, a simple separation of the labourers into skilled and unskilled, simultaneously with their hierarchic arrangement in classes, yet the number of the unskilled labourers, owing to the preponderating influence of the skilled, remains very limited.	Obgleich sie, wie wir sahen, neben der hierarchischen Gliederung der Arbeiter eine einfache Scheidung zwischen geschickten und ungeschickten Arbeitern schafft, bleibt die Zahl der letztren durch den überwiegenden Einfluß der erstren sehr beschränkt.	ch14_clean.en-ch14_clean.de
Although it adapts the detail operations to the various degrees of maturity, strength, and development of the living instruments of labour, thus conducing to exploitation of women and children, yet this tendency as a whole is wrecked on the habits and the resistance of the male labourers.	Obgleich sie die Sonderoperationen dem verschiednen Grad von Reife, Kraft und Entwicklung ihrer lebendigen Arbeitsorgane anpaßt und daher zu produktiver Ausbeutung von Weibern und Kindern drängt, scheitert diese Tendenz im großen und ganzen an den Gewohnheiten und dem Widerstand der männlichen Arbeiter.	ch14_clean.en-ch14_clean.de
Although the splitting up of handicrafts lowers the cost of forming the workman, and thereby lowers his value, yet for the more difficult detail work, a longer apprenticeship is necessary, and, even where it would be superfluous, is jealously insisted upon by the workmen.	Obgleich die Zersetzung der handwerksmäßigen Tätigkeit die Bildungskosten und daher den Wert der Arbeiter senkt, bleibt für schwierigere Detailarbeit eine längre Erlernungszeit nötig und wird auch da, wo sie vom Überfluß, eifersüchtig von den Arbeitern aufrechterhalten.	ch14_clean.en-ch14_clean.de
In England, for instance, we find the laws of apprenticeship, with their seven years’ probation, in full force down to the end of the manufacturing period; and they are not thrown on one side till the advent of Modern Industry.	Wir finden z.B. in England die laws of apprenticeship <Lehrlingsgesetze> mit ihrer siebenjährigen Lernzeit bis zum Ende der Manufakturperiode in Vollkraft und erst von der großen Industrie über Haufen geworfen.	ch14_clean.en-ch14_clean.de
Since handicraft skill is the foundation of manufacture, and since the mechanism of manufacture as a whole possesses no framework, apart from the labourers themselves, capital is constantly compelled to wrestle with the insubordination of the workmen.	Da das Handwerksgeschick die Grundlage der Manufaktur bleibt und der in ihr funktionierende Gesamtmechanismus kein von den Arbeitern selbst unabhängiges objektives Skelett besitzt, ringt das Kapital beständig mit der Insubordination der Arbeiter.	ch14_clean.en-ch14_clean.de
“By the infirmity of human nature,” says friend Ure, “it happens that the more skilful the workman, the more self-willed and intractable he is apt to become, and of course the less fit a component of a mechanical system in which ... he may do great damage to the whole” Hence throughout the whole manufacturing period there runs the complaint of want of discipline among the workmen62.	"Die Schwäche der menschlichen Natur", ruft Freund Ure aus, "ist so groß, daß der Arbeiter, je geschickter, desto eigenwilliger und schwieriger zu behandeln wird und folglich dem Gesamtmechanismus durch seine rappelköpfigen Launen schweren Schaden zufügt." Durch die ganze Manufakturperiode läuft daher die Klage über den Disziplinmangel der Arbeiter.	ch14_clean.en-ch14_clean.de
And had we not the testimony of contemporary writers, the simple facts, that during the period between the 16th century and the epoch of Modern Industry, capital failed to become the master of the whole disposable working-time of the manufacturing labourers, that manufactures are short-lived, and change their locality from one country to another with the emigrating or immigrating workmen, these facts would speak volumes.	Und hätten wir nicht die Zeugnisse gleichzeitiger Schriftsteller, die einfachen Tatsachen, daß es vom 16. Jahrhundert bis zur Epoche der großen Industrie dem Kapital mißlingt, sich der ganzen disponiblen Arbeitszeit der Manufakturarbeiter zu bemächtigen, daß die Manufakturen kurzlebig sind und mit der Ein- oder Auswandrung der Arbeiter ihren Sitz in dem einen Land verlassen und in dem andren aufschlagen, würden Bibliotheken sprechen.	ch14_clean.en-ch14_clean.de
“Order must in one way or another be established,” exclaims in 1770 the oft-cited author of the “Essay on Trade and Commerce.”	"Ordnung muß auf die eine oder die andre Weise gestiftet werden", ruft 1770 der wiederholt zitierte Verfasser des "Essay on Trade and Commerce".	ch14_clean.en-ch14_clean.de
“Order,” re-echoes Dr. Andrew Ure 66 years later, “Order” was wanting in manufacture based on “the scholastic dogma of division of labour,” and “Arkwright created order.”	Ordnung, hallt es 66 Jahre später zurück aus dem Mund des Dr. Andrew Ure, "Ordnung" fehlte in der auf "dem scholastischen Dogma der Arbeit" beruhenden Manufaktur, und "Arkwright schuf die Ordnung".	ch14_clean.en-ch14_clean.de
At the same time manufacture was unable, either to seize upon the production of society to its full extent, or to revolutionise that production to its very core.	Zugleich konnte die Manufaktur die gesellschaftliche Produktion weder in ihrem ganzen Umfang ergreifen noch in ihrer Tiefe umwälzen.	ch14_clean.en-ch14_clean.de
It towered up as an economic work of art, on the broad foundation of the town handicrafts, and of the rural domestic industries.	Sie gipfelte als ökonomisches Kunstwerk auf der breiten Grundlage des städtischen Handwerks und der ländlich häuslichen Industrie.	ch14_clean.en-ch14_clean.de
At a given stage in its development, the narrow technical basis on which manufacture rested, came into conflict with requirements of production that were created by manufacture itself.	Ihre eigne enge technische Basis trat auf einem gewissen Entwicklungsgrad mit den von ihr selbst geschaffnen Produktionsbedürfnissen in Widerspruch.	ch14_clean.en-ch14_clean.de
One of its most finished creations was the workshop for the production of the instruments of labour themselves, including especially the complicated mechanical apparatus then already employed.	Eins ihrer vollendetsten Gebilde war die Werkstatt zur Produktion der Arbeitsinstrumente selbst, und namentlich auch der bereits angewandten komplizierteren mechanischen Apparate.	ch14_clean.en-ch14_clean.de
A machine-factory, says Ure, “displayed the division of labour in manifold gradations the file, the drill, the lathe, having each its different workman in the order of skill.” (P. 21.)	"Ein solches Atelier", sagt Ure, "bot dem Auge die Teilung der Arbeit in ihren mannigfachen Abstufungen. Bohrer, Meißel, Drechselbank hatten jede ihre eignen Arbeiter, hierarchisch gegliedert nach dem Grad ihrer Geschicklichkeit."	ch14_clean.en-ch14_clean.de
This workshop, the product of the division of labour in manufacture, produced in its turn machines.	Dies Produkt der manufakturmäßigen Teilung der Arbeit produzierte seinerseits - Maschinen.	ch14_clean.en-ch14_clean.de
It is they that sweep away the handicraftsman’s work as the regulating principle of social production.	Sie heben die handwerksmäßige Tätigkeit als das regelnde Prinzip der gesellschaftlichen Produktion auf.	ch14_clean.en-ch14_clean.de
Thus, on the one hand, the technical reason for the life-long annexation of the workman to a detail function is removed.	So wird einerseits der technische Grund der lebenslangen Annexation des Arbeiters an eine Teilfunktion weggeräumt.	ch14_clean.en-ch14_clean.de
On the other hand, the fetters that this same principle laid on the dominion of capital, fall away.	Andrerseits fallen die Schranken, welche dasselbe Prinzip der Herrschaft des Kapitals noch auferlegte.	ch14_clean.en-ch14_clean.de

