Chapter 16: Absolute and Relative Surplus-Value In considering the labour-process, we began (see Chapter VII.) by treating it in the abstract, apart from its historical forms, as a process between man and Nature.	VIERZEHNTES KAPITEL Absoluter und relativer Mehrwert Der Arbeitsprozeß wurde (sieh fünftes Kapitel) zunächst abstrakt betrachtet, unabhängig von seinen geschichtlichen Formen, als Prozeß zwischen Mensch und Natur.	ch16_clean.en-ch16_clean.de
We there stated, “If we examine the whole labour-process, from the point of view of its result, it is plain that both the instruments and the subject of labour are means of production, and that the labour itself is productive labour.”	Es hieß dort: "Betrachtet man den ganzen Arbeitsprozeß vom Standpunkt seines Resultats, so erscheinen beide, Arbeitsmittel und Arbeitsgegenstand, als Produktionsmittel und die Arbeit selbst als produktive Arbeit."	ch16_clean.en-ch16_clean.de
And in Note 2, same page, we further added: “This method of determining, from the standpoint of the labour-process alone, what is productive labour, is by no means directly applicable to the case of the capitalist process of production.”	Und in Note 7 wurde ergänzt: "Diese Bestimmung produktiver Arbeit, wie sie sich vom Standpunkt des einfachen Arbeitsprozesses ergibt, reicht keineswegs hin für den kapitalistischen Produktionsprozeß."	ch16_clean.en-ch16_clean.de
We now proceed to the further development of this subject.	Dies ist hier weiter zu entwickeln.	ch16_clean.en-ch16_clean.de
So far as the labour-process is purely individual, one and the same labourer unites in himself all the functions, that later on become separated.	Soweit der Arbeitsprozeß ein rein individueller, vereinigt derselbe Arbeiter alle Funktionen, die sich später trennen.	ch16_clean.en-ch16_clean.de
When an individual appropriates natural objects for his livelihood, no one controls him but himself.	In der individuellen Aneignung von Naturgegenständen zu seinen Lebenszwecken kontrolliert er sich selbst.	ch16_clean.en-ch16_clean.de
Afterwards he is controlled by others.	Später wird er kontrolliert.	ch16_clean.en-ch16_clean.de
A single man cannot operate upon Nature without calling his own muscles into play under the control of his own brain.	Der einzelne Mensch kann nicht auf die Natur wirken ohne Betätigung seiner eignen Muskeln unter Kontrolle seines eignen Hirns.	ch16_clean.en-ch16_clean.de
As in the natural body head and hand wait upon each other, so the labour-process unites the labour of the hand with that of the head.	Wie im Natursystem Kopf und Hand zusammengehören, vereint der Arbeitsprozeß Kopfarbeit und Handarbeit.	ch16_clean.en-ch16_clean.de
Later on they part company and even become deadly foes.	Später scheiden sie sich bis zum feindlichen Gegensatz.	ch16_clean.en-ch16_clean.de
The product ceases to be the direct product of the individual, and becomes a social product, produced in common by a collective labourer, i.e., by a combination of workmen, each of whom takes only a part, greater or less, in the manipulation of the subject of their labour.	Das Produkt verwandelt sich überhaupt aus dem unmittelbaren Produkt des individuellen Produzenten in ein gesellschaftliches, in das gemeinsame Produkt eines Gesamtarbeiters, d.h. eines kombinierten Arbeitspersonals, dessen Glieder der Handhabung des Arbeitsgegenstandes näher oder ferner stehn.	ch16_clean.en-ch16_clean.de
As the co-operative character of the labour-process becomes more and more marked, so, as a necessary consequence, does our notion of productive labour, and of its agent the productive labourer, become extended.	Mit dem kooperativen Charakter des Arbeitsprozesses selbst erweitert sich daher notwendig der Begriff der produktiven Arbeit und ihres Trägers, des produktiven Arbeiters.	ch16_clean.en-ch16_clean.de
In order to labour productively, it is no longer necessary for you to do manual work yourself; enough, if you are an organ of the collective labourer, and perform one of its subordinate functions.	Um produktiv zu arbeiten, ist es nun nicht mehr nötig, selbst Hand anzulegen; es genügt, Organ des Gesamtarbeiters zu sein, irgendeine seiner Unterfunktionen zu vollziehn.	ch16_clean.en-ch16_clean.de
The first definition given above of productive labour, a definition deduced from the very nature of the production of material objects, still remains correct for the collective labourer, considered as a whole.	Die obige ursprüngliche Bestimmung der produktiven Arbeit, aus der Natur der materiellen Produk- tion selbst abgeleitet, bleibt immer wahr für den Gesamtarbeiter, als Gesamtheit betrachtet.	ch16_clean.en-ch16_clean.de
But it no longer holds good for each member taken individually.	Aber sie gilt nicht mehr für jedes seiner Glieder, einzeln genommen.	ch16_clean.en-ch16_clean.de
On the other hand, however, our notion of productive labour becomes narrowed.	Andrerseits aber verengt sich der Begriff der produktiven Arbeit.	ch16_clean.en-ch16_clean.de
Capitalist production is not merely the production of commodities, it is essentially the production of surplus-value.	Die kapitalistische Produktion ist nicht nur Produktion von Ware, sie ist wesentlich Produktion von Mehrwert.	ch16_clean.en-ch16_clean.de
The labourer produces, not for himself, but for capital.	Der Arbeiter produziert nicht für sich, sondern für das Kapital.	ch16_clean.en-ch16_clean.de
It no longer suffices, therefore, that he should simply produce.	Es genügt daher nicht länger, daß er überhaupt produziert.	ch16_clean.en-ch16_clean.de
He must produce surplus-value.	Er muß Mehrwert produzieren.	ch16_clean.en-ch16_clean.de
That labourer alone is productive, who produces surplus-value for the capitalist, and thus works for the self-expansion of capital.	Nur der Arbeiter ist produktiv, der Mehrwert für den Kapitalisten produziert oder zur Selbstverwertung des Kapitals dient.	ch16_clean.en-ch16_clean.de
If we may take an example from outside the sphere of production of material objects, a schoolmaster is a productive labourer when, in addition to belabouring the heads of his scholars, he works like a horse to enrich the school proprietor.	Steht es frei, ein Beispiel außerhalb der Sphäre der materiellen Produktion zu wählen, so ist ein Schulmeister produktiver Arbeiter, wenn er nicht nur Kinderköpfe bearbeitet, sondern sich selbst abarbeitet zur Bereicherung des Unternehmers.	ch16_clean.en-ch16_clean.de
That the latter has laid out his capital in a teaching factory, instead of in a sausage factory, does not alter the relation.	Daß letztrer sein Kapital in einer Lehrfabrik angelegt hat, statt in einer Wurstfabrik, ändert nichts an dem Verhältnis.	ch16_clean.en-ch16_clean.de
Hence the notion of a productive labourer implies not merely a relation between work and useful effect, between labourer and product of labour, but also a specific, social relation of production, a relation that has sprung up historically and stamps the labourer as the direct means of creating surplus-value.	Der Begriff des produktiven Arbeiters schließt daher keineswegs bloß ein Verhältnis zwischen Tätigkeit und Nutzeffekt, zwischen Arbeiter und Arbeitsprodukt ein, sondern auch ein spezifisch gesellschaftliches, geschichtlich entstandnes Produktionsverhältnis, welches den Arbeiter zum unmittelbaren Verwertungsmittel des Kapitals stempelt.	ch16_clean.en-ch16_clean.de
To be a productive labourer is, therefore, not a piece of luck, but a misfortune.	Produktiver Arbeiter zu sein ist daher kein Glück, sondern ein Pech.	ch16_clean.en-ch16_clean.de
In Book IV. which treats of the history of the theory, it will be more clearly seen, that the production of surplus-value has at all times been made, by classical political economists, the distinguishing characteristic of the productive labourer.	Im Vierten Buch dieser Schrift, welches die Geschichte der Theorie behandelt, wird man näher sehn, daß die klassische politische Ökonomie von jeher die Produktion von Mehrwert zum entscheidenden Charakter des produktiven Arbeiters machte.	ch16_clean.en-ch16_clean.de
Hence their definition of a productive labourer changes with their comprehension of the nature of surplus-value.	Mit ihrer Auffassung von der Natur des Mehrwerts wechselt daher ihre Definition des produktiven Arbeiters.	ch16_clean.en-ch16_clean.de
Thus the Physiocrats insist that only agricultural labour is productive, since that alone, they say, yields a surplus-value.	So erklären die Physiokraten, nur die Ackerbauarbeit sei produktiv, weil sie allein einen Mehrwert liefre.	ch16_clean.en-ch16_clean.de
And they say so because, with them, surplus-value has no existence except in the form of rent.	Für die Physiokraten existiert Mehrwert aber ausschließlich in der Form der Grundrente.	ch16_clean.en-ch16_clean.de
The prolongation of the working day beyond the point at which the labourer would have produced just an equivalent for the value of his labour-power, and the appropriation of that surplus labour by capital, this is production of absolute surplus-value.	Die Verlängrung des Arbeitstags über den Punkt hinaus, wo der Arbeiter nur ein Äquivalent für den Wert seiner Arbeitskraft produziert hätte, und die Aneignung dieser Mehrarbeit durch das Kapital - das ist die Produktion des absoluten Mehrwerts.	ch16_clean.en-ch16_clean.de
It forms the general groundwork of the capitalist system, and the starting-point for the production of relative surplus-value.	Sie bildet die allgemeine Grundlage des kapitalistischen Systems und den Ausgangspunkt der Produktion des relativen Mehrwerts.	ch16_clean.en-ch16_clean.de
The latter pre-supposes that the working day is already divided into two parts, necessary labour, and surplus labour.	Bei dieser ist der Arbeitstag von vornherein in zwei Stücke geteilt: notwendige Arbeit und Mehrarbeit.	ch16_clean.en-ch16_clean.de
In order to prolong the surplus labour, the necessary labour is shortened by methods whereby the equivalent for the wages is produced in less time.	Um die Mehrarbeit zu verlängern, wird die notwendige Arbeit verkürzt durch Methoden, vermittelst deren das Äquivalent des Arbeitslohns in weniger Zeit produziert wird.	ch16_clean.en-ch16_clean.de
The production of absolute surplus-value turns exclusively upon the length of the working day; the production of relative surplus-value, revolutionises out and out the technical processes of labour, and the composition of society.	Die Produktion des absoluten Mehrwerts dreht sich nur um die Länge des Arbeitstags; die Produktion des relativen Mehrwerts revolutioniert durch und durch die technischen Prozesse der Arbeit und die gesellschaftlichen Gruppierungen.	ch16_clean.en-ch16_clean.de
It therefore pre-supposes a specific mode, the capitalist mode of production, a mode which, along with its methods, means, and conditions, arises and develops itself spontaneously on the foundation afforded by the formal subjection of labour to capital.	Sie unterstellt also eine spezifisch kapitalistische Produktionsweise, die mit ihren Methoden, Mitteln und Bedingungen selbst erst auf Grundlage der formellen Subsumtion der Arbeit unter das Kapital naturwüchsig entsteht und ausgebildet wird.	ch16_clean.en-ch16_clean.de
In the course of this development, the formal subjection is replaced by the real subjection of labour to capital.	An die Stelle der formellen tritt die reelle Subsumtion der Arbeit unter das Kapital.	ch16_clean.en-ch16_clean.de
It will suffice merely to refer to certain intermediate forms, in which surplus labour is not extorted by direct compulsion from the producer, nor the producer himself yet formally subjected to capital.	Es genügt bloßer Hinweis auf Zwitterformen, worin die Mehrarbeit weder durch direkten Zwang dem Produzenten ausgepumpt wird, noch auch dessen formelle Unterordnung unter das Kapital eingetreten ist.	ch16_clean.en-ch16_clean.de
In such forms capital has not yet acquired the direct control of the labour-process.	Das Kapital hat sich hier noch nicht unmittelbar des Arbeitsprozesses bemächtigt.	ch16_clean.en-ch16_clean.de
By the side of independent producers who carry on their handicrafts and agriculture in the traditional old-fashioned way, there stands the usurer or the merchant, with his usurer’s capital or merchant’s capital, feeding on them like a parasite.	Neben die selbständigen Produzenten, die in überlieferter, urväterlicher Betriebsweise handwerkern oder ackerbauen, tritt der Wucherer oder Kaufmann, das Wucherkapital oder das Handelskapital, das sie parasitenmäßig aussaugt.	ch16_clean.en-ch16_clean.de
The predominance, in a society, of this form of exploitation excludes the capitalist mode of production; to which mode, however, this form may serve as a transition, as it did towards the close of the Middle Ages.	Vorherrschaft dieser Exploitationsform in einer Gesellschaft schließt die kapitalistische Produktionsweise aus, zu der sie andrerseits, wie im spätren Mittelalter, den Übergang bilden kann.	ch16_clean.en-ch16_clean.de
Finally, as is shown by modern “domestic industry,” some intermediate forms are here and there reproduced in the background of Modern Industry, though their physiognomy is totally changed.	Endlich, wie das Beispiel der modernen Hausarbeit zeigt, werden gewisse Zwitterformen auf dem Hintergrund der großen Industrie stellenweis reproduziert, wenn auch mit gänzlich veränderter Physiognomie.	ch16_clean.en-ch16_clean.de
If, on the one hand, the mere formal subjection of labour to capital suffices for the production of absolute surplus-value, if, e.g., it is sufficient that handicraftsmen who previously worked on their own account, or as apprentices of a master, should become wage labourers under the direct control of a capitalist; so, on the other hand, we have seen, how the methods of producing relative surplus-value, are, at the same time, methods of producing absolute surplus-value.	Wenn zur Produktion des absoluten Mehrwerts die bloß formelle Subsumtion der Arbeit unter das Kapital genügt, z.B. daß Handwerker, die früher für sich selbst oder auch als Gesellen eines Zunftmeisters arbeiteten, nun als Lohnarbeiter unter die direkte Kontrolle des Kapitalisten treten, zeigt sich andrerseits, wie die Methoden zur Produktion des relativen Mehrwerts zugleich Methoden zur Produktion des absoluten Mehrwerts sind.	ch16_clean.en-ch16_clean.de
Nay, more, the excessive prolongation of the working day turned out to be the peculiar product of Modern Industry.	Ja, die maßlose Verlängrung des Arbeitstags stellte sich als eigenstes Produkt der großen Industrie dar.	ch16_clean.en-ch16_clean.de
Generally speaking, the specifically capitalist mode of production ceases to be a mere means of producing relative surplus-value, so soon as that mode has conquered an entire branch of production; and still more so, so soon as it has conquered all the important branches.	Überhaupt hört die spezifisch kapitalistische Produktionsweise auf, bloßes Mittel zur Produktion des relativen Mehrwerts zu sein, sobald sie sich eines ganzen Produktionszweigs, und noch mehr, sobald sie sich aller entscheidenden Produktionszweige bemächtigt hat.	ch16_clean.en-ch16_clean.de
It then becomes the general, socially predominant form of production.	Sie wird jetzt allgemeine, gesellschaftlich herrschende Form des Produktionsprozesses.	ch16_clean.en-ch16_clean.de
As a special method of producing relative surplus-value, it remains effective only, first, in so far as it seizes upon industries that previously were only formally subject to capital, that is, so far as it is propagandist; secondly, in so far as the industries that have been taken over by it, continue to be revolutionised by changes in the methods of production.	Als besondre Methode zur Produktion des relativen Mehrwerts wirkt sie nur noch, erstens soweit sie dem Kapital bisher nur formell untergeordnete Industrien ergreift, also in ihrer Propaganda. Zweitens, soweit ihr bereits anheimgefallne Industrien fortwährend revolutioniert werden durch Wechsel der Produktionsmethoden.	ch16_clean.en-ch16_clean.de
From one standpoint, any distinction between absolute and relative surplus-value appears illusory.	Von gewissem Gesichtspunkt scheint der Unterschied zwischen absolutem und relativem Mehrwert überhaupt illusorisch.	ch16_clean.en-ch16_clean.de
Relative surplus-value is absolute, since it compels the absolute prolongation of the working day beyond the labour-time necessary to the existence of the labourer himself.	Der relative Mehr- wert ist absolut, denn er bedingt absolute Verlängrung des Arbeitstags über die zur Existenz des Arbeiters selbst notwendige Arbeitszeit.	ch16_clean.en-ch16_clean.de
Absolute surplus-value is relative, since it makes necessary such a development of the productiveness of labour, as will allow of the necessary labour-time being confined to a portion of the working day.	Der absolute Mehrwert ist relativ, denn er bedingt eine Entwicklung der Arbeitsproduktivität, welche erlaubt, die notwendige Arbeitszeit auf einen Teil des Arbeitstags zu beschränken.	ch16_clean.en-ch16_clean.de
But if we keep in mind the behaviour of surplus-value, this appearance of identity vanishes.	Faßt man aber die Bewegung des Mehrwerts ins Auge, so verschwindet dieser Schein der Einerleiheit.	ch16_clean.en-ch16_clean.de
Once the capitalist mode of production is established and become general, the difference between absolute and relative surplus-value makes itself felt, whenever there is a question of raising the rate of surplus-value.	Sobald die kapitalistische Produktionsweise einmal hergestellt und allgemeine Produktionsweise geworden, macht sich der Unterschied zwischen absolutem und relativem Mehrwert fühlbar, sobald es gilt, die Rate des Mehrwerts überhaupt zu steigern.	ch16_clean.en-ch16_clean.de
Assuming that labour-power is paid for at its value, we are confronted by this alternative: given the productiveness of labour and its normal intensity, the rate of surplus-value can be raised only by the actual prolongation of the working day; on the other hand, given the length of the working day, that rise can be effected only by a change in the relative magnitudes of the components of the working day, viz., necessary labour and surplus labour; a change which, if the wages are not to fall below the value of labour-power, presupposes a change either in the productiveness or in the intensity of the labour.	Vorausgesetzt, die Arbeitskraft werde zu ihrem Wert bezahlt, stehn wir dann vor dieser Alternative: Die Produktivkraft der Arbeit und ihren Normalgrad von Intensität gegeben, ist die Rate des Mehrwerts nur erhöhbar durch absolute Verlängrung des Arbeitstags; andrerseits, bei gegebner Grenze des Arbeitstags, ist die Rate des Mehrwerts nur erhöhbar durch relativen Größenwechsel seiner Bestandteile, der notwendigen Arbeit und der Mehrarbeit, was seinerseits, soll der Lohn nicht unter den Wert der Arbeitskraft sinken, Wechsel in der Produktivität oder Intensität der Arbeit voraussetzt.	ch16_clean.en-ch16_clean.de
If the labourer wants all his time to produce the necessary means of subsistence for himself and his race, he has no time left in which to work gratis for others.	Braucht der Arbeiter alle seine Zeit, um die zur Erhaltung seiner selbst und seiner Race nötigen Lebensmittel zu produzieren, so bleibt ihm keine Zeit, um unentgeltlich für dritte Personen zu arbeiten.	ch16_clean.en-ch16_clean.de
Without a certain degree of productiveness in his labour, he has no such superfluous time at his disposal; without such superfluous time, no surplus labour, and therefore no capitalists, no slave-owners, no feudal lords, in one word, no class of large proprietors.	Ohne einen gewissen Produktivitätsgrad der Arbeit keine solche disponible Zeit für den Arbeiter, ohne solche überschüssige Zeit keine Mehrarbeit und daher keine Kapitalisten, aber auch keine Sklavenhalter, keine Feudalbarone, in einem Wort keine Großbesitzerklasse.	ch16_clean.en-ch16_clean.de
Thus we may say that surplus-value rests on a natural basis; but this is permissible only in the very general sense, that there is no natural obstacle absolutely preventing one man from disburdening himself of the labour requisite for his own existence, and burdening another with it, any more, for instance, than unconquerable natural obstacle prevent one man from eating the flesh of another.	So kann von einer Naturbasis des Mehrwerts gesprochen werden, aber nur in dem ganz allgemeinen Sinn, daß kein absolutes Naturhindernis den einen abhält, die zu seiner eignen Existenz nötige Arbeit von sich selbst ab- und einem andern aufzuwälzen, z.B. ebensowenig wie absolute Naturhindernisse die einen abhalten, das Fleisch der andern als Nahrung zu verwenden.	ch16_clean.en-ch16_clean.de
No mystical ideas must in any way be connected, as sometimes happens, with this historically developed productiveness of labour.	(1a) Es sind durchaus nicht, wie es hier und da geschehn, mystische Vorstellungen mit dieser naturwüchsigen Produktivität der Arbeit zu verbinden.	ch16_clean.en-ch16_clean.de
It is only after men have raised themselves above the rank of animals, when therefore their labour has been to some extent socialised, that a state of things arises in which the surplus labour of the one becomes a condition of existence for the other.	Nur sobald die Menschen sich aus ihren ersten Tierzuständen her- ausgearbeitet, ihre Arbeit selbst also schon in gewissem Grad vergesellschaftet ist, treten Verhältnisse ein, worin die Mehrarbeit des einen zur Existenzbedingung des andern wird.	ch16_clean.en-ch16_clean.de
At the dawn of civilisation the productiveness acquired by labour is small, but so too are the wants which develop with and by the means of satisfying them.	In den Kulturanfängen sind die erworbnen Produktivkräfte der Arbeit gering, aber so sind die Bedürfnisse, die sich mit und an den Mitteln ihrer Befriedigung entwickeln.	ch16_clean.en-ch16_clean.de
Further, at that early period, the portion of society that lives on the labour of others is infinitely small compared with the mass of direct producers.	Ferner ist in jenen Anfängen die Proportion der Gesellschaftsteile, die von fremder Arbeit leben, verschwindend klein gegen die Masse der unmittelbaren Produzenten.	ch16_clean.en-ch16_clean.de
Along with the progress in the productiveness of labour, that small portion of society increases both absolutely and relatively.	Mit dem Fortschritt der gesellschaftlichen Produktivkraft der Arbeit wächst diese Proportion absolut und relativ.	ch16_clean.en-ch16_clean.de
Besides, capital with its accompanying relations springs up from an economic soil that is the product of a long process of development.	Das Kapitalverhältnis entspringt übrigens auf einem ökonomischen Boden, der das Produkt eines langen Entwicklungsprozesses ist.	ch16_clean.en-ch16_clean.de
The productiveness of labour that serves as its foundation and starting-point, is a gift, not of nature, but of a history embracing thousands of centuries.	Die vorhandne Produktivität der Arbeit, wovon es als Grundlage ausgeht, ist nicht Gabe der Natur, sondern einer Geschichte, die Tausende von Jahrhunderten umfaßt.	ch16_clean.en-ch16_clean.de
Apart from the degree of development, greater or less, in the form of social production, the productiveness of labour is fettered by physical conditions.	Von der mehr oder minder entwickelten Gestalt der gesellschaftlichen Produktion abgesehn, bleibt die Produktivität der Arbeit an Naturbedingungen gebunden.	ch16_clean.en-ch16_clean.de
These are all referable to the constitution of man himself (race, &c.), and to surrounding nature.	Sie sind alle rückführbar auf die Natur des Menschen selbst, wie Race usw., und die ihn umgebende Natur.	ch16_clean.en-ch16_clean.de
The external physical conditions fall into two great economic classes, (1) Natural wealth in means of subsistence, i.e., a fruitful soil, waters teeming with fish, &c., and (2), natural wealth in the instruments of labour, such as waterfalls, navigable rivers, wood, metal, coal, &c. At the dawn of civilisation, it is the first class that turns the scale; at a higher stage of development, it is the second.	Die äußeren Naturbedingungen zerfallen ökonomisch in zwei große Klassen, natürlichen Reichtum an Lebensmitteln, also Bodenfruchtbarkeit, fischreiche Gewässer usw., und natürlichen Reichtum an Arbeitsmitteln, wie lebendige Wassergefälle, schiffbare Flüsse, Holz, Metalle, Kohle usw. In den Kulturanfängen gibt die erstere, auf höherer Entwicklungsstufe die zweite Art des natürlichen Reichtums den Ausschlag.	ch16_clean.en-ch16_clean.de
Compare, for example, England with India, or in ancient times, Athens and Corinth with the shores of the Black Sea.	Man vergleiche z.B. England mit Indien oder, in der antiken Welt, Athen und Korinth mit den Uferländern des Schwarzen Meeres.	ch16_clean.en-ch16_clean.de
The fewer the number of natural wants imperatively calling for satisfaction, and the greater the natural fertility of the soil and the favourableness of the climate, so much less is the labour-time necessary for the maintenance and reproduction of the producer.	Je geringer die Zahl der absolut zu befriedigenden Naturbedürfnisse und je größer die natürliche Bodenfruchtbarkeit und Gunst des Klimas, desto geringer die zur Erhaltung und Reproduktion des Produzenten notwendige Arbeitszeit.	ch16_clean.en-ch16_clean.de
So much greater therefore can be the excess of his labours for others over his labour for himself.	Desto größer kann also der Überschuß seiner Arbeit für andere über seine Arbeit für sich selbst sein.	ch16_clean.en-ch16_clean.de
Diodorus long ago remarked this in relation to the ancient Egyptians. “It is altogether incredible how little trouble and expense the bringing up of their children causes them.	So bemerkt schon Diodor über die alten Ägypter: "Es ist ganz unglaublich, wie wenig Mühe und Kosten die Erziehung ihrer Kinder ihnen verursacht.	ch16_clean.en-ch16_clean.de
They cook for them the first simple food at hand; they also give them the lower part of the papyrus stem to eat, so far as it can be roasted in the fire, and the roots and stalks of marsh plants, some raw, some boiled and roasted.	Sie kochen ihnen die nächste beste einfache Speise; auch geben sie ihnen von der Papierstaude den untern Teil zu essen, soweit man ihn im Feuer rösten kann, und die Wurzeln und Stengel der Sumpfgewächse, teils roh, teils gesotten und gebraten.	ch16_clean.en-ch16_clean.de
Most of the children go without shoes and unclothed, for the air is so mild.	Die meisten Kinder gehn ohne Schuhe und unbekleidet, da die Luft so mild ist.	ch16_clean.en-ch16_clean.de
Hence a child, until he is grown up, costs his parents not more, on the whole, than twenty drachmas.	Daher kostet ein Kind seinen Eltern, bis es erwachsen ist, im ganzen nicht über zwanzig Drachmen.	ch16_clean.en-ch16_clean.de
It is this, chiefly, which explains why the population of Egypt is so numerous, and, therefore, why so many great works can be undertaken.”	Hieraus ist es hauptsächlich zu erklären, daß in Ägypten die Bevölkerung so zahlreich ist und darum so viele große Werke angelegt werden konnten."	ch16_clean.en-ch16_clean.de
Nevertheless the grand structures of ancient Egypt are less due to the extent of its population than to the large proportion of it that was freely disposable.	Indes sind die großen Bauwerke des alten Ägyptens dem Umfang seiner Bevölkerung weniger geschuldet, als der großen Proportion, worin sie disponibel war.	ch16_clean.en-ch16_clean.de
Just as the individual labourer can do more surplus labour in proportion as his necessary labour-time is less, so with regard to the working population. The smaller the part of it which is required for the production of the necessary means of subsistence, so much the greater is the part that can be set to do other work.	Wie der individuelle Arbeiter um so mehr Mehrarbeit liefern kann, je geringer seine notwendige Arbeitszeit, so, je geringer der zur Produktion der notwendigen Lebensmittel erheischte Teil der Arbeiterbevökerung, desto größer ihr für andres Werk disponibler Teil.	ch16_clean.en-ch16_clean.de
Capitalist production once assumed, then, all other circumstances remaining the same, and given the length of the working day, the quantity of surplus labour will vary with the physical conditions of labour, especially with the fertility of the soil.	Die kapitalistische Produktion einmal vorausgesetzt, wird, unter sonst gleichbleibenden Umständen und bei gegebner Länge des Arbeitstags, die Größe der Mehrarbeit mit den Naturbedingungen der Arbeit, namentlich auch der Bodenfruchtbarkeit, variieren.	ch16_clean.en-ch16_clean.de
But it by no means follows from this that the most fruitful soil is the most fitted for the growth of the capitalist mode of production.	Es folgt aber keineswegs umgekehrt, daß der fruchtbarste Boden der geeignetste zum Wachstum der kapitalistischen Produktionsweise.	ch16_clean.en-ch16_clean.de
This mode is based on the dominion of man over nature.	Sie unterstellt Herrschaft des Menschen über die Natur.	ch16_clean.en-ch16_clean.de
Where nature is too lavish, she “keeps him in hand, like a child in leading-strings.”	Eine zu verschwenderische Natur "hält ihn an ihrer Hand wie ein Kind am Gängelband".	ch16_clean.en-ch16_clean.de
She does not impose upon him any necessity to develop himself.	Sie macht seine eigne Entwicklung nicht zu einer Naturnotwendigkeit.	ch16_clean.en-ch16_clean.de
It is not the tropics with their luxuriant vegetation, but the temperate zone, that is the mother-country of capital.	Nicht das tropische Klima mit seiner überwuchernden Vegetation, sondern die gemäßigte Zone ist das Mutterland des Kapitals.	ch16_clean.en-ch16_clean.de
It is not the mere fertility of the soil, but the differentiation of the soil, the variety of its natural products, the changes of the seasons, which form the physical basis for the social division of labour, and which, by changes in the natural surroundings, spur man on to the multiplication of his wants, his capabilities, his means and modes of labour.	Es ist nicht die absolute Fruchtbarkeit des Bodens, sondern seine Differenzierung, die Mannigfaltigkeit seiner natürlichen Produkte, welche die Naturgrundlage der gesellschaftlichen Teilung der Arbeit bildet und den Menschen durch den Wechsel der Naturumstände, innerhalb deren er haust, zur Vermannigfachung seiner eignen Bedürfnisse, Fähigkeiten, Arbeitsmittel und Arbeitsweisen spornt.	ch16_clean.en-ch16_clean.de
It is the necessity of bringing a natural force under the control of society, of economising, of appropriating or subduing it on a large scale by the work of man’s hand, that first plays the decisive part in the history of industry.	Die Notwendigkeit, eine Naturkraft gesellschaftlich zu kontrollieren, damit hauszuhalten, sie durch Werke von Menschenhand auf großem Maßstab erst anzueignen oder zu zähmen, spielt die entscheidendste Rolle in der Geschichte der Industrie.	ch16_clean.en-ch16_clean.de
Examples are, the irrigation works in Egypt, Lombardy, Holland, or in India and Persia where irrigation by means of artificial canals, not only supplies the soil with the water indispensable to it, but also carries down to it, in the shape of sediment from the hills, mineral fertilisers.	So z.B. die Wasserreglung in Ägypten , Lombardei, Holland usw. Oder in Indien, Persien usw., wo die Überrieslung durch künstliche Kanäle dem Boden nicht nur das unentbehrliche Wasser, sondern mit dessen Geschlämme zugleich den Minenaldünger von den Bergen zuführt.	ch16_clean.en-ch16_clean.de
The secret of the flourishing state of industry in Spain and Sicily under the dominion of the Arabs lay in their irrigation works.	Das Geheimnis der Industrieblüte von Spanien und Sizilien unter arabischer Herrschaft war die Kanalisation.	ch16_clean.en-ch16_clean.de
Favourable natural conditions alone, give us only the possibility, never the reality, of surplus labour, nor, consequently, of surplus-value and a surplus-product.	Die Gunst der Naturbedingungen liefert immer nur die Möglichkeit, niemals die Wirklichkeit der Mehrarbeit, also des Mehrwerts oder des Mehrprodukts.	ch16_clean.en-ch16_clean.de
The result of difference in the natural conditions of labour is this, that the same quantity of labour satisfies, in different countries, a different mass of requirements, consequently, that under circumstances in other respects analogous, the necessary labour-time is different.	Die verschiednen Naturbedingungen der Arbeit bewirken, daß dieselbe Quantität Arbeit in verschiednen Ländern verschiedne Bedürfnismassen befriedigt , daß also, unter sonst analogen Umständen, die notwendige Arbeitszeit verschieden ist.	ch16_clean.en-ch16_clean.de
These conditions affect surplus labour only as natural limits, i.e., by fixing the points at which labour for others can begin.	Auf die Mehrarbeit wirken sie nur als Naturschranke, d.h. durch die Bestimmung des Punkts, wo die Arbeit für andre beginnen kann.	ch16_clean.en-ch16_clean.de
In proportion as industry advances, these natural limits recede.	In demselben Maß, worin die Industrie vortritt, weicht diese Naturschranke zurück.	ch16_clean.en-ch16_clean.de
In the midst of our West European society, where the labourer purchases the right to work for his own livelihood only by paying for it in surplus labour, the idea easily takes root that it is an inherent quality of human labour to furnish a surplus-product.	Mitten in der westeuropäischen Gesellschaft, wo der Arbeiter die Erlaubnis, für seine eigne Existenz zu arbeiten, nur durch Mehrarbeit erkauft, wird sich leicht eingebildet, es sei eine der menschlichen Arbeit eingeborne Qualität, ein Surplusprodukt zu liefern.	ch16_clean.en-ch16_clean.de
But consider, for example, an inhabitant of the eastern islands of the Asiatic Archipelago, where sago grows wild in the forests.	Man nehme aber z.B. den Einwohner der östlichen Inseln des asiatischen Archipelagus, wo der Sago wild im Walde wächst.	ch16_clean.en-ch16_clean.de
“When the inhabitants have convinced themselves, by boring a hole in the tree, that the pith is ripe, the trunk is cut down and divided into several pieces, the pith is extracted, mixed with water and filtered: it is then quite fit for use as sago.	"Wenn die Einwohner, indem sie ein Loch in den Baum bohren, sich davon überzeugt haben, daß das Mark reif ist, so wird der Stamm umgeschlagen und in mehrere Stücke geteilt, das Mark wird herausgekratzt, mit Wasser gemischt und geseiht, es ist dann vollkommen brauchbares Sagomehl.	ch16_clean.en-ch16_clean.de
One tree commonly yields 300 lbs., and occasionally 500 to 600 lbs.	Ein Baum gibt gemeiniglich 300 Pfund und kann 500 bis 600 Pfund geben.	ch16_clean.en-ch16_clean.de
There, then, people go into the forests, and cut bread for themselves, just as with us they cut fire-wood.” 10 Suppose now such an eastern bread-cutter requires 12 working hours a week for the satisfaction of all his wants.	Man geht dort also in den Wald und schneidet sich sein Brot, wie man bei uns sein Brennholz schlägt." Gesetzt, ein solcher ostasiatischer Brotschneider brauche 12 Arbeitsstunden in der Woche zur Befriedigung aller seiner Bedürfnisse.	ch16_clean.en-ch16_clean.de
Nature’s direct gift to him is plenty of leisure time.	Was ihm die Gunst der Natur unmittelbar gibt, ist viel Mußezeit.	ch16_clean.en-ch16_clean.de
Before he can apply this leisure time productively for himself, a whole series of historical events is required; before he spends it in surplus labour for strangers, compulsion is necessary.	Damit er diese produktiv für sich selbst verwende, ist eine ganze Reihe geschichtlicher Umstände, damit er sie in Mehrarbeit für fremde Personen verausgabe, ist äußrer Zwang erheischt.	ch16_clean.en-ch16_clean.de
If capitalist production were introduced, the honest fellow would perhaps have to work six days a week, in order to appropriate to himself the product of one working day.	Würde kapitalistische Produktion eingeführt, so müßte der Brave vielleicht 6 Tage in der Woche arbeiten, um sich selbst das Produkt eines Arbeitstags anzueignen.	ch16_clean.en-ch16_clean.de
The bounty of Nature does not explain why he would then have to work 6 days a week, or why he must furnish 5 days of surplus labour.	Die Gunst der Natur erklärt nicht, warum er jetzt 6 Tage in der Woche arbeitet oder warum er 5 Tage Mehrarbeit liefert.	ch16_clean.en-ch16_clean.de
It explains only why his necessary labour-time would be limited to one day a week.	Sie erklärt nur, warum seine notwendige Arbeitszeit auf einen Tag in der Woche beschränkt ist.	ch16_clean.en-ch16_clean.de
But in no case would his surplus-product arise from some occult quality inherent in human labour.		ch16_clean.en-ch16_clean.de
Thus, not only does the historically developed social productiveness of labour, but also its natural productiveness, appear to be productiveness of the capital with which that labour is incorporated.	In keinem Fall aber entspränge sein Mehrprodukt aus einer der menschlichen Arbeit eingebornen, okkulten Qualität.	ch16_clean.en-ch16_clean.de
Ricardo never concerns himself about the origin of surplus-value.	Wie die geschichtlich entwickelten, gesellschaftlichen, so erscheinen die naturbedingten Produktivkräfte der Arbeit als Produktivkräfte des Kapitals, dem sie einverleibt wird. - Ricardo kümmert sich nie um den Ursprung des Mehrwerts.	ch16_clean.en-ch16_clean.de
He treats it as a thing inherent in the capitalist mode of production, which mode, in his eyes, is the natural form of social production.	Er behandelt ihn wie eine der kapitalistischen Produktionsweise, der in seinen Augen natürlichen Form der gesellschaftlichen Produktion, inhärente Sache.	ch16_clean.en-ch16_clean.de
Whenever he discusses the productiveness of labour, he seeks in it, not the cause of surplus-value, but the cause that determines the magnitude of that value.	Wo er von der Produktivität der Arbeit spricht, da sucht er in ihr nicht die Ursache des Daseins von Mehrwert, sondern nur die Ursache, die seine Größe bestimmt.	ch16_clean.en-ch16_clean.de
On the other hand, his school has openly proclaimed the productiveness of labour to be the originating cause of profit (read: Surplus-value).	Dagegen hat seine Schule die Produktivkraft der Arbeit laut proklamiert als die Entstehungsursache des Profits (lies: Mehrwerts).	ch16_clean.en-ch16_clean.de
This at all events is a progress as against the mercantilists who, on their side, derived the excess of the price over the cost of production of the product, from the act of exchange, from the product being sold above its value.	Jedenfalls ein Fortschritt gegenüber den Merkantilisten, die ihrerseits den Überschuß des Preises der Produkte über ihre Produktionskosten aus dem Austausch herleiten, aus ihrem Verkauf über ihren Wert.	ch16_clean.en-ch16_clean.de
Nevertheless, Ricardo’s school simply shirked the problem, they did not solve it.	Trotzdem hatte auch Ricardos Schule das Problem bloß umgangen, nicht gelöst.	ch16_clean.en-ch16_clean.de
In fact these bourgeois economists instinctively saw, and rightly so, that it is very dangerous to stir too deeply the burning question of the origin of surplus-value.	In der Tat hatten diese bürgerlichen Ökonomen den richtigen Instinkt, es sei sehr gefährlich, die brennende Frage nach dem Ursprung des Mehrwerts zu tief zu ergründen.	ch16_clean.en-ch16_clean.de
But what are we to think of John Stuart Mill, who, half a century after Ricardo, solemnly claims superiority over the mercantilists, by clumsily repeating the wretched evasions of Ricardo’s earliest vulgarisers?	Was aber sagen, wenn ein halbes Jahrhundert nach Ricardo Herr John Stuart Mill würdevoll seine Überlegenheit über die Merkantilisten konstatiert, indem er die faulen Ausflüchte der ersten Verflacher Ricardos schlecht wiederholt?	ch16_clean.en-ch16_clean.de
Mill says: “The cause of profit is that labour produces more than is required for its support.”	Mill sagt: "Die Ursache des Profits ist die, daß die Arbeit mehr produziert, als für ihren Unterhalt erforderlich ist."	ch16_clean.en-ch16_clean.de
So far, nothing but the old story; but Mill wishing to add something of his own, proceeds: “To vary the form of the theorem; the reason why capital yields a profit, is because food, clothing, materials and tools, last longer than the time which was required to produce them.”	Soweit nicht als die alte Leier; aber Mill will auch Eignes hinzutun: "Oder um die Form des Satzes zu variieren: der Grund, weshalb das Kapital einen Profit liefert, ist der, daß Nahrung, Kleider, Rohstoffe und Arbeitsmittel längere Zeit dauern, als zu ihrer Produktion erforderlich ist."	ch16_clean.en-ch16_clean.de
He here confounds the duration of labour-time with the duration of its products.	Mill verwechselt hier die Dauer der Arbeitszeit mit der Dauer ihrer Produkte.	ch16_clean.en-ch16_clean.de
According to this view, a baker whose product lasts only a day, could never extract from his workpeople the same profit, as a machine maker whose products endure for 20 years and more.	Nach dieser Ansicht würde ein Bäcker, dessen Produkte nur einen Tag dauern, aus seinen Lohnarbeitern nie denselben Profit ziehen können wie ein Maschinenbauer, dessen Produkte zwanzig Jahre und länger dauern.	ch16_clean.en-ch16_clean.de
Of course it is very true, that if a bird’s nest did not last longer than the time it takes in building, birds would have to do without nests.	Allerdings, wenn die Vogelnester nicht längere Zeit vorhielten, als zu ihrem Bau erforderlich, so würden die Vögel sich ohne Nester behelfen müssen.	ch16_clean.en-ch16_clean.de
This fundamental truth once established, Mill establishes his own superiority over the mercantilists. “We thus see,” he proceeds, “that profit arises, not from the incident of exchange, but from the productive power of labour; and the general profit of the country is always what the productive power of labour makes it, whether any exchange takes place or not.	Diese Grundwahrheit einmal festgestellt, stellt Mill seine Überlegenheit über die Merkantilisten fest: "Wir sehn also, daß der Profit entsteht, nicht aus dem Zwischenfall der Austäusche, sondern aus der Produktivkraft der Arbeit; der Gesamtprofit eines Landes ist immer bestimmt durch die Produktivkraft der Arbeit, gleichviel ob Austausch stattfindet oder nicht.	ch16_clean.en-ch16_clean.de
If there were no division of employments, there would be no buying or selling, but there would still be profit.”	Bestände keine Teilung der Beschäftigungen, so gäbe es weder Kauf noch Verkauf, aber immer noch Profit."	ch16_clean.en-ch16_clean.de
For Mill then, exchange, buying and selling, those general conditions of capitalist production, are but an incident, and there would always be profits even without the purchase and sale of labour-power!	Hier sind also Austausch, Kauf und Verkauf, die allgemeinen Bedingungen der kapitalistischen Produktion, ein purer Zwischenfall, und es gibt immer noch Profit ohne Kauf und Verkauf der Arbeitskraft!	ch16_clean.en-ch16_clean.de
“If,” he continues, “the labourers of the country collectively produce twenty per cent more than their wages, profits will be twenty per cent, whatever prices may or may not be.”	Weiter: "Produziert die Gesamtheit der Arbeiter eines Landes 20% über ihre Lohnsumme, so werden die Profite 20% sein, was auch immer der Stand der Warenpreise."	ch16_clean.en-ch16_clean.de
This is, on the one hand, a rare bit of tautology; for if labourers produce a surplus-value of 20% for the capitalist, his profit will be to the total wages of the labourers as 20:100.	Dies ist einerseits eine äußerst gelungne Tautologie, denn wenn Arbeiter einen Mehrwert von 20% für ihre Kapitalisten produzieren, so werden sich die Profite zum Gesamtlohn der Arbeiter verhalten wie 20 : 100.	ch16_clean.en-ch16_clean.de
On the other hand, it is absolutely false to say that “profits will be 20%.”	Andrerseits ist es absolut falsch, daß die Profite "20% sein werden".	ch16_clean.en-ch16_clean.de
They will always be less, because they are calculated upon the sum total of the capital advanced.	Sie müssen immer kleiner sein, weil Profite berechnet werden auf die Totalsumme des vorgeschoßnen Kapitals.	ch16_clean.en-ch16_clean.de
If, for example, the capitalist have advanced £500, of which £4OO is laid out in means of production and £ in wages, and if the rate of surplus-value be 20%, the rate of profit will be 20:500, i.e., 4% and not 20%.	Der Kapitalist habe z.B. 500 Pfd.St. vorgeschossen, davon 400 Pfd.St. in Produktionsmitteln, 100 Pfd.St. in Arbeitslohn.	ch16_clean.en-ch16_clean.de
Then follows a splendid example of Mill’s method of handling the different historical forms of social production.	Die Rate des Mehrwerts sei, wie angenommen, 20%, so wird die Profitrate sein wie 20 : 500, d.h. 4% und nicht 20%.	ch16_clean.en-ch16_clean.de
“I assume, throughout, the state of things which, where the labourers and capitalists are separate classes, prevails, with few exceptions, universally; namely, that the capitalist advances the whole expenses, including the entire remuneration of the labourer.”	Folgt eine glänzende Probe, wie Mill die verschiednen geschichtlichen Formen der gesellschaftlichen Produktion behandelt: "Ich setze überall den gegenwärtigen Stand der Dinge voraus, der bis auf wenige Ausnahmen überall herrscht, d.h. daß der Kapitalist alle Vorschüsse macht, die Bezahlung des Arbeiters einbegriffen."	ch16_clean.en-ch16_clean.de
Strange optical illusion to see everywhere a state of things which as yet exists only exceptionally on our earth.	Seltsame optische Täuschung, überall einen Zustand zu sehn, der bis jetzt nur ausnahmsweise auf dem Erdball herrscht!	ch16_clean.en-ch16_clean.de
	Doch weiter. Mill ist gut genug, zuzugeben, "es sei nicht eine absolute Notwendigkeit, daß dem so sei". <In seinem Brief an N. F. Danielson vom 28. November 1878 schlug Marx folgende Fassung dieses Absatzes vor: Folgt eine glänzende Probe, wie Mill die verschiednen geschichtlichen Formen der gesellschaftlichen Produktion behandelt: "Ich setze überall", sagt er, "den gegenwärtigen Stand der Dinge voraus, der bis auf wenige Ausnahmen überall herrscht, wo Arbeiter und Kapitalisten einander als Klassen gegenüberstehen, d.h., daß der Kapitalist alle Vorschüsse macht, die Bezahlung des Arbeiters einbegriffen."	ch16_clean.en-ch16_clean.de
But let us finish – Mill is willing to concede, “that he should do so is not a matter of inherent necessity.”	Herr Mill will gern glauben, es sei nicht eine absolute Notwendigkeit, daß dem so sei - selbst in dem ökonomischen System, in dem Arbeiter und Kapitalisten einander als Klassen gegenüberstehen.> Im Gegenteil.	ch16_clean.en-ch16_clean.de
On the contrary: “the labourer might wait, until the production is complete, for all that part of his wages which exceeds mere necessaries: and even for the whole, if he has funds in hand sufficient for his temporary support.	"Der Arbeiter könnte, selbst mit seinem ganzen Lohnbetrage, die Zahlung abwarten, bis die Arbeit vollständig fertig ist, wenn er die zu seiner Erhaltung in der Zwischenzeit nötigen Mittel hätte.	ch16_clean.en-ch16_clean.de
But in the latter case, the labourer is to that extent really a capitalist in the concern, by supplying a portion of the funds necessary for carrying it on.”	Aber in diesem Falle wäre er in gewissem Grade ein Kapitalist, der Kapital ins Geschäft legte, und einen Teil der zu seiner Fortführung nötigen Fonds lieferte."	ch16_clean.en-ch16_clean.de
Mill might have gone further and have added, that the labourer who advances to himself not only the necessaries of life but also the means of production, is in reality nothing but his own wage-labourer.	Ebensogut könnte Mill sagen, der Arbeiter, der sich selbst nicht nur die Lebensmittel, sondern auch die Arbeitsmittel vorschießt, sei in Wirklichkeit sein eigner Lohnarbeiter.	ch16_clean.en-ch16_clean.de
He might also have said that the American peasant proprietor is but a serf who does enforced labour for himself instead of for his lord.	Oder der amerikanische Bauer sei sein eigner Sklave, der nur für sich selbst statt für einen fremden Herrn frondet.	ch16_clean.en-ch16_clean.de
After thus proving clearly, that even if capitalist production had no existence, still it would always exist, Mill is consistent enough to show, on the contrary, that it has no existence, even when it does exist.	Nachdem uns Mill derart klärlich erwiesen, daß die kapitalistische Produktion, selbst wenn sie nicht existierte, dennoch immer existieren würde, ist er nun konsequent genug, zu beweisen, daß sie selbst dann nicht existiert, wenn sie existiert: "Und selbst im vorigen Fall" (wenn der Kapitalist dem Lohnarbeiter seine sämtlichen Subsistenzmittel vorschießt) "kann der Arbeiter unter demselben Gesichtspunkt betrachtet werden" (d.h. als ein Kapitalist).	ch16_clean.en-ch16_clean.de
“And even in the former case” (when the workman is a wage labourer to whom the capitalist advances all the necessaries of life, he the labourer), “may be looked upon in the same light,” (i.e., as a capitalist), “since, contributing his labour at less than the market-price, (!) he may be regarded as lending the difference (?) to his employer and receiving it back with interest, &c.” 12 In reality, the labourer advances his labour gratuitously to the capitalist during, say one week, in order to receive the market price at the end of the week, &c., and it is this which, according to Mill, transforms him into a capitalist.	"Denn indem er seine Arbeit unter dem Marktpreise (!) hergibt, kann er angesehn werden, als schösse er die Differenz (?) seinem Unternehmer vor usw."(9a) In der tatsächlichen Wirklichkeit schießt der Arbeiter dem Kapitalisten seine Arbeit während einer Woche usw. umsonst vor, um am Ende der Woche usw. ihren Marktpreis zu erhalten; das macht ihn, nach Mill, zum Kapitalisten!	ch16_clean.en-ch16_clean.de
On the level plain, simple mounds look like hills; and the imbecile flatness of the present bourgeoisie is to be measured by the altitude of its great intellects.	In der platten Ebene erscheinen auch Erdhaufen als Hügel; man messe die Plattheit unsrer heutigen Bourgeoisie am Kaliber ihrer "großen Geister".	ch16_clean.en-ch16_clean.de

