Chapter 18: Various Formula for the Rate of Surplus-Value We have seen that the rate of surplus-value is represented by the following formulae: I. Surplus-value ( s ) = Surplus-value = Surplus-labour Variable Capital v Value of labour-power Necessary labour The two first of these formulae represent, as a ratio of values, that which, in the third, is represented as a ratio of the times during which those values are produced.	SECHZEHNTES KAPITEL Verschiedne Formeln für die Rate des Mehrwerts Man hat gesehn, daß die Rate des Mehrwerts sich darstellt in den Formeln: I. Mehrwert/Variables Kapital (m/v) = Mehrwert/Wert der Arbeitskraft = Mehrarbeit/Notwendige Arbeit. Die zwei ersten Formen stellen als Verhältnis von Werten dar, was die dritte als Verhältnis der Zeiten, worin diese Werte produziert werden.	ch18_clean.en-ch18_clean.de
These formulae, supplementary the one to the other, are rigorously definite and correct.	Diese einander ersetzenden Formeln sind begrifflich streng.	ch18_clean.en-ch18_clean.de
We therefore find them substantially, but not consciously, worked out in classical Political Economy.	Man findet sie daher wohl der Sache nach, aber nicht bewußt ausgearbeitet in der klassischen politischen Ökonomie.	ch18_clean.en-ch18_clean.de
There we meet with the following derivative formulae. II.	Hier begegnen wir dagegen den folgenden abgleiteten Formeln: II. Mehrarbeit /Arbeitstag <In der autorisierten französischen Ausgabe setzt Marx diese erste Formel in Klammern, "weil sich der Begriff der Mehrarbeit in der bürgerlichen politischen Ökonomie nicht klar ausgedrückt findet".> = Mehrwert/Produktenwert = Mehrprodukt/Gesamtprodukt.	ch18_clean.en-ch18_clean.de
Surplus-labour = Surplus-value = Surplus-product Working day Value of the Product Total Product One and the same ratio is here expressed as a ratio of labour-times, of the values in which those labour-times are embodied, and of the products in which those values exist.	Eine und dieselbe Proportion ist hier abwechselnd ausgedrückt in der Form der Arbeitszeiten, der Werte, worin sie sich verkörpern, der Produkte, worin diese Werte existieren.	ch18_clean.en-ch18_clean.de
It is of course understood that, by “Value of the Product,” is meant only the value newly created in a working day, the constant part of the value of the product being excluded.	Es wird natürlich unterstellt, daß unter Wert des Produkts nur das Wertprodukt des Arbeitstags zu verstehn, der konstante Teil des Produktenwerts aber ausgeschlossen ist.	ch18_clean.en-ch18_clean.de
In all of these formulae (II. ), the actual degree of exploitation of labour, or the rate of surplus-value, is falsely expressed.	In allen diesen Formeln ist der wirkliche Exploitationsgrad der Arbeit oder die Rate des Mehrwerts falsch ausgedrückt.	ch18_clean.en-ch18_clean.de
Let the working day be 12 hours.	Der Arbeitstag sei 12 Stunden.	ch18_clean.en-ch18_clean.de
Then, making the same assumptions as in former instances, the real degree of exploitation of labour will be represented in the following proportions. 6 hours surplus-labour = Surplus-value of 3 sh. = 100% 6 hours necessary labour Variable Capital of 3 sh.	Mit den andren Annahmen unsres früheren Beispiels stellt sich in diesem Fall der wirkliche Exploitationsgrad der Arbeit dar in den Proportionen: 6 Stunden Mehrarbeit/6 Stunden notwendige Arbeit = Mehrwert von 3 sh./Variables Kapital von 3 sh. = 100%.	ch18_clean.en-ch18_clean.de
From formulae II. we get very differently, 6 hours surplus-labour = Surplus-value of 3 sh. = 50% Working day of 12 hours Value created of 6 sh.	Nach den Formeln II erhalten wir dagegen: 6 Stunden Mehrarbeit/Arbeitstag von 12 Stunden = Mehrwert von 3 sh./Wertprodukt von 6 sh. = 50%.	ch18_clean.en-ch18_clean.de
These derivative formulae express, in reality, only the proportion in which the working day, or the value produced by it, is divided between capitalist and labourer.	Diese abgeleiteten Formeln drücken in der Tat die Proportion aus, worin der Arbeitstag oder sein Wertprodukt sich zwischen Kapitalist und Arbeiter teilt.	ch18_clean.en-ch18_clean.de
If they are to be treated as direct expressions of the degree of self-expansion of capital, the following erroneous law would hold good: Surplus-labour or surplus-value can never reach 100%.	Gelten sie daher als unmittelbare Ausdrücke des Selbstverwertungsgrades des Kapitals, so gilt das falsche Gesetz: Die Mehrarbeit oder der Mehrwert kann nie 100% erreichen.	ch18_clean.en-ch18_clean.de
Since the surplus-labour is only an aliquot part of the working day, or since surplus-value is only an aliquot part of the value created, the surplus-labour must necessarily be always less than the working day, or the surplus-value always less than the total value created.	Da die Mehrarbeit stets nur einen aliquoten Teil des Arbeitstags oder der Mehrwert stets nur einen aliquoten Teil des Wertprodukts bilden kann, ist die Mehrarbeit notwendigerweise stets kleiner als der Arbeitstag oder der Mehrwert stets kleiner als das Wertprodukt.	ch18_clean.en-ch18_clean.de
In order, however, to attain the ratio of 100: they must be equal.	Um sich zu verhalten wie 100/100, müßten sie aber gleich sein.	ch18_clean.en-ch18_clean.de
In order that the surplus-labour may absorb the whole day (i.e., an average day of any week or year), the necessary labour must sink to zero.	Damit die Mehrarbeit den ganzen Arbeitstag absorbiere (es handelt sich hier um den Durchschnittstag der Arbeitswoche, des Arbeitsjahrs usw.), müßte die notwendige Arbeit auf Null sinken.	ch18_clean.en-ch18_clean.de
But if the necessary labour vanish, so too does the surplus-labour, since it is only a function of the former.	Verschwindet aber die notwendige Arbeit, so verschwindet auch die Mehrarbeit, da letztre nur eine Funktion der ersten.	ch18_clean.en-ch18_clean.de
The ratio Surplus-labour or Surplus-value Working day Value created can therefore never reach the limit 100/100, still less rise to 100 + x/100.	Die Proportion Mehrarbeit/Arbeitstag = Mehrwert/Wertprodukt kann also niemals die Grenze 100/100 erreichen und noch weniger auf 100+x/100 steigen.	ch18_clean.en-ch18_clean.de
But not so the rate of surplus-value, the real degree of exploitation of labour.	Wohl aber die Rate des Mehrwerts oder der wirkliche Exploitationsgrad der Arbeit.	ch18_clean.en-ch18_clean.de
Take, e.g., the estimate of L. de Lavergne, according to which the English agricultural labourer gets only 1/4, the capitalist (farmer) on the other hand 3/ of the product 2 or its value, apart from the question of how the booty is subsequently divided between the capitalist, the landlord, and others.	Nimm z.B. die Schätzung des Herrn L. de Lavergne, wonach der englische Ackerbauarbeiter nur 1/4, der Kapitalist (Pächter) dagegen 3/4 des Produkts oder seines Werts erhält, wie die Beute sich immer zwischen Kapitalist und Grundeigentümer usw. nachträglich weiter verteilt.	ch18_clean.en-ch18_clean.de
According to this, this surplus-labour of the English agricultural labourer is to his necessary labour as 3:1, which gives a rate of exploitation of 300%.	Die Mehrarbeit des englischen Landarbeiters verhält sich danach zu seiner notwendigen Arbeit = 3 : 1, ein Prozentsatz der Exploitation von 300%.	ch18_clean.en-ch18_clean.de
The favorite method of treating the working day as constant in magnitude became, through the use of formulae II., a fixed usage, because in them surplus-labour is always compared with a working day of given length.	Die Schulmethode, den Arbeitstag als konstante Größe zu behandeln, wurde durch Anwendung der Formeln II befestigt, weil man hier die Mehrarbeit stets mit einem Arbeitstag von gegebner Größe vergleicht.	ch18_clean.en-ch18_clean.de
The same holds good when the repartition of the value produced is exclusively kept in sight.	Ebenso, wenn die Teilung des Wertprodukts ausschließlich ins Auge gefaßt wird.	ch18_clean.en-ch18_clean.de
The working day that has already been realized in given value, must necessarily be a day of given length.	Der Arbeitstag, der sich bereits in einem Wertprodukt vergegenständlicht hat, ist stets ein Arbeitstag von gegebenen Grenzen.	ch18_clean.en-ch18_clean.de
The habit of representing surplus-value and value of labour-power as fractions of the value created – a habit that originates in the capitalist mode of production itself, and whose import will hereafter be disclosed – conceals the very transaction that characterizes capital, namely the exchange of variable capital for living labour-power, and the consequent exclusion of the labourer from the product.	Die Darstellung von Mehrwert und Wert der Arbeitskraft als Bruchteilen des Wertprodukts - eine Darstellungsweise, die übrigens aus der kapitalistischen Produktionsweise selbst erwächst und deren Bedeutung sich später erschließen wird - versteckt den spezifischen Charakter des Kapitalverhältnisses, nämlich den Austausch des variablen Kapitals mit der lebendigen Arbeitskraft und den entsprechenden Ausschluß des Arbeiters vom Produkt.	ch18_clean.en-ch18_clean.de
Instead of the real fact, we have false semblance of an association, in which labourer and capitalist divide the product in proportion to the different elements which they respectively contribute towards its formation.	An die Stelle tritt der falsche Schein eines Assoziationsverhältnisses, worin Arbeiter und Kapitalist das Produkt nach dem Verhältnis seiner verschiednen Bildungsfaktoren teilen. Übrigens sind die Formeln II stets in die Formeln I rückverwandelbar.	ch18_clean.en-ch18_clean.de
Moreover, the formulae II. can at any time be reconverted into formulae I. If, for instance, we have Surplus-labour of 6 hours Working day of 12 hours then the necessary labour-time being 12 hours less the surplus-labour of 6 hours, we get the following result, Surplus-labour of 6 hours = 100 Necessary labour of 6 hours 100 There is a third formula which I have occasionally already anticipated; it is III.	Haben wir z.B. Mehrarbeit von 6 Stunden/Arbeitstag von 12 Stunden, so ist die notwendige Arbeitszeit = Arbeitstag von zwölf Stunden minus Mehrarbeit von sechs Stunden, und so ergibt sich: Mehrarbeit von 6 Stunden/Notwendige Arbeit von 6 Stunden = 100/100. Eine dritte Formel, die ich gelegentlich schon antizipiert habe, ist: III. Mehrwert/Wert der Arbeitskraft = Mehrarbeit/Notwendige Arbeit = Unbezahlte Arbeit/Bezahlte Arbeit.	ch18_clean.en-ch18_clean.de
Surplus-value = Surplus-labour = Unpaid labour Value of labour-power Necessary labour Paid labour After the investigations we have given above, it is no longer possible to be misled, by the formula Unpaid labour, Paid labour into concluding, that the capitalist pays for labour and not for labour-power.	Das Mißverständnis, wozu die Formel Unbezahlte Arbeit/Bezahlte Arbeit verleiten könnte, als zahle der Kapitalist die Arbeit und nicht die Arbeitskraft, fällt nach der früher gegebenen Entwicklung fort.	ch18_clean.en-ch18_clean.de
This formula is only a popular expression for Surplus-labour, Necessary labour The capitalist pays the value, so far as price coincides with value, of the labour-power, and receives in exchange the disposal of the living labour-power itself.	Unbezahlte Arbeit/Bezahlte Arbeit ist nur populärer Ausdruck für Mehrarbeit/Notwendige Arbeit. Der Kapitalist zahlt den Wert, resp. davon abweichenden Preis der Arbeitskraft und erhält im Austausch die Verfügung über die lebendige Arbeitskraft selbst.	ch18_clean.en-ch18_clean.de
His usufruct is spread over two periods.	Seine Nutznießung dieser Arbeitskraft zerfällt in zwei Perioden.	ch18_clean.en-ch18_clean.de
During one the labourer produces a value that is only equal to the value of his labour-power; he produces its equivalent.	Während der einen Periode produziert der Arbeiter nur einen Wert = Wert seiner Arbeitskraft, also nur ein Äquivalent.	ch18_clean.en-ch18_clean.de
This the capitalist receives in return for his advance of the price of the labour-power, a product ready made in the market.	Für den vorgeschoßnen Preis der Arbeitskraft erhält so der Kapitalist ein Produkt vom selben Preis. Es ist, als ob er das Produkt fertig auf dem Markt gekauft hätte.	ch18_clean.en-ch18_clean.de
During the other period, the period of surplus-labour, the usufruct of the labour-power creates a value for the capitalist, that costs him no equivalent.	In der Periode der Mehrarbeit dagegen bildet die Nutznießung der Arbeitskraft Wert für den Kapitalisten, ohne ihm einen Wertersatz zu kosten.	ch18_clean.en-ch18_clean.de
This expenditure of labour-power comes to him gratis.	Er hat diese Flüssigmachung der Arbeitskraft umsonst.	ch18_clean.en-ch18_clean.de
In this sense it is that surplus-labour can be called unpaid labour.	In diesem Sinn kann die Mehrarbeit unbezahlte Arbeit heißen.	ch18_clean.en-ch18_clean.de
Capital, therefore, it not only, as Adam Smith says, the command over labour.	Das Kapital ist also nicht nur Kommando über Arbeit, wie A. Smith sagt.	ch18_clean.en-ch18_clean.de
It is essentially the command over unpaid labour.	Es ist wesentlich Kommando über unbezahlte Arbeit.	ch18_clean.en-ch18_clean.de
All surplus-value, whatever particular form (profit, interest, or rent), it may subsequently crystallize into, is in substance the materialisation of unpaid labour.	Aller Mehrwert, in welcher besondern Gestalt von Profit, Zins, Rente usw. er sich später kristallisiere, ist seiner Substanz nach Materiatur unbezahlter Arbeitszeit.	ch18_clean.en-ch18_clean.de
The secret of the self-expansion of capital resolves itself into having the disposal of a definite quantity of other people’s unpaid labour.	Das Geheimnis von der Selbstverwertung des Kapitals löst sich auf in seine Verfügung über ein bestimmtes Quantum unbezahlter fremder Arbeit.	ch18_clean.en-ch18_clean.de

