Chapter 20: Time-Wages Wages themselves again take many forms, a fact not recognizable in the ordinary economic treatises which, exclusively interested in the material side of the question, neglect every difference of form.	ACHTZEHNTES KAPITEL Der Zeitlohn Der Arbeitslohn nimmt selbst wieder sehr mannigfaltige Formen an, ein Umstand, nicht erkennbar aus den ökonomischen Kompendien, die in ihrer brutalen Interessiertheit für den Stoff jeden Formunterschied vernachlässigen.	ch20_clean.en-ch20_clean.de
An exposition of all these forms however, belongs to the special study of wage labour, not therefore to this work.	Eine Darstellung aller dieser Formen gehört jedoch in die spezielle Lehre von der Lohnarbeit, also nicht in dieses Werk.	ch20_clean.en-ch20_clean.de
Still the two fundamental forms must be briefly worked out here.	Dagegen sind die zwei herrschenden Grundformen hier kurz zu entwickeln.	ch20_clean.en-ch20_clean.de
The sale of labour-power, as will be remembered, takes place for a definite period of time.	Der Verkauf der Arbeitskraft findet, wie man sich erinnert, stets für bestimmte Zeitperioden statt.	ch20_clean.en-ch20_clean.de
The converted form under which the daily, weekly, &c., value of labour-power presents itself, is hence that of time-wages, therefore day-wages, &c. Next it is to be noted that the laws set forth, in the 17th chapter, on the changes in the relative magnitudes of price of labour-power and surplus-value, pass by a simple transformation of form, into laws of wages.	Die verwandelte Form, worin der Tageswert, Wochenwert usw. der Arbeitskraft sich unmittelbar darstellt, ist daher die des "Zeitlohns", also Tageslohn usw. Es ist nun zunächst zu bemerken, daß die im fünfzehnten Kapitel dargestellten Gesetze über den Größenwechsel von Preis der Arbeitskraft und Mehrwert sich durch einfache Formveränderung in Gesetze des Arbeitslohns verwandeln.	ch20_clean.en-ch20_clean.de
Similarly the distinction between the exchange-value of labour power, and the sum of the necessaries of life into which this value is converted, now reappears as the distinction between nominal and real wages.	Ebenso erscheint der Unterschied zwischen dem Tauschwert der Arbeitskraft und der Masse der Lebensmittel, worin sich dieser Wert umsetzt, jetzt als Unterschied von nominellem und reellem Arbeitslohn.	ch20_clean.en-ch20_clean.de
It would be useless to repeat here, with regard to the phenomenal form, what has been already worked out in the substantial form.	Es wäre nutzlos, in der Erscheinungsform zu wiederholen, was in der wesentlichen Form bereits entwickelt.	ch20_clean.en-ch20_clean.de
We limit ourselves therefore to a few points characteristic of time-wages.	Wir beschränken uns daher auf wenige, den Zeitlohn charakterisierende Punkte.	ch20_clean.en-ch20_clean.de
The sum of money which the labourer receives for his daily or weekly labour, forms the amount of his nominal wages, or of his wages estimated in value.	Die Geldsumme , die der Arbeiter für seine Tagesarbeit, Wochenarbeit usw. erhält, bildet den Betrag seines nominellen oder dem Wert nach geschätzten Arbeitslohns.	ch20_clean.en-ch20_clean.de
But it is clear that according to the length of the working day, that is, according to the amount of actual labour daily supplied, the same daily or weekly wage may represent very different prices of labour, i.e., very different sums of money for the same quantity of labour.	Es ist aber klar, daß je nach der Länge des Arbeitstags, also je nach der täglich von ihm gelieferten Quantität Arbeit, derselbe Tageslohn, Wochenlohn usw. einen sehr verschiednen Preis der Arbeit, d.h. sehr verschiedne Geldsummen für dasselbe Quantum Arbeit darstellen kann.	ch20_clean.en-ch20_clean.de
We must, therefore, in considering time-wages, again distinguish between the sum-total of the daily or weekly wages, &c., and the price of labour.	Man muß also bei dem Zeitlohn wieder unterscheiden zwischen Gesamtbetrag des Arbeitslohns, Taglohns, Wochenlohns usw. und Preis der Arbeit.	ch20_clean.en-ch20_clean.de
How then, to find this price, i.e., the money-value of a given quantity of labour?	Wie nun diesen Preis finden, d.h. den Geldwert eines gegebnen Quantums Arbeit?	ch20_clean.en-ch20_clean.de
The average price of labour is found, when the average daily value of the labour-power is divided by the average number of hours in the working day.	Der durchschnittliche Preis der Arbeit ergibt sich, indem man den durchschnittlichen Tageswert der Arbeitskraft durch die Stundenzahl des durchschnittlichen Arbeitstags dividiert.	ch20_clean.en-ch20_clean.de
If, e.g., the daily value of labour-power is 3 shillings, the value of the product of 6 working-hours, and if the working day is 12 hours, the price of 1 working hour is 3/ shillings = 3d. The price of the working-hour thus found serves as the unit measure for the price of labour.	Ist z.B. der Tageswert der Arbeitskraft 3 sh., das Wertprodukt von 6 Arbeitsstunden, und ist der Arbeitstag zwölfstündig, so ist der Preis einer Arbeitsstunde = 3 sh./12 = 3 d. Der so gefundene Preis der Arbeitsstunde dient als Einheitsmaß für den Preis der Arbeit.	ch20_clean.en-ch20_clean.de
It follows therefore that the daily and weekly wages, &c., may remain the same, although the price of labour falls constantly.	Es folgt daher, daß der Taglohn, Wochenlohn usw. derselbe bleiben kann, obgleich der Preis der Arbeit fortwährend sinkt.	ch20_clean.en-ch20_clean.de
If, e.g., the habitual working day is 10 hours and the daily value of the labour-power 3s., the price of the working-hour is 3 3/5d. It falls to 3s. as soon as the working day rises to 12 hours, to 2 2/5d as soon as it rises to 15 hours.	War z.B. der gewohnheitsmäßige Arbeitstag 10 Stunden und der Tageswert der Arbeitskraft 3 sh., so betrug der Preis der Arbeitsstunde 33/5 d.; er sinkt auf 3 d., sobald der Arbeitstag zu 12 Stunden, und 22/5 d., sobald er zu 15 Stunden steigt.	ch20_clean.en-ch20_clean.de
Daily or weekly wages remain, despite all this, unchanged.	Tages- oder Wochenlohn bleiben trotzdem unverändert.	ch20_clean.en-ch20_clean.de
On the contrary, the daily or weekly wages may rise, although the price of labour remains constant or even falls.	Umgekehrt kann der Taglohn oder Wochenlohn steigen, obgleich der Preis der Arbeit konstant bleibt oder selbst sinkt.	ch20_clean.en-ch20_clean.de
If, e.g., the working day is 10 hours, and the daily value of labour-power 3 shillings, the price of one working-hour is 3 3/5d.	War z.B. der Arbeitstag zehnstündig und ist der Tageswert der Arbeitskraft 3 sh., so der Preis einer Arbeitsstunde 33/5 d. Arbeitet der Arbeiter infolge zunehmender Beschäftigung und bei gleichbeibendem Preise der Arbeit 12 Stunden, so steigt sein Tageslohn nun auf 3 sh.	ch20_clean.en-ch20_clean.de
If the labourer, in consequence of increase of trade, works 12 hours, the price of labour remaining the same, his daily wage now rises to 3 shillings 7 1/ d. without any variation in the price of labour.	71/5 d. ohne Variation im Preise der Arbeit.	ch20_clean.en-ch20_clean.de
The same result might follow if, instead of the extensive amount of labour, its intensive amount increased.	Dasselbe Resultat könnte herauskommen, wenn statt der extensiven Größe der Arbeit ihre intensive Größe zunähme.	ch20_clean.en-ch20_clean.de
3The rise of the nominal daily or weekly wages may therefore be accompanied by a price of labour that remains stationary or falls.	Steigen des nominellen Tages- oder Wochenlohns mag daher begleitet sein von gleichbleibendem oder sinkendem Preis der Arbeit.	ch20_clean.en-ch20_clean.de
The same holds as to the income of the labourer’s family, as soon as the quantity of labour expended by the head of the family is increased by the labour of the members of his family.	Dasselbe gilt von der Einnahme der Arbeiterfamilie, sobald das vom Familienhaupt gelieferte Arbeitsquantum durch die Arbeit der Fami- lienglieder vermehrt wird.	ch20_clean.en-ch20_clean.de
There are, therefore, methods of lowering the price of labour independent of the reduction of the nominal daily or weekly wages.	Es gibt also von der Schmälerung des nominellen Tages- oder Wochenlohns unabhängige Methoden zur Herabsetzung des Preises der Arbeit.	ch20_clean.en-ch20_clean.de
As a general law it follows that, given the amount of daily or weekly labour, &c., the daily or weekly wages depend on the price of labour which itself varies either with the value of labour-power, or with the difference between its price and its value.	Als allgemeines Gesetz aber folgt: Ist die Quantität der Tages-, Wochenarbeit usw. gegeben, so hängt der Tages- oder Wochenlohn vom Preise der Arbeit ab, der selbst variiert, entweder mit dem Wert der Arbeitskraft oder den Abweichungen ihres Preises von ihrem Werte.	ch20_clean.en-ch20_clean.de
Given, on the other hand, the price of labour, the daily or weekly wages depend on the quantity of the daily or weekly labour.	Ist dagegen der Preis der Arbeit gegeben, so hängt der Tages- oder Wochenlohn von der Quantität der Tages- oder Wochenarbeit ab.	ch20_clean.en-ch20_clean.de
The unit-measure for time-wages, the price of the working-hour, is the quotient of the value of a day’s labour-power, divided by the number of hours of the average working day.	Die Maßeinheit des Zeitlohns, der Preis der Arbeitsstunden, ist der Quotient des Tageswerts der Arbeitskraft, dividiert durch die Stundenzahl des gewohnheitsmäßigen Arbeitstags.	ch20_clean.en-ch20_clean.de
Let the latter be 12 hours, and the daily value of labour-power 3 shillings, the value of the product of 6 hours of labour.	Gesetzt, letztrer betrage 12 Stunden, der Tageswert der Arbeitskraft 3 sh., das Wertprodukt von 6 Arbeitsstunden.	ch20_clean.en-ch20_clean.de
Under these circumstances the price of a working hour is 3d. ; the value produced in it is 6d. If the labourer is now employed less than 12 hours (or less than 6 days in the week), e.g., only 6 or 8 hours, he receives, with this price of labour, only 2s. or 1s.	Der Preis der Arbeitsstunde ist unter diesen Umständen 3 d., ihr Wertprodukt 6 d. Wird der Arbeiter nun weniger als 12 Stunden täglich (oder weniger als 6 Tage in der Woche) beschäftigt, z.B. nur 6 oder 8 Stunden, so erhält er, bei diesem Preise der Arbeit, nur 2 oder 11/2 sh.	ch20_clean.en-ch20_clean.de
6d. a day.	Taglohn.	ch20_clean.en-ch20_clean.de
As on our hypothesis he must work on the average 6 hours daily, in order to produce a day’s wage corresponding merely to the value of his labour power, as according to the same hypothesis he works only half of every hour for himself, and half for the capitalist, it is clear that he cannot obtain for himself the value of the product of 6 hours if he is employed less than 12 hours.	Da er nach der Voraussetzung im Durchschnitt 6 Stunden täglich arbeiten muß, um nur einen dem Wert seiner Arbeitskraft entsprechenden Taglohn zu produzieren, da er nach derselben Voraussetzung von jeder Stunde nur 1/2 für sich selbst, 1/2 aber für den Kapitalisten arbeitet, so ist es klar, daß er das Wertprodukt von 6 Stunden nicht herausschlagen kann, wenn er weniger als 12 Stunden beschäftigt wird.	ch20_clean.en-ch20_clean.de
In previous chapters we saw the destructive consequences of over-work; here we find the sources of the sufferings that result to the labourer from his insufficient employment.	Sah man früher die zerstörenden Folgen der Überarbeit, so entdeckt man hier die Quellen der Leiden, die für den Arbeiter aus seiner Unterbeschäftigung entspringen.	ch20_clean.en-ch20_clean.de
If the hour’s wage is fixed so that the capitalist does not bind himself to pay a day’s or a week’s wage, but only to pay wages for the hours during which he chooses to employ the labourer, he can employ him for a shorter time than that which is originally the basis of the calculation of the hour-wage, or the unit-measure of the price of labour.	Wird der Stundenlohn in der Weise fixiert, daß der Kapitalist sich nicht zur Zahlung eines Tages- oder Wochenlohns verpflichtet, sondern nur zur Zahlung der Arbeitsstunden, während deren es ihm beliebt, den Arbeiter zu beschäftigen, so kann er ihn unter der Zeit beschäftigen, die der Schätzung des Stundenlohns oder der Maßeinheit für den Preis der Arbeit ursprünglich zugrunde liegt.	ch20_clean.en-ch20_clean.de
Since this unit is determined by the ratio daily value of labour-power working day of a given number of hours’ it, of course, loses all meaning as soon as the working day ceases to contain a definite number of hours.	Da diese Maßeinheit bestimmt ist durch die Proportion Tageswert der Arbeitskraft)/Arbeitstag von gegebner Stundenzahl, verliert sie natürlich allen Sinn, sobald der Arbeitstag aufhört, eine bestimmte Stundenzahl zu zählen.	ch20_clean.en-ch20_clean.de
The connection between the paid and the unpaid labour is destroyed.	Der Zusammenhang zwischen der bezahlten und unbezahlten Arbeit wird aufgehoben.	ch20_clean.en-ch20_clean.de
The capitalist can now wring from the labour a certain quantity of surplus labour without allowing him the labour-time necessary for his own subsistence.	Der Kapitalist kann jetzt ein bestimmtes Quantum Mehrarbeit aus dem Arbeiter herausschlagen, ohne ihm die zu seiner Selbsterhaltung notwendige Arbeitszeit einzuräumen.	ch20_clean.en-ch20_clean.de
He can annihilate all regularity of employment, and according to his own convenience, caprice, and the interest of the moment, make the most enormous overwork alternate with relative or absolute cessation of work.	Er kann jede Regelmäßigkeit der Beschäftigung vernichten und ganz nach Bequemlichkeit, Willkür und augenblicklichem Interesse die ungeheuerste Überarbeit mit relativer oder gänzlicher Arbeitslosigkeit abwechseln lassen.	ch20_clean.en-ch20_clean.de
He can, under the pretense of paying “the normal price of labour,” abnormally lengthen the working day without any corresponding compensation to the labourer.	Er kann, unter dem Vorwand, den "normalen Preis der Arbeit" zu zahlen, den Arbeitstag, ohne irgend entsprechende Kompensation für den Arbeiter, anormal verlängern.	ch20_clean.en-ch20_clean.de
Hence the perfectly rational revolt in 1860 of the London labourers, employed in the building trades, against the attempt of the capitalists to impose on them this sort of wage by the hour.	Daher der durchaus rationelle Aufstand der im Baufach beschäftigten Londoner Arbeiter gegen den Versuch der Kapitalisten, diesen Stundenlohn aufzuherrschen.	ch20_clean.en-ch20_clean.de
The legal limitation of the working day puts an end to such mischief, although not, of course, to the diminution of employment caused by the competition of machinery, by changes in the quality of the labourers employed, and by crises partial or general.	Die gesetzliche Beschränkung des Arbeitstags macht solchem Unfug ein Ende, obgleich natürlich nicht der aus Konkurrenz der Maschinerie, Wechsel in der Qualität der angewandten Arbeiter, partiellen und allgemeinen Krisen entspringenden Unterbeschäftigung.	ch20_clean.en-ch20_clean.de
With an increasing daily or weekly wage the price of labour may remain nominally constant, and yet may fall below its normal level.	Bei wachsendem Tages- oder Wochenlohn kann der Preis der Arbeit nominell konstant bleiben und dennoch unter sein normales Niveau sinken.	ch20_clean.en-ch20_clean.de
This occurs every time that, the price of labour (reckoned per working-hour) remaining constant, the working day is prolonged beyond its customary length.	Dies findet jedesmal statt, sobald mit konstantem Preis der Arbeit, resp. der Arbeitsstunde, der Arbeitstag über seine gewohnheitsmäßige Dauer verlängert wird.	ch20_clean.en-ch20_clean.de
If in the fraction: daily value of labour power working day the denominator increases, the numerator increases yet more rapidly.	Wenn in dem Bruch Tageswert der Arbeitskraft/Arbeitstag der Nenner wächst, wächst der Zähler noch rascher.	ch20_clean.en-ch20_clean.de
The value of labour-power, as dependent on its wear and tear, increases with the duration of its functioning, and in more rapid proportion than the increase of that duration.	Der Wert der Arbeitskraft, weil ihr Verschleiß, wächst mit der Dauer ihrer Funktion und in rascherer Proportion als das Inkrement ihrer Funktionsdauer.	ch20_clean.en-ch20_clean.de
In many branches of industry where time-wage is the general rule without legal limits to the working-time, the habit has, therefore, spontaneously grown up of regarding the working day as normal only up to a certain point, e.g., up to the expiration of the tenth hour (“normal working day,” “the day’s work,” “the regular hours of work”).	In vielen Industriezweigen, wo Zeitlohn vorherrscht, ohne gesetzliche Schranken der Arbeitszeit, hat sich daher naturwüchsig die Gewohnheit herausgebildet, daß der Arbeitstag nur bis zu einem gewissen Punkt, z.B. bis zum Ablauf der zehnten Stunde, als normal gilt ("normal working day", "the day's work", "the regular hours of work <"normaler Arbeitstag", "Tagesarbeit", "reguläre Arbeitszeit">).	ch20_clean.en-ch20_clean.de
Beyond this limit the working-time is over-time, and is, taking the hour as unit-measure, paid better (“extra pay”), although often in a proportion ridiculously small.	Jenseits dieser Grenze bildet die Arbeitszeit Überzeit (overtime) und wird, die Stunde als Maßeinheit genommen, besser bezahlt (extra pay), obgleich oft in lächerlich kleiner Proportion.	ch20_clean.en-ch20_clean.de
The normal working day exists here as a fraction of the actual working day, and the latter, often during the whole year, lasts longer than the former.	Der normale Arbeitstag existiert hier als Bruchteil des wirklichen Arbeitstags, und der letztere währt oft während des ganzen Jahres länger als der erstere.	ch20_clean.en-ch20_clean.de
The increase in the price of labour with the extension of the working day beyond a certain normal limit, takes such a shape in various British industries that the low price of labour during the so-called normal time compels the labourer to work during the better paid over-time, if he wishes to obtain a sufficient wage at all.	Der Wachstum im Preis der Arbeit mit der Verlängerung des Arbeitstags über eine gewisse Normalgrenze gestaltet sich in verschiednen britischen Industriezweigen so, daß der niedrige Preis der Arbeit während der sog. Normalzeit dem Arbeiter die besser bezahlte Überzeit aufzwingt, will er überhaupt einen genügenden Arbeitslohn herausschlagen.	ch20_clean.en-ch20_clean.de
Legal limitation of the working day puts an end to these amenities.	Gesetzliche Beschränkung des Arbeitstags macht diesem Vergnügen ein Ende.	ch20_clean.en-ch20_clean.de
It is a fact generally known that, the longer the working days, in any branch of industry, the lower are the wages.	Es ist allgemein bekannte Tatsache, daß, je länger der Arbeitstag in einem Industriezweig, um so niedriger der Arbeitslohn.	ch20_clean.en-ch20_clean.de
A. Redgrave, factory inspector, illustrates this by a comparative review of the 20 years from 1839-1859, according to which wages rose in the factories under the 10 Hours Law, whilst they fell in the factories in which the work lasted 14 to 15 hours daily.	Fabrikinspektor A. Redgrave illustriert dies durch eine vergleichende Übersicht der zwanzigjährigen Periode von 1839-1859, wonach der Arbeitslohn in den dem Zehnstundengesetz unterworfenen Fabriken stieg, während er fiel in den Fabriken, wo 14 bis 15 Stunden täglich gearbeitet wird.	ch20_clean.en-ch20_clean.de
From the law, “the price of labour being given, the daily or weekly wage depends on the quantity of labour expended,” it follows, first of all, that the lower the price of labour, the greater must be the quantity of labour, or the longer must be the working day for the labourer to secure even a miserable average wage.	Zunächst folgt aus dem Gesetz: "Bei gegebnem Preis der Arbeit hängt der Tages- oder Wochenlohn von der Quantität der gelieferten Arbeit ab", daß, je niedriger der Preis der Arbeit, desto größer das Arbeitsquantum sein muß oder desto länger der Arbeitstag, damit der Arbeiter auch nur einen kümmerlichen Durchschnittslohn sichre.	ch20_clean.en-ch20_clean.de
The lowness of the price of labour acts here as a stimulus to the extension of the labour-time.	Die Niedrigkeit des Arbeitspreises wirkt hier als Sporn zur Verlängerung der Arbeitszeit.	ch20_clean.en-ch20_clean.de
On the other hand, the extension of the working-time produces, in its turn, a fall in the price of labour, and with this a fall in the day’s or week’s wages.	Umgekehrt aber produziert ihrerseits die Verlängerung der Arbeitszeit einen Fall im Arbeitspreise und damit im Tages- oder Wochenlohn.	ch20_clean.en-ch20_clean.de
The determination of the price of labour by: daily value of labour power working day of a given number of hours shows that a mere prolongation of the working day lowers the price of labour, if no compensation steps in.	Die Bestimmung des Arbeitspreises durch Tageswert der Arbeitskraft/Arbeitstag von gegebner Stundenzahl ergibt, daß bloße Verlängerung des Arbeitstags den Arbeitspreis senkt, wenn keine Kompensation eintritt.	ch20_clean.en-ch20_clean.de
But the same circumstances which allow the capitalist in the long run to prolong the working day, also allow him first, and compel him finally, to nominally lower the price of labour until the total price of the increased number of hours is lowered, and, therefore, the daily or weekly wage.	Aber dieselben Umstände, welche den Kapitalisten befähigen, den Arbeitstag auf die Dauer zu verlängern, befähigen ihn erst und zwingen ihn schließlich, den Arbeitspreis auch nominell zu senken, bis der Gesamtpreis der vermehrten Stundenzahl sinkt, also der Tages- oder Wochenlohn.	ch20_clean.en-ch20_clean.de
Reference to two circumstances is sufficient here.	Hinweis auf zwei Umstände genügt hier.	ch20_clean.en-ch20_clean.de
If one man does the work of 1½ or 2 men, the supply of labour increases, although the supply of labour-power on the market remains constant.	Verrichtet ein Mann das Werk von 11/2 oder 2 Männern, so wächst die Zufuhr der Arbeit, wenn auch die Zufuhr der auf dem Markt befindlichen Arbeitskräfte konstant bleibt.	ch20_clean.en-ch20_clean.de
The competition thus created between the labourers allows the capitalist to beat down the price of labour, whilst the falling price of labour allows him, on the other hand, to screw up still further the working-time.	Die so unter den Arbeitern erzeugte Konkurrenz befähigt den Kapitalisten, den Preis der Arbeit herabzudrücken, während der fallende Preis der Arbeit ihn umgekehrt befähigt, die Arbeitszeit noch weiter heraufzuschrauben.	ch20_clean.en-ch20_clean.de
Soon, however, this command over abnormal quantities of unpaid labour, i.e., quantities in excess of the average social amount, becomes a source of competition amongst the capitalists themselves.	Bald jedoch wird diese Verfügung über anormale, d.h. das gesellschaftliche Durchschnittsniveau überfließende Quanta unbezahlter Arbeit zum Konkurrenzmittel unter den Kapitalisten selbst.	ch20_clean.en-ch20_clean.de
A part of the price of the commodity consists of the price of labour.	Ein Teil des Warenpreises besteht aus dem Preis der Arbeit.	ch20_clean.en-ch20_clean.de
The unpaid part of the labour-price need not be reckoned in the price of the commodity.	Der nicht gezahlte Teil des Arbeitspreises braucht nicht im Warenpreis zu rechnen.	ch20_clean.en-ch20_clean.de
It may be presented to the buyer.	Er kann dem Warenkäufer geschenkt werden.	ch20_clean.en-ch20_clean.de
This is the first step to which competition leads.	Dies ist der erste Schritt, wozu die Konkurrenz treibt.	ch20_clean.en-ch20_clean.de
The second step to which it drives is to exclude also from the selling price of the commodity at least a part of the abnormal surplus-value created by the extension of the working day.	Der zweite Schritt, wozu sie zwingt, ist, wenigstens einen Teil des durch die Verlängerung des Arbeitstags erzeugten anormalen Mehrwerts ebenfalls aus dem Verkaufspreis der Ware auszuschließen.	ch20_clean.en-ch20_clean.de
In this way, an abnormally low selling price of the commodity arises, at first sporadically, and becomes fixed by degrees; a lower selling price which henceforward becomes the constant basis of a miserable wage for an excessive working-time, as originally it was the product of these very circumstances.	In dieser Weise bildet sich erst sporadisch und fixiert sich nach und nach ein anormal niedriger Verkaufspreis der Ware, der von nun an zur konstanten Grundlage kümmerlichen Arbeitslohns bei übermäßiger Arbeitszeit wird, wie er ursprünglich das Produkt dieser Umstände war.	ch20_clean.en-ch20_clean.de
This movement is simply indicated here, as the analysis of competition does not belong to this part of our subject.	Wir deuten diese Bewegung bloß an, da die Analyse der Konkurrenz nicht hierhin gehört.	ch20_clean.en-ch20_clean.de
Nevertheless, the capitalist may, for a moment, speak for himself.	Doch mag für einen Augenblick der Kapitalist selbst sprechen.	ch20_clean.en-ch20_clean.de
“In Birmingham there is so much competition of masters one against another that many are obliged to do things as employers that they would otherwise be ashamed of; and yet no more money is made, but only the public gets the benefit.”	"In Birmingham ist die Konkurrenz unter den Meistern so groß, daß mancher von uns gezwungen ist, als Arbeitsanwender zu tun, was er sich schämen würde, sonst zu tun; und dennoch wird nicht mehr Geld gemacht (and yet no more money is made), sondern das Publikum allein hat den Vorteil davon."	ch20_clean.en-ch20_clean.de
The reader will remember the two sorts of London bakers, of whom one sold the bread at its full price (the “full-priced” bakers), the other below its normal price (“the under-priced,” “the undersellers”).	Man erinnert sich der Zwei Sorten Londoner Bäcker, wovon die eine Brot zum vollen Preise (the "fullpriced" backers), die andre es unter seinem normalen Preise verkauft ("the underpriced", "the undersellers").	ch20_clean.en-ch20_clean.de
The “full-priced” denounced their rivals before the Parliamentary Committee of Inquiry: “They only exist now by first defrauding the public, and next getting 18 hours’ work out of their men for 12 hours’ wages....	Die "fullpriced" denunzieren ihre Konkurrenten vor der parlamentarischen Untersuchungskommission: "Sie existieren nur, indem sie erstens das Publikum betrügen" (durch Fälschung der Ware) "und zweitens 18 Arbeitsstunden aus ihren Leuten für den Lohn zwölfstündiger Arbeit herausschinden ...	ch20_clean.en-ch20_clean.de
The unpaid labour of the men was made ... the source whereby the competition was carried on, and continues so to this day....	Die unbezahlte Arbeit (the unpaid labour) der Arbeiter ist das Mittel, wodurch der Konkurrenzkampf geführt wird ...	ch20_clean.en-ch20_clean.de
The competition among the master bakers is the cause of the difficulty in getting rid of night-work.	Die Konkurrenz unter den Bäckermeistern ist die Ursache der Schwierigkeit in Beseitigung der Nachtarbeit.	ch20_clean.en-ch20_clean.de
An underseller, who sells his bread below the cost-price according to the price of flour, must make it up by getting more out of the labour of the men....	Ein Unterverkäufer, der sein Brot unter dem mit dem Mehlpreis wechselnden Kostpreis verkauft, hält sich schadlos, indem er mehr Arbeit aus seinen Leuten herausschlägt.	ch20_clean.en-ch20_clean.de
If I got only 12 hours’ work out of my men, and my neighbor got 18 or 20, he must beat me in the selling price.	Wenn ich nur 12 Stunden Arbeit aus meinen Leuten herausschlage, mein Nachbar dagegen 18 oder 20, muß er mich im Verkaufspreis schlagen.	ch20_clean.en-ch20_clean.de
If the men could insist on payment for over-work, this would be set right....	Könnten die Arbeiter auf Zahlung für Überzeit bestehen, so wäre es mit diesem Manöver bald zu Ende ...	ch20_clean.en-ch20_clean.de
A large number of those employed by the undersellers are foreigners and youths, who are obliged to accept almost any wages they can obtain.”	Eine große Anzahl der von den Unterverkäufern Beschäftigten sind Fremde, Jungen und andre, die fast mit jedem Arbeitslohn, den sie kriegen können, vorlieb zu nehmen gezwungen sind."	ch20_clean.en-ch20_clean.de
This jeremiad is also interesting because it shows how the appearance only of the relations of production mirrors itself in the brain of the capitalist.	Diese Jeremiade ist auch deswegen interessant, weil sie zeigt, wie nur der Schein der Produktionsverhältnisse sich im Kapitalistenhirn widerspiegelt.	ch20_clean.en-ch20_clean.de
The capitalist does not know that the normal price of labour also includes a definite quantity of unpaid labour, and that this very unpaid labour is the normal source of his gain.	Der Kapitalist weiß nicht, daß der normale Preis der Arbeit ein bestimmtes Quantum unbezahlter Arbeit einschließt und eben diese unbezahlte Arbeit die normale Quelle seines Gewinns ist.	ch20_clean.en-ch20_clean.de
The category of surplus labour-time does not exist at all for him, since it is included in the normal working day, which he thinks he has paid for in the day’s wages.	Die Kategorie der Mehrarbeitszeit existiert überhaupt nicht für ihn, denn sie ist eingeschlossen im normalen Arbeitstag, den er im Taglohn zu zahlen glaubt.	ch20_clean.en-ch20_clean.de
But over-time does exist for him, the prolongation of the working day beyond the limits corresponding with the usual price of labour.	Wohl aber existiert für ihn die Überzeit, die Verlängerung des Arbeitstags über die dem gewohnten Preis der Arbeit entsprechende Schranke.	ch20_clean.en-ch20_clean.de
Face to face with his underselling competitor, he even insists upon extra pay for this over-time.	Seinem unterverkaufenden Konkurrenten gegenüber besteht er sogar auf Extrazahlung (extra pay) für diese Überzeit.	ch20_clean.en-ch20_clean.de
He again does not know that this extra pay includes unpaid labour, just as well as does the price of the customary hour of labour.	Er weiß wieder nicht, daß diese Extrazahlung ebensowohl unbezahlte Arbeit einschießt, wie der Preis der gewöhnlichen Arbeitsstunde.	ch20_clean.en-ch20_clean.de
For example, the price of one hour of the 12 hours’ working day is 3d., say the value-product of half a working-hour, whilst the price of the over-time working-hour is 4d., or the value-product of 2/ of a working hour.	Z.B. der Preis einer Stunde des zwölfstündigen Arbeitstags ist 3 d., das Wertprodukt von 1/2 Arbeitsstunde, während der Preis der überzeitigen Arbeitsstunde 4 d., das Wertprodukt von 2/3 Arbeitsstunde.	ch20_clean.en-ch20_clean.de
In the first case the capitalist appropriates to himself one-half, in the second, one-third of the working-hour without paying for it.	Im ersten Fall eignet sich der Kapitalist von einer Arbeitsstunde die Hälfte, im andern 1/3 ohne Zahlung an.	ch20_clean.en-ch20_clean.de

