Chapter 22: National Differences of Wages In the 17th chapter we were occupied with the manifold combinations which may bring about a change in magnitude of the value of labour-power – this magnitude being considered either absolutely or relatively, i.e., as compared with surplus-value; whilst on the other hand, the quantum of the means of subsistence in which the price of labour is realized might again undergo fluctuations independent of, or different from, the changes of this price.	ZWANZIGSTES KAPITEL Nationale Verschiedenheit der Arbeitslöhne Im fünfzehnten Kapitel beschäftigten uns die mannigfachen Kombinationen, welche einen Wechsel in der absoluten oder relativen (d.h. mit dem Mehrwert verglichen) Wertgröße der Arbeitskraft hervorbringen kann, während andrerseits wieder das Quantum von Lebensmitteln, worin der Preis der Arbeitskraft realisiert wird, von dem Wechsel dieses Preises unabhängige oder verschiedne Bewegung durchlaufen konnte.	ch22_clean.en-ch22_clean.de
As has been already said, the simple translation of the value, or respectively of the price, of labour-power into the exoteric form of wages transforms all these laws into laws of the fluctuations of wages.	Wie bereits bemerkt, verwandeln sich durch einfache Übersetzung des Werts, resp. Preises der Arbeitskraft in die exoterische Form des Arbeitslohns alle jene Gesetze in Gesetze der Bewegung des Arbeitslohns.	ch22_clean.en-ch22_clean.de
That which appears in these fluctuations of wages within a single country as a series of varying combinations, may appear in different countries as contemporaneous difference of national wages.	Was innerhalb dieser Bewegung als wechselnde Kombination, kann für verschiedne Länder als gleichzeitige Verschiedenheit nationaler Arbeitslöhne erscheinen.	ch22_clean.en-ch22_clean.de
In the comparison of the wages in different nations, we must therefore take into account all the factors that determine changes in the amount of the value of labour-power; the price and the extent of the prime necessaries of life as naturally and historically developed, the cost of training the labourers, the part played by the labour of women and children, the productiveness of labour, its extensive and intensive magnitude.	Beim Vergleich nationaler Arbeitslöhne sind also alle den Wechsel in der Wertgröße der Arbeitskraft bestimmende Momente zu erwägen, Preis und Umfang der natürlichen und historisch entwickelten ersten Lebensbedürfnisse, Erziehungskosten des Arbeiters, Rolle der Weiber- und Kinderarbeit, Produktivität der Arbeit, ihre extensive und intensive Größe.	ch22_clean.en-ch22_clean.de
Even the most superficial comparison requires the reduction first of the average day-wage for the same trades, in different countries, to a uniform working day.	Selbst die oberflächlichste Vergleichung erheischt, zunächst den Durchschnitts-Taglohn für dieselben Gewerbe in verschiednen Ländern auf gleich große Arbeitstage zu reduzieren.	ch22_clean.en-ch22_clean.de
After this reduction to the same terms of the day-wages, time-wage must again be translated into piece-wage, as the latter only can be a measure both of the productivity and the intensity of labour.	Nach solcher Ausgleichung der Taglöhne muß der Zeitlohn wieder in Stücklohn übersetzt werden, da nur der letztere ein Gradmesser sowohl für die Produktivität als die intensive Größe der Arbeit.	ch22_clean.en-ch22_clean.de
In every country there is a certain average intensity of labour below which the labour for the production of a commodity requires more than the socially necessary time, and therefore does not reckon as labour of normal quality.	In jedem Lande gilt eine gewisse mittlere Intensität der Arbeit, unter welcher die Arbeit bei Produktion einer Ware mehr als die gesellschaftlich notwendige Zeit verbraucht, und daher nicht als Arbeit von normaler Qualität zählt.	ch22_clean.en-ch22_clean.de
Only a degree of intensity above the national average affects, in a given country, the measure of value by the mere duration of the working-time.	Nur ein über den nationalen Durchschnitt sich erhebender Intensitätsgrad ändert, in einem gegebnen Lande, das Maß des Werts durch die bloße Dauer der Arbeitszeit.	ch22_clean.en-ch22_clean.de
This is not the case on the universal market, whose integral parts are the individual countries.	Anders auf dem Weltmarkt, dessen integrierende Teile die einzelnen Länder sind.	ch22_clean.en-ch22_clean.de
The average intensity of labour changes from country to country; here it is greater, there less.	Die mittlere Intensität der Arbeit wechselt von Land zu Land; sie ist hier größer, dort kleiner.	ch22_clean.en-ch22_clean.de
These national averages form a scale, whose unit of measure is the average unit of universal labour.	Diese nationalen Durchschnitte bilden also eine Stufenleiter, deren Maßeinheit die Durchschnittseinheit der universellen Arbeit ist.	ch22_clean.en-ch22_clean.de
The more intense national labour, therefore, as compared with the less intense, produces in the same time more value, which expresses itself in more money.	Verglichen mit der weniger intensiven, produziert also die intensivere nationale Arbeit in gleicher Zeit mehr Wert, der sich in mehr Geld ausdrückt.	ch22_clean.en-ch22_clean.de
But the law of value in its international application is yet more modified by the fact that on the world-market the more productive national labour reckons also as the more intense, so long as the more productive nation is not compelled by competition to lower the selling price of its commodities to the level of their value.	Noch mehr aber wird das Wertgesetz in seiner internationalen Anwendung dadurch modifiziert, daß auf dem Weltmarkt die produktivere nationale Arbeit ebenfalls als intensivere zählt, sooft die produktivere Nation nicht durch die Konkurrenz gezwungen wird, den Verkaufspreis ihrer Ware auf ihren Wert zu senken.	ch22_clean.en-ch22_clean.de
In proportion as capitalist production is developed in a country, in the same proportion do the national intensity and productivity of labour there rise above the international level.	Im Maß, wie in einem Lande die kapitalistische Produktion entwickelt ist, im selben Maß erheben sich dort auch die nationale Intensität und Produktivität der Arbeit über das internationale Niveau.	ch22_clean.en-ch22_clean.de
The different quantities of commodities of the same kind, produced in different countries in the same working-time, have, therefore, unequal international values, which are expressed in different prices, i.e., in sums of money varying according to international values.	(64a) Die verschiedenen Warenquanta derselben Art, die in verschiedenen Ländern in gleicher Arbeitszeit produziert werden, haben also ungleiche internationale Werte, die sich in verschiedenen Preisen ausdrücken, d.h. in je nach den internationalen Werten verschiednen Geldsummen.	ch22_clean.en-ch22_clean.de
The relative value of money will, therefore, be less in the nation with more developed capitalist mode of production than in the nation with less developed.	Der relative Wert des Geldes wird also kleiner sein bei der Nation mit entwickelterer kapitalistischer Produktionsweise als bei der mit wenig entwickelter.	ch22_clean.en-ch22_clean.de
It follows, then, that the nominal wages, the equivalent of labour-power expressed in money, will also be higher in the first nation than in the second; which does not at all prove that this holds also for the real wages, i.e., for the means of subsistence placed at the disposal of the labourer.	Folgt also, daß der nominelle Arbeitslohn, das Äquivalent der Arbeitskraft ausgedrückt in Geld, ebenfalls höher sein wird bei der ersten Nation als bei der zweiten; was keineswegs besagt, daß dies auch für den wirklichen Lohn gilt, d.h. für die dem Arbeiter zur Verfügung gestellten Lebensmittel.	ch22_clean.en-ch22_clean.de
But even apart from these relative differences of the value of money in different countries, it will be found, frequently, that the daily or weekly, &tc., wage in the first nation is higher than in the second, whilst the relative price of labour, i.e., the price of labour as compared both with surplus-value and with the value of the product, stands higher in the second than in the first.	Aber auch abgesehn von dieser relativen Verschiedenheit des Geldwerts in verschiedenen Ländern, wird man häufig finden, daß der Tages-, Wochen-, etc. Lohn bei der ersteren Nation höher ist als bei der zweiten, während der relative Arbeitspreis, d.h. der Arbeitspreis im Verhältnis sowohl zum Mehrwert wie zum Wert des Produkts, bei der zweiten Nation höher steht als bei der ersteren.	ch22_clean.en-ch22_clean.de
J. W. Cowell, member of the Factory Commission of 1833, after careful investigation of the spinning trade, came to the conclusion that “in England wages are virtually lower to the capitalist, though higher to the operative than on the Continent of Europe.”	J. W. Cowell, Mitglied der Fabrikkommission von 1833, kam nach sorgfältiger Untersuchung der Spinnerei zum Ergebnis, daß "in England die Löhne der Sache nach niedriger für den Fabrikanten sind als auf dem Kontinent, obwohl sie für den Arbeiter höher sein mögen" (Ure, p. 314).	ch22_clean.en-ch22_clean.de
The English Factory Inspector, Alexander Redgrave, in his report of Oct. 31st, 1866, proves by comparative statistics with continental states, that in spite of lower wages and much longer working-time, continental labour is, in proportion to the product, dearer than English.	Der englische Fabrikinspektor Alexander Redgrave weist im Fabrikbericht vom 31. Oktober 1866 durch vergleichende Statistik mit den Kontinentalstaaten nach, daß trotz niedrigerem Lohn und viel längerer Arbeitszeit die kontinentale Arbeit, verhältnismäßig zum Produkt, teurer ist als die englische.	ch22_clean.en-ch22_clean.de
An English manager of a cotton factory in Oldenburg declares that the working time there lasted from 5: a.m. to 8 p.m., Saturdays included, and that the workpeople there, when under English overlookers, did not supply during this time quite so much product as the English in 10 hours, but under German overlookers much less.	Ein englischer Direktor (manager) in einer Baumwollfabrik in Oldenburg erklärt, daß dort die Arbeitszeit von 5.30 Uhr morgens bis 8 Uhr abends währt, samstags eingeschlossen, und daß die dortigen Arbeiter, wenn unter englischen Arbeitsaufsehen, während dieser Zeit nicht ganz soviel Produkt liefern als Engländer in 10 Stunden, unter deutschen Arbeitsaufsehern aber noch viel weniger.	ch22_clean.en-ch22_clean.de
Wages are much lower than in England, in many cases 50%, but the number of hands in proportion to the machinery was much greater, in certain departments in the proportion of 5:3. Mr. Redgrave gives very full details as to the Russian cotton factories.	Der Lohn stehe viel tiefer als in England, in vielen Fällen um 50%, aber die Zahl der Hände im Verhältnis zur Maschinerie sei viel größer, in verschiedenen Departements im Verhältnis von 5 : 3. Herr Redgrave gibt sehr genaue Details über die russischen Baumwollfabriken.	ch22_clean.en-ch22_clean.de
The data were given him by an English manager until recently employed there.	Die Data sind ihm geliefert durch einen dort noch kürzlich beschäftigten englischen manager.	ch22_clean.en-ch22_clean.de
On this Russian soil, so fruitful of all infamies, the old horrors of the early days of English factories are in full swing.	Auf diesem russischen Boden, an allen Infamien so fruchtbar, stehn auch die alten Greuel aus der Kindheitspreiode der englischen factories <Fabriken> in vollster Blüte.	ch22_clean.en-ch22_clean.de
The managers are, of course, English, as the native Russian capitalist is of no use in factory business.	Die Dirigenten sind natürlich Engländer, da der eingeborene russische Kapitalist nicht für das Fabrikgeschäft taugt.	ch22_clean.en-ch22_clean.de
Despite all over-work, continued day and night, despite the most shameful under-payment of the workpeople, Russian manufacture manages to vegetate only by prohibition of foreign competition. I give, in conclusion, a comparative table of Mr. Redgrave’s, on the average number of spindles per factory and per spinner in the different countries of Europe.	Trotz aller Überarbeit, fortlaufender Tag- und Nachtarbeit und schmählichster Unterzahlung der Arbeiter, vegetiert das russische Fabrikat nur durch Prohibition des ausländischen. - Ich gebe schließlich noch eine vergleichende Übersicht des Herrn Redgrave über die Durchschnitts-Spindelzahl per Fabrik und per Spinner in verschiednen Ländern Europas.	ch22_clean.en-ch22_clean.de
He himself remarks that he had collected these figures a few years ago, and that since that time the size of the factories and the number of spindles per labourer in England has increased.	Herr Redgrave bemerkt selbst, daß er diese Zahlen vor einigen Jahren gesammelt hat und daß seit der Zeit die Größe der Fabriken und die Spindelzahl per Arbeiter in England gewachsen seien.	ch22_clean.en-ch22_clean.de
He supposes, however, an approximately equal progress in the continental countries mentioned, so that the numbers given would still have their value for purposes of comparison.	Er unterstellt aber verhältnismäßig gleich großen Fortschritt in den aufgezählten Kontinentalländern, so daß die Zahlenangaben ihren komparativen Wert behalten hätten.	ch22_clean.en-ch22_clean.de
AVERAGE NUMBER OF SPINDLES PER FACTORY England, average of spindles per factory 12, France, average of spindles per factory 1, Prussia, average of spindles per factory 1, Belgium, average of spindles per factory 4, Saxony, average of spindles per factory 4, Austria, average of spindles per factory 7, Switzerland, average of spindles per factory 8, AVERAGE NUMBER OF PERSONS EMPLOYED TO SPINDLES France one person to 14 spindles Russia one person to 28 spindles Prussia one person to 37 spindles Bavaria one person to 46 spindles Austria one person to 49 spindles Belgium one person to 50 spindles Saxony one person to 50 spindles Switzerland one person to 55 spindles Smaller States of Germany one person to 55 spindles Great Britain one person to 74 spindles “This comparison,” says Mr. Redgrave, “is yet more unfavorable to Great Britain, inasmuch as there is so large a number of factories in which weaving by power is carried on in conjunction with spinning” (whilst in the table the weavers are not deducted), “and the factories abroad are chiefly spinning factories; if it were possible to compare like with like, strictly, I could find many cotton spinning factories in my district in which mules containing 2, spindles are minded by one man (the minder) and two assistants only, turning off daily 220 lbs. of yarn, measuring 400 miles in length.” 5 It is well known that in Eastern Europe, as well as in Asia, English companies have undertaken the construction of railways, and have, in making them, employed side by side with the native labourers, a certain number of English working-men.	Durchschnittsanzahl von Spindeln per Fabrik In England Durchschnittszahl von Spindeln auf je eine Fabrik 12.600 In der Schweiz Durchschnittszahl von Spindeln auf je eine Fabrik 8.000 In Östreich Durchschnittszahl von Spindeln auf je eine Fabrik 7.000 In Sachsen Durchschnittszahl von Spindeln auf je eine Fabrik 4.500 In Belgien Durchschnittszahl von Spindeln auf je eine Fabrik 4.000 In Frankreich Durchschnittszahl von Spindeln auf je eine Fabrik 1.500 In Preußen Durchschnittszahl von Spindeln auf je eine Fabrik 1.500 Durchschnittsanzahl von Spindeln per Kopf In Frankreich eine Person auf 14 Spindeln In Rußland eine Person auf 28 Spindeln In Preußen eine Person auf 37 Spindeln In Bayern eine Person auf 46 Spindeln In Östreich eine Person auf 49 Spindeln In Belgien eine Person auf 50 Spindeln In Sachsen eine Person auf 50 Spindeln In den kleinern deutschen Staaten eine Person auf 55 Spindeln In der Schweiz eine Person auf 55 Spindeln In Großbritannien eine Person auf 74 Spindeln "Diese Vergleichung", sagt Herr Redgrave, "ist, außer andren Gründen, besonders auch deswegen für Großbritannien ungünstig, weil dort eine sehr große Zahl Fabriken existiert, worin die Maschinenweberei mit der Spinnerei verbunden ist, während die Rechnung keinen Kopf für die Webstühle abzieht. Die auswärtigen Fabriken sind dagegen meist bloße Spinnereien. Könnten wir genau Gleiches mit Gleichem vergleichen, so könne ich viele Baumwollspinnereien in meinem Distrikt aufzählen, worin Mules mit 2.200 Spindeln von einem einzigen Mann (minder) und zwei Handlangerinnen überwacht und täglich 220 Pfund Garn, 400 (englische) Meilen in Länge, fabriziert werden. "("Reports of Insp. of Fact., 31st Oct. 1866", p. 31-37 passim.) Man weiß, daß in Osteuropa sowohl wie in Asien englische Kompanien Eisenbahnen in Bau übernommen haben und dabei neben einheimischen auch eine gewisse Zahl englischer Arbeiter verwenden.	ch22_clean.en-ch22_clean.de
Compelled by practical necessity, they thus have had to take into account the national difference in the intensity of labour, but this has brought them no loss.	Durch praktische Notwendigkeit gezwungen, so den nationalen Unterschieden in der Intensität der Arbeit Rechnung zu tragen, hat ihnen das keinen Schaden gebracht.	ch22_clean.en-ch22_clean.de
Their experience shows that even if the height of wages corresponds more or less with the average intensity of labour, the relative price of labour varies generally in the inverse direction.	Ihre Erfahrung lehrt, daß, wenn auch die Höhe des Lohnes mehr oder weniger der mittleren Arbeitsintensität entspricht, der relative Arbeitspreis (im Verhältnis zum Produkt) sich im allgemeinen im entgegengesetzten Sinn bewegt.	ch22_clean.en-ch22_clean.de
In an “Essay on the Rate of Wages,” one of his first economic writings, H. Carey tries to prove that the wages of the different nations are directly proportional to the degree of productiveness of the national working days, in order to draw from this international relation the conclusion that wages everywhere rise and fall in proportion to the productiveness of labour.	In "Versuch über die Rate des Arbeitslohns" , einer seiner frühsten ökonomischen Schriften, sucht H. Carey nachzuweisen, daß die verschiednen nationalen Arbeitslöhne sich direkt verhalten wie die Produktivitätsgrade der nationalen Arbeitstage, um aus diesem internationalen Verhältnis den Schluß zu ziehen, daß der Arbeitslohn überhaupt steigt und fällt wie die Produktivität der Arbeit.	ch22_clean.en-ch22_clean.de
The whole of our analysis of the production of surplus-value shows the absurdity of this conclusion, even if Carey himself had proved his premises instead of, after his usual uncritical and superficial fashion, shuffling to and fro a confused mass of statistical materials.	Unsre ganze Analyse der Produktion des Mehrwerts beweist die Abgeschmacktheit dieser Schlußfolgerung, hätte Carey selbst seine Prämisse bewiesen, statt seiner Gewohnheit gemäß unkritisch und oberflächlich zusammengerafftes statistisches Material kunterbunt durcheinanderzuwürfeln.	ch22_clean.en-ch22_clean.de
The best of it is that he does not assert that things actually are as they ought to be according to his theory.	Das Beste ist, daß er nicht behauptet, die Sache verhalte sich wirklich so, wie sie sich der Theorie nach verhalten sollte.	ch22_clean.en-ch22_clean.de
For State intervention has falsified the natural economic relations.	Die Staatseinmischung hat nämlich das naturgemäße ökonomische Verhältnis verfälscht.	ch22_clean.en-ch22_clean.de
The different national wages must be reckoned, therefore, as if that part of each that goes to the State in the form of taxes, came to the labourer himself.	Man muß daher die nationalen Arbeitslöhne so berechnen, als ob der Teil derselben, der dem Staat in der Form von Steuern zufällt, dem Arbeiter selbst zufiele.	ch22_clean.en-ch22_clean.de
Ought not Mr. Carey to consider further whether those “State expenses” are not the “natural” fruits of capitalistic development?	Sollte Herr Carey nicht weiter darüber nachdenken, ob diese "Staatskosten" nicht auch "naturgemäße Früchte" der kapitalistischen Entwicklung sind?	ch22_clean.en-ch22_clean.de
The reasoning is quite worthy of the man who first declared the relations of capitalist production to be eternal laws of nature and reason, whose free, harmonious working is only disturbed by the intervention of the State, in order afterwards to discover that the diabolical influence of England on the world market (an influence which, it appears, does not spring from the natural laws of capitalist production) necessitates State intervention, i.e., the protection of those laws of nature and reason by the State, alias the System of Protection.	Das Räsonnement ist ganz des Mannes würdig, der die kapitalistischen Produktionsverhältnisse erst für ewige Natur- und Vernunftsgesetze erklärte, deren frei harmonisches Spiel nur durch die Staatseinmischung gestört werde, um hinterher zu entdecken, daß Englands diabolischer Einfluß auf den Weltmarkt, ein Einfluß, der, wie es scheint, nicht den Naturgesetzen der kapitalistischen Produktion entspringt, die Staatseinmischung nötig macht, nämlich den Schutz jener Natur- und Vernunftsgesetze durch den Staat, alias das Protektionssystem.	ch22_clean.en-ch22_clean.de
He discovered further that the theorems of Ricardo and others, in which existing social antagonisms and contradictions are formulated, are not the ideal product of the real economic movement, but on the contrary, that the real antagonisms of capitalist production in England and elsewhere are the result of the theories of Ricardo and others!	Er entdeckte ferner, daß die Theoreme Ricardos usw., worin existierende gesellschaftliche Gegensätze und Widersprüche formuliert sind, nicht das ideale Produkt der wirklichen ökonomischen Bewegung, sondern daß umgekehrt die wirklichen Gegensätze der kapitalistischen Produktion in England und anderswo das Resultat der Ricardoschen usw. Theorie sind!	ch22_clean.en-ch22_clean.de
Finally he discovered that it is, in the last resort, commerce that destroys the inborn beauties and harmonies of the capitalist mode of production.	Er entdeckte schließlich, daß es in letzter Instanz der Handel ist, der die eingebornen Schönheiten und Harmonien der kapitalistischen Produktionsweise vernichtet.	ch22_clean.en-ch22_clean.de
A step further and he will, perhaps, discover that the one evil in capitalist production is capital itself.	Noch einen Schritt weiter, und er entdeckt vielleicht, daß der einzige Mißstand an der kapitalistischen Produktion das Kapital selbst ist.	ch22_clean.en-ch22_clean.de
Only a man with such atrocious want of the critical faculty and such spurious erudition deserved, in spite of his Protectionist heresy, to become the secret source of the harmonious wisdom of a Bastiat, and of all the other Free-trade optimists of today.	Nur ein Mann von so entsetzlicher Kritiklosigkeit und solcher Gelehrsamkeit de faux aloi <von falschem Gehalt> verdiente, trotz seiner protektionistische Ketzerei, die Geheimquelle der harmonischen Weisheit eines Bastiat und aller andern freihändlerischen Optimisten der Gegenwart zu werden.	ch22_clean.en-ch22_clean.de

