Chapter 24: Conversion of Surplus-Value into Capital Section 1: Capitalist Production on a Progressively Increasing Scale.	ZWEIUNDZWANZIGSTES KAPITEL Verwandlung von Mehrwert in Kapital 1. Kapitalistischer Produktionsprozeß auf erweiterter Stufenleiter.	ch24_clean.en-ch24_clean.de
Transition of the Laws of Property that Characterise Production of Commodities into Laws of Capitalist Appropriation Hitherto we have investigated how surplus-value emanates from capital; we have now to see how capital arises from surplus-value.	Umschlag der Eigentumsgesetze der Warenproduktion in Gesetze der kapitalistischen Aneignung Früher hatten wir zu betrachten, wie der Mehrwert aus dem Kapital, jetzt wie das Kapital aus dem Mehrwert entspringt.	ch24_clean.en-ch24_clean.de
Employing surplus-value as capital, reconverting it into capital, is called accumulation of capital.	Anwendung von Mehrwert als Kapital oder Rückverwandlung von Mehrwert in Kapital heißt Akkumulation des Kapitals.	ch24_clean.en-ch24_clean.de
First let us consider this transaction from the standpoint of the individual capitalist.	Betrachten wir diesen Vorgang zunächst vom Standpunkt des einzelnen Kapitalisten.	ch24_clean.en-ch24_clean.de
Suppose a spinner to have advanced a capital of £10,000, of which four-fifths (£8,000) are laid out in cotton, machinery, &c., and one-fifth (£2,000) in wages.	Ein Spinner z.B. habe ein Kapital von 10.000 Pfd.St. vorgeschossen, wovon vier Fünftel in Baumwolle, Maschinen etc., das letzte Fünftel in Arbeitslohn.	ch24_clean.en-ch24_clean.de
Let him produce 240, lbs. of yarn annually, having a value of £2,000.	Er produziere jährlich 240.000 Pfd. Garn zum Wert von 12.000 Pfd.St..	ch24_clean.en-ch24_clean.de
The rate of surplus-value being 100%, the surplus-value lies in the surplus or net product of 40, lbs. of yarn, one-sixth of the gross product, with a value of £2, which will be realised by a sale. £2, is £2,000.	Bei einer Rate des Mehrwerts von 100% steckt der Mehrwert im Mehrprodukt oder Nettoprodukt von 40.000 Pfd. Garn, einem Sechstel des Bruttoprodukts, zum Wert von 2.000 Pfd.	ch24_clean.en-ch24_clean.de
We can neither see nor smell in this sum of money a trace of surplus-value.	Sterling, den der Verkauf realisieren wird. Eine Wertsumme von 2.000 Pfd.St. ist eine Wertsumme von 2.000 Pfd.St.	ch24_clean.en-ch24_clean.de
	Man riecht und sieht diesem Gelde nicht an, daß es Mehrwert ist.	ch24_clean.en-ch24_clean.de
When we know that a given value is surplus-value, we know how its owner came by it; but that does not alter the nature either of value or of money.	Der Charakter eines Werts als Mehrwert zeigt, wie er zu seinem Eigner kam, ändert aber nichts an der Natur des Werts oder des Geldes.	ch24_clean.en-ch24_clean.de
In order to convert this additional sum of £2, into capital, the master-spinner will, all circumstances remaining as before, advance four-fifths of it (£1,600) in the purchase of cotton, &c., and one-fifth (£400) in the purchase of additional spinners, who will find in the market the necessaries of life whose value the master has advanced to them.	Um die neu hinzugekommne Summe von 2.000 Pfd.St. in Kapital zu verwandeln, wird also der Spinner, alle andern Umstände gleichbleibend, vier Fünftel davon vorschießen im Ankauf von Baumwolle usw. und ein Fünftel im Ankauf neuer Spinnarbeiter, die auf dem Markte die Lebensmittel finden werden, deren Wert er ihnen vorgeschossen hat.	ch24_clean.en-ch24_clean.de
Then the new capital of £2, functions in the spinning mill, and brings in, in its turn, a surplus-value of £400.	Dann fungiert das neue Kapital von 2.000 Pfd.St. in der Spinnerei und bringt seinerseits einen Mehrwert von 400 Pfd. ein.	ch24_clean.en-ch24_clean.de
The capital value was originally advanced in the money form.	Der Kapitalwert war ursprünglich vorgeschossen in Geldform; der Mehrwert dagegen existiert von vornherein als Wert eines bestimmten Teils des Bruttoprodukts.	ch24_clean.en-ch24_clean.de
The surplus-value on the contrary is, originally, the value of a definite portion of the gross product. If this gross product be sold, converted into money, the capital value regains its original form.	Wird dieses verkauft, in Geld verwandelt, so gewinnt der Kapitalwert seine ursprüngliche Form wieder, aber der Mehrwert verwandelt seine ursprüngliche Daseinsweise.	ch24_clean.en-ch24_clean.de
From this moment the capital value and the surplus-value are both of them sums of money, and their reconversion into capital takes place in precisely the same way.	Von diesem Augenblick an sind jedoch Kapitalwert und Mehrwert beides Geldsummen, und ihre Wiederverwandlung in Kapital vollzieht sich auf ganz dieselbe Weise.	ch24_clean.en-ch24_clean.de
The one, as well as the other, is laid out by the capitalist in the purchase of commodities that place him in a position to begin afresh the fabrication of his goods, and this time, on an extended scale.	Die eine wie die andre legt der Kapitalist an im Ankauf der Waren, die ihn instand setzen, die Verfertigung seines Artikels von neuem zu beginnen, und zwar diesmal auf erweiterter Stufenleiter.	ch24_clean.en-ch24_clean.de
But in order to be able to buy those commodities, he must find them ready in the market.	Um aber diese Waren zu kaufen, muß er sie auf dem Markte vorfinden.	ch24_clean.en-ch24_clean.de
His own yarns circulate, only because he brings his annual product to market, as all other capitalists likewise do with their commodities.	Seine eignen Garne zirkulieren nur, weil er sein Jahresprodukt auf den Markt bringt, wie das alle andern Kapitalisten mit ihren Waren ebenfalls tun.	ch24_clean.en-ch24_clean.de
But these commodities, before coming to market, were part of the general annual product, part of the total mass of objects of every kind, into which the sum of the individual capitals, i.e., the total capital of society, had been converted in the course of the year, and of which each capitalist had in hand only an aliquot part.	Aber ehe sie auf den Markt kamen, hatten sie sich schon befunden im jährlichen Produktionsfonds, d.h. der Gesamtmasse der Gegenstände aller Art, worin die Gesamtsumme der Einzelkapitale oder das gesellschaftliche Gesamtkapital im Laufe des Jahres sich verwandelt und wovon jeder Einzelkapitalist nur einen aliquoten Teil in Händen hat.	ch24_clean.en-ch24_clean.de
The transactions in the market effectuate only the interchange of the individual components of this annual product, transfer them from one hand to another, but can neither augment the total annual production, nor alter the nature of the objects produced.	Die Vorgänge auf dem Markt bewerkstelligen nur den Umsatz der einzelnen Bestandteile der Jahresproduktion, schicken sie von einer Hand in die andre, aber sie können weder die Gesamt-Jahresproduktion vergrößern noch die Natur der produzierten Gegenstände ändern.	ch24_clean.en-ch24_clean.de
Hence the use that can be made of the total annual product, depends entirely upon its own composition, but in no way upon circulation.	Welcher Gebrauch also von dem jährlichen Gesamtprodukt gemacht werden kann, das hängt ab von seiner eignen Zusammensetzung, keineswegs aber von der Zirkulation.	ch24_clean.en-ch24_clean.de
The annual production must in the first place furnish all those objects (use values) from which the material components of capital, used up in the course of the year, have to be replaced.	Zunächst muß die Jahresproduktion alle die Gegenstände (Gebrauchswerte) liefern, aus denen die im Lauf des Jahres verbrauchten sachlichen Bestandteile des Kapitals zu ersetzen sind.	ch24_clean.en-ch24_clean.de
Deducting these there remains the net or surplus-product, in which the surplus-value lies.	Nach Abzug dieser bleibt das Netto- oder Mehrprodukt, worin der Mehrwert steckt.	ch24_clean.en-ch24_clean.de
And of what does this surplus-product consist?	Und woraus besteht dies Mehrprodukt?	ch24_clean.en-ch24_clean.de
Only of things destined to satisfy the wants and desires of the capitalist class, things which, consequently, enter into the consumption fund of the capitalists?	Vielleicht in Dingen, bestimmt zur Befriedigung der Bedürfnisse und Gelüste der Kapitalistenklasse, die also in ihren Konsumtionsfonds eingehn?	ch24_clean.en-ch24_clean.de
Were that the case, the cup of surplus-value would be drained to the very dregs, and nothing but simple reproduction would ever take place.	Wäre das alles, so würde der Mehrwert verjubelt bis auf die Hefen, und es fände bloß einfache Reproduktion statt.	ch24_clean.en-ch24_clean.de
To accumulate it is necessary to convert a portion of the surplus-product into capital.	Um zu akkumulieren, muß man einen Teil des Mehrprodukts in Kapital verwandeln.	ch24_clean.en-ch24_clean.de
But we cannot, except by a miracle, convert into capital anything but such articles as can be employed in the labour process (i.e., means of production), and such further articles as are suitable for the sustenance of the labourer (i.e., means of subsistence).	Aber, ohne Wunder zu tun, kann man nur solche Dinge in Kapital verwandeln, die im Arbeitsprozeß verwendbar sind, d.h. Produktionsmittel, und des ferneren Dinge, von denen der Arbeiter sich erhalten kann, d.h. Lebensmittel.	ch24_clean.en-ch24_clean.de
Consequently, a part of the annual surplus labour must have been applied to the production of additional means of production and subsistence, over and above the quantity of these things required to replace the capital advanced.	Folglich muß ein Teil der jährlichen Mehrarbeit verwandt worden sein zur Herstellung zusätzlicher Produktions- und Lebensmittel, im Überschuß über das Quantum, das zum Ersatz des vorgeschossenen Kapitals erforderlich war.	ch24_clean.en-ch24_clean.de
In one word, surplus-value is convertible into capital solely because the surplus-product, whose value it is, already comprises the material elements of new capital.	Mit einem Wort: der Mehrwert ist nur deshalb in Kapital verwandelbar, weil das Mehrprodukt, dessen Wert er ist, bereits die sachlichen Bestandteile eines neuen Kapitals enthält.	ch24_clean.en-ch24_clean.de
Now in order to allow of these elements actually functioning as capital, the capitalist class requires additional labour.	(21a) Um nun diese Bestandteile tatsächlich als Kapital fungieren zu lassen, bedarf die Kapitalistenklasse eines Zuschusses von Arbeit.	ch24_clean.en-ch24_clean.de
If the exploitation of the labourers already employed do not increase, either extensively or intensively, then additional labour-power must be found.	Soll nicht die Ausbeutung der schon beschäftigten Arbeiter extensiv oder intensiv wachsen, so müssen zusätzliche Arbeitskräfte eingestellt werden.	ch24_clean.en-ch24_clean.de
For this the mechanism of capitalist production provides beforehand, by converting the working class into a class dependent on wages, a class whose ordinary wages suffice, not only for its maintenance, but for its increase.	Dafür hat der Mechanismus der kapitalistischen Produktion ebenfalls schon gesorgt, indem er die Arbeiterklasse reproduziert als vom Arbeitslohn abhängige Klasse, deren gewöhnlicher Lohn hinreicht, nicht nur ihre Erhaltung zu sichern, sondern auch ihre Vermehrung.	ch24_clean.en-ch24_clean.de
It is only necessary for capital to incorporate this additional labour-power, annually supplied by the working class in the shape of labourers of all ages, with the surplus means of production comprised in the annual produce, and the conversion of surplus-value into capital is complete.	Diese, ihm durch die Arbeiterklasse auf verschiednen Altersstufen jährlich gelieferten, zuschüssigen Arbeitskräfte braucht das Kapital nur noch den in der Jahresproduktion schon enthaltnen zuschüssigen Produktionsmitteln einzuverleiben, und die Verwandlung des Mehrwerts in Kapital ist fertig.	ch24_clean.en-ch24_clean.de
From a concrete point of view, accumulation resolves itself into the reproduction of capital on a progressively increasing scale.	Konkret betrachtet, löst sich die Akkumulation auf in Reproduktion des Kapitals auf progressiver Stufenleiter.	ch24_clean.en-ch24_clean.de
The circle in which simple reproduction moves, alters its form, and, to use Sismondi’s expression, changes into a spiral.	Der Kreislauf der einfachen Reproduktion verändert sich und verwandelt sich, nach Sismondis Ausdruck, in eine Spirale.	ch24_clean.en-ch24_clean.de
Let us now return to our illustration.	(21b) Kehren wir jetzt zu unserm Beispiel zurück.	ch24_clean.en-ch24_clean.de
It is the old story: Abraham begat Isaac, Isaac begat Jacob, and so on. The original capital of £10, brings in a surplus-value of £2,000, which is capitalised.	Es ist die alte Geschichte: Abraham zeugte Isaak, Isaak zeugte Jakob usw. Das ursprüngliche Kapital von 10.000 Pfd.St. bringt einen Mehrwert von 2.000 Pfd.St., der kapitalisiert wird.	ch24_clean.en-ch24_clean.de
The new capital of £2, brings in a surplus-value of £400, and this, too, is capitalised, converted into a second additional capital, which, in its turn, produces a further surplus-value of £80. And so the ball rolls on. We here leave out of consideration the portion of the surplus-value consumed by the capitalist.	Das neue Kapital von 2.000 Pfd.St. bringt einen Mehrwert von 400 Pfd.St. ; dieser, wiederum kapitalisiert, also in ein zweites zusätzliches Kapital verwandelt, bringt einen neuen Mehrwert von 80 Pfd.St., usw. Wir sehen hier ab von dem vom Kapitalisten verzehrten Teil des Mehrwerts.	ch24_clean.en-ch24_clean.de
Just as little does it concern us, for the moment, whether the additional capital is joined on to the original capital, or is separated from it to function independently; whether the same capitalist, who accumulated it employs it, or whether he hands it over to another.	Ebensowenig interessiert es uns für den Augenblick, ob die Zusatzkapitale zum ursprünglichen Kapital geschlagen oder von ihm zu selbständiger Verwertung getrennt werden; ob derselbe Kapitalist sie ausnutzt, der sie akkumuliert hat, oder ob er sie andern überträgt.	ch24_clean.en-ch24_clean.de
This only we must not forget, that by the side of the newly-formed capital, the original capital continues to reproduce itself, and to produce surplus-value, and that this is also true of all accumulated capital, and the additional capital engendered by it.	Nur dürfen wir nicht vergessen, daß neben den neugebildeten Kapitalen das ursprüngliche Kapital fortfährt sich zu reproduzieren und Mehrwert zu produzieren, und daß dasselbe gilt von jedem akkumulierten Kapital in Beziehung auf das von ihm erzeugte Zusatzkapital.	ch24_clean.en-ch24_clean.de
The original capital was formed by the advance of £10,000.	Das ursprüngliche Kapital bildete sich durch den Vorschuß von 10.000 Pfd.St.	ch24_clean.en-ch24_clean.de
How did the owner become possessed of it?	Woher hat sie ihr Besitzer?	ch24_clean.en-ch24_clean.de
“By his own labour and that of his forefathers,” answer unanimously the spokesmen of Political Economy. And, in fact, their supposition appears the only one consonant with the laws of the production of commodities.	Durch seine eigne Arbeit und die seiner Vorfahren! antworten uns einstimmig die Wortführer der politischen Ökonomie (21c), und ihre Annahme scheint in der Tat die einzige, die zu den Gesetzen der Warenproduktion stimmt.	ch24_clean.en-ch24_clean.de
But it is quite otherwise with regard to the additional capital of £2,000.	Ganz anders verhält es sich mit dem Zusatzkapital von 2.000 Pfd.St.	ch24_clean.en-ch24_clean.de
How that originated we know perfectly well.	Seinen Entstehungsprozeß kennen wir ganz genau.	ch24_clean.en-ch24_clean.de
	Es ist kapitalisierter Mehrwert.	ch24_clean.en-ch24_clean.de
There is not one single atom of its value that does not owe its existence to unpaid labour.	Von Ursprung an enthält er nicht ein einziges Wertatom, das nicht aus unbezahlter fremder Arbeit herstammt.	ch24_clean.en-ch24_clean.de
The means of production, with which the additional labour-power is incorporated, as well as the necessaries with which the labourers are sustained, are nothing but component parts of the surplus-product, of the tribute annually exacted from the working class by the capitalist class.	Die Produktionsmittel, denen die zuschüssige Arbeitskraft einverleibt wird, wie die Lebensmittel, von denen diese sich erhält, sind nichts als integrierende Bestandteile des Mehrprodukts, des der Arbeiterklasse jährlich durch die Kapitalistenklasse entrissenen Tributs.	ch24_clean.en-ch24_clean.de
Though the latter with a portion of that tribute purchases the additional labour-power even at its full price, so that equivalent is exchanged for equivalent, yet the transaction is for all that only the old dodge of every conqueror who buys commodities from the conquered with the money he has robbed them of.	Wenn diese mit einem Teil des Tributs von jener zusätzliche Arbeitskraft kauft, selbst zum vollen Preise, so daß Äquivalent sich austauscht gegen Äquivalent - es bleibt immer das alte Verfahren des Eroberers, der den Besiegten Waren abkauft mit ihrem eignen, geraubten Geld.	ch24_clean.en-ch24_clean.de
If the additional capital employs the person who produced it, this producer must not only continue to augment the value of the original capital, but must buy back the fruits of his previous labour with more labour than they cost.	Wenn das Zusatzkapital seinen eignen Produzenten beschäftigt, so muß dieser erstens fortfahren, das ursprüngliche Kapital zu verwerten, und zudem den Ertrag seiner früheren Arbeit zurückkaufen mit mehr Arbeit, als er gekostet hat.	ch24_clean.en-ch24_clean.de
When viewed as a transaction between the capitalist class and the working class, it makes no difference that additional labourers are employed by means of the unpaid labour of the previously employed labourers.	Als Transaktion zwischen der Kapitalistenklasse und der Arbeiterklasse betrachtet, ändert es nichts an der Sache, wenn mit der unbezahlten Arbeit der bisher beschäftigten Arbeiter zuschüssige Arbeiter beschäftigt werden.	ch24_clean.en-ch24_clean.de
The capitalist may even convert the additional capital into a machine that throws the producers of that capital out of work, and that replaces them by a few children.	Der Kapitalist verwandelt vielleicht auch das Zusatzkapital in eine Maschine, die den Produzenten des Zusatzkapitals aufs Pflaster wirft und durch ein paar Kinder ersetzt.	ch24_clean.en-ch24_clean.de
In every case the working class creates by the surplus labour of one year the capital destined to employ additional labour in the following year.	In allen Fällen hat die Arbeiterklasse durch ihre diesjährige Mehrarbeit das Kapital geschaffen, das im nächsten Jahr zuschüssige Arbeit beschäftigen wird.	ch24_clean.en-ch24_clean.de
And this is what is called: creating capital out of capital.	Das ist es, was man nennt: Kapital durch Kapital erzeugen.	ch24_clean.en-ch24_clean.de
The accumulation of the first additional capital of £2, presupposes a value of £10, belonging to the capitalist by virtue of his “primitive labour,” and advanced by him.	Die Voraussetzung der Akkumulation des ersten Zusatzkapitals von 2.000 Pfd.St. war eine vom Kapitalisten vorgeschoßne, ihm kraft seiner "ursprünglichen Arbeit" gehörige Wertsumme von 10.000 Pfd.St.	ch24_clean.en-ch24_clean.de
The second additional capital of £ presupposes, on the contrary, only the previous accumulation of the £2,000, of which the £ is the surplus-value capitalised.	Die Voraussetzung des zweiten Zusatzkapitals von 400 Pfd.St. dagegen ist nichts andres als die vorhergegangne Akkumulation des ersten, der 2.000 Pfd.St., dessen kapitalisierter Mehrwert es ist.	ch24_clean.en-ch24_clean.de
The ownership of past unpaid labour is thenceforth the sole condition for the appropriation of living unpaid labour on a constantly increasing scale.	Eigentum an vergangner unbezahlter Arbeit erscheint jetzt als die einzige Bedingung für gegenwärtige Aneignung lebendiger unbezahlter Arbeit in stets wachsendem Umfang.	ch24_clean.en-ch24_clean.de
The more the capitalist has accumulated, the more is he able to accumulate.	Je mehr der Kapitalist akkumuliert hat, desto mehr kann er akkumulieren.	ch24_clean.en-ch24_clean.de
In so far as the surplus-value, of which the additional capital, No. 1, consists, is the result of the purchase of labour-power with part of the original capital, a purchase that conformed to the laws of the exchange of commodities, and that, from a legal standpoint, presupposes nothing beyond the free disposal, on the part of the labourer, of his own capacities, and on the part of the owner of money or commodities, of the values that belong to him; in so far as the additional capital, No. 2, &c., is the mere result of No. 1, and, therefore, a consequence of the above conditions; in so far as each single transaction invariably conforms to the laws of the exchange of commodities, the capitalist buying labour-power, the labourer selling it, and we will assume at its real value; in so far as all this is true, it is evident that the laws of appropriation or of private property, laws that are based on the production and circulation of commodities, become by their own inner and inexorable dialectic changed into their very opposite.	Insofern der Mehrwert, woraus Zusatzkapital Nr. I besteht, das Resultat des Ankaufs der Arbeitskraft durch einen Teil des Originalkapitals war, ein Kauf, der den Gesetzen des Warenaustausches entsprach, und, juristisch betrachtet, nichts voraussetzt als freie Verfügung auf seiten des Arbeiters über seine eignen Fähigkeiten, auf seiten des Geld- oder Warenbesitzers über ihm gehörige Werte; sofern Zusatzkapital Nr. II usw. bloß Resultat von Zusatzkapital Nr. I, also Konsequenz jenes ersten Verhältnisses; sofern jede einzelne Transaktion fortwährend dem Gesetz des Warenaustausches entspricht, der Kapitalist stets die Arbeitskraft kauft, der Arbeiter sie stets verkauft, und wir wollen annehmen selbst zu ihrem wirklichen Wert, schlägt offenbar das auf Warenproduktion und Warenzirkulation beruhende Gesetz der Aneignung oder Gesetz des Privateigentums durch seine eigne, innere, unvermeidliche Dialektik in sein direktes Gegenteil um.	ch24_clean.en-ch24_clean.de
The exchange of equivalents, the original operation with which we started, has now become turned round in such a way that there is only an apparent exchange.	Der Austausch von Äquivalenten, der als die ursprüngliche Operation erschien, hat sich so gedreht, daß nur zum Schein ausgetauscht wird, indem erstens der gegen Arbeitskraft ausgetauschte Kapitalteil selbst nur ein Teil des ohne Äquivalent angeeigneten fremden Arbeitsproduktes ist und zweitens von seinem Produzenten, dem Arbeiter, nicht nur ersetzt, sondern mit neuem Surplus ersetzt werden muß.	ch24_clean.en-ch24_clean.de
This is owing to the fact, first, that the capital which is exchanged for labour-power is itself but a portion of the product of others’ labour appropriated without an equivalent; and, secondly, that this capital must not only be replaced by its producer, but replaced together with an added surplus.	Das Verhältnis des Austausches zwischen Kapitalist und Arbeiter wird also nur ein dem Zirkulationsprozeß angehöriger Schein, bloße Form, die dem Inhalt selbst fremd ist und ihn nur mystifiziert.	ch24_clean.en-ch24_clean.de
The relation of exchange subsisting between capitalist and labourer becomes a mere semblance appertaining to the process of circulation, a mere form, foreign to the real nature of the transaction, and only mystifying it.	Der beständige Kauf und Verkauf der Arbeitskraft ist die Form.	ch24_clean.en-ch24_clean.de
The ever repeated purchase and sale of labour-power is now the mere form; what really takes place is this – the capitalist again and again appropriates, without equivalent, a portion of the previously materialised labour of others, and exchanges it for a greater quantity of living labour.	Der Inhalt ist, daß der Kapitalist einen Teil der bereits vergegenständlichten fremden Arbeit, die er sich unaufhörlich ohne Äquivalent aneignet, stets wieder gegen größeres Quantum lebendiger fremder Arbeit umsetzt.	ch24_clean.en-ch24_clean.de
At first the rights of property seemed to us to be based on a man’s own labour.	Ursprünglich erschien uns das Eigentumsrecht gegründet auf eigne Arbeit.	ch24_clean.en-ch24_clean.de
At least, some such assumption was necessary since only commodity-owners with equal rights confronted each other, and the sole means by which a man could become possessed of the commodities of others, was by alienating his own commodities; and these could be replaced by labour alone.	Wenigstens mußte diese Annahme gelten, da sich nur gleichberechtigte Warenbesitzer gegenüberstehn, das Mittel zur Aneignung fremder Ware aber nur die Veräußerung der eignen Ware, und letztere nur durch Arbeit herstellbar ist.	ch24_clean.en-ch24_clean.de
Now, however, property turns out to be the right, on the part of the capitalist, to appropriate the unpaid labour of others or its product, and to be the impossibility, on the part of the labourer, of appropriating his own product.	Eigentum erscheint jetzt auf Seite des Kapitalisten als das Recht, fremde unbezahlte Arbeit oder ihr Produkt, auf Seite des Arbeiters als Unmöglichkeit, sich sein eignes Produkt anzueignen.	ch24_clean.en-ch24_clean.de
The separation of property from labour has become the necessary consequence of a law that apparently originated in their identity.	Die Scheidung zwischen Eigentum und Arbeit wird zur notwendigen Konsequenz eines Gesetzes, das scheinbar von ihrer Identität ausging.	ch24_clean.en-ch24_clean.de
Therefore, however much the capitalist mode of appropriation may seem to fly in the face of the original laws of commodity production, it nevertheless arises, not from a violation, but, on the contrary, from the application of these laws.	Sosehr die kapitalistische Aneignungsweise also den ursprünglichen Gesetzen der Warenproduktion ins Gesicht zu schlagen scheint, so entspringt sie doch keineswegs aus der Verletzung, sondern im Gegenteil aus der Anwendung dieser Gesetze.	ch24_clean.en-ch24_clean.de
Let us make this clear once more by briefly reviewing the consecutive phases of motion whose culminating point is capitalist accumulation.	Ein kurzer Rückblick auf die Reihenfolge der Bewegungsphasen, deren Schlußpunkt die kapitalistische Akkumulation ist, stelle dies nochmals klar.	ch24_clean.en-ch24_clean.de
We saw, in the first place, that the original conversion of a sum of values into capital was achieved in complete accordance with the laws of exchange.	Zuerst haben wir gesehn, daß die ursprüngliche Verwandlung einer Wertsumme in Kapital sich durchaus gemäß den Gesetzen des Austausches vollzog.	ch24_clean.en-ch24_clean.de
One party to the contract sells his labour-power, the other buys it.	Der eine Kontrahent verkauft seine Arbeitskraft, der andre kauft sie.	ch24_clean.en-ch24_clean.de
The former receives the value of his commodity, whose use value – labour – is thereby alienated to the buyer.	Der erstre empfängt den Wert seiner Ware, deren Gebrauchswert - die Arbeit - damit an den zweiten veräußert ist.	ch24_clean.en-ch24_clean.de
Means of production which already belong to the latter are then transformed by him, with the aid of labour equally belonging to him, into a new product which is likewise lawfully his.	Dieser verwandelt nunmehr ihm bereits gehörende Produktionsmittel mit Hilfe von ihm ebenfalls gehörender Arbeit in ein neues Produkt, das ihm ebenfalls von Rechts wegen gehört.	ch24_clean.en-ch24_clean.de
The value of this product includes: first, the value of the used-up means of production.	Der Wert dieses Produkts schließt ein: erstens den Wert der verbrauchten Produktionsmittel.	ch24_clean.en-ch24_clean.de
Useful labour cannot consume these means of production without transferring their value to the new product, but, to be saleable, labour-power must be capable of supplying useful labour in the branch of industry in which it is to be employed.	Die nützliche Arbeit kann diese Produktionsmittel nicht verbrauchen, ohne ihren Wert auf das neue Produkt zu übertragen; um aber verkäuflich zu sein, muß die Arbeitskraft imstande sein, in dem Industriezweig, wo sie verwandt werden soll, nützliche Arbeit zu liefern.	ch24_clean.en-ch24_clean.de
The value of the new product further includes: the equivalent of the value of the labour-power together with a surplus-value.	Der Wert des neuen Produkts schließt ferner ein: das Äquivalent des Werts der Arbeitskraft und einen Mehrwert.	ch24_clean.en-ch24_clean.de
This is so because the value of the labour-power – sold for a definite length of time, say a day, a week, etc. – is less than the value created by its use during that time.	Und zwar deshalb, weil die für einen bestimmten Zeitraum, Tag, Woche etc., verkaufte Arbeitskraft weniger Wert besitzt, als ihr Gebrauch während dieser Zeit schafft.	ch24_clean.en-ch24_clean.de
But the worker has received payment for the exchange-value of his labour-power and by so doing has alienated its use value – this being the case in every sale and purchase.	Der Arbeiter aber hat den Tauschwert seiner Arbeitskraft bezahlt erhalten und hat damit ihren Gebrauchswert veräußert - wie das bei jedem Kauf und Verkauf der Fall.	ch24_clean.en-ch24_clean.de
The fact that this particular commodity, labour-power, possesses the peculiar use value of supplying labour, and therefore of creating value, cannot affect the general law of commodity production.	Daß diese besondre Ware Arbeitskraft den eigentümlichen Gebrauchswert hat, Arbeit zu liefern, also Wert zu schaffen, das kann das allgemeine Gesetz der Warenproduktion nicht berühren.	ch24_clean.en-ch24_clean.de
If, therefore, the magnitude of value advanced in wages is not merely found again in the product, but is found there augmented by a surplus-value, this is not because the seller has been defrauded, for he has really received the value of his commodity; it is due solely to the fact that this commodity has been used up by the buyer.	Wenn also die in Arbeitslohn vorgeschoßne Wertsumme sich in Produkt nicht bloß einfach wieder vorfindet, sondern um einen Mehrwert vermehrt vorfindet, so rührt dies nicht her aus einer Übervorteilung des Verkäufers, der ja den Wert seiner Ware erhalten, sondern nur aus dem Verbrauch dieser Ware durch den Käufer.	ch24_clean.en-ch24_clean.de
The law of exchange requires equality only between the exchange-values of the commodities given in exchange for one another.	Das Gesetz des Austausches bedingt Gleichheit nur für die Tauschwerte der gegeneinander weggegebenen Waren.	ch24_clean.en-ch24_clean.de
From the very outset it presupposes even a difference between their use values and it has nothing whatever to do with their consumption, which only begins after the deal is closed and executed.	Es bedingt sogar von vornherein Verschiedenheit ihrer Gebrauchswerte und hat absolut nichts zu schaffen mit ihrem Verbrauch, der erst nach geschloßnem und vollzognem Handel beginnt.	ch24_clean.en-ch24_clean.de
Thus the original conversion of money into capital is achieved in the most exact accordance with the economic laws of commodity production and with the right of property derived from them.	Die ursprüngliche Verwandlung des Geldes in Kapital vollzieht sich also im genauesten Einklang mit den ökonomischen Gesetzen der Warenproduktion und mit dem daraus sich ableitenden Eigentumsrecht.	ch24_clean.en-ch24_clean.de
Nevertheless, its result is: (1) that the product belongs to the capitalist and not to the worker; (2) that the value of this product includes, besides the value of the capital advanced, a surplus-value which costs the worker labour but the capitalist nothing, and which none the less becomes the legitimate property of the capitalist; (3) that the worker has retained his labour-power and can sell it anew if he can find a buyer.	Trotzdem aber hat sie zum Ergebnis: 1. daß das Produkt dem Kapitalisten gehört und nicht dem Arbeiter; 2. daß der Wert dieses Produkts, außer dem Wert des vorgeschoßnen Kapitals, einen Mehrwert einschließt, der dem Arbeiter Arbeit, dem Kapitalisten aber nichts gekostet hat und der dennoch das rechtmäßige Eigentum des Kapitalisten wird; 3. daß der Arbeiter seine Arbeitskraft forterhalten hat und sie aufs neue verkaufen kann, wenn er einen Käufer findet.	ch24_clean.en-ch24_clean.de
Simple reproduction is only the periodical repetition of this first operation; each time money is converted afresh into capital.	Die einfache Reproduktion ist nur die periodische Wiederholung dieser ersten Operation; jedesmal wird, stets von neuem, Geld in Kapital verwandelt.	ch24_clean.en-ch24_clean.de
Thus the law is not broken; on the contrary, it is merely enabled to operate continuously.	Das Gesetz wird also nicht gebrochen, im Gegenteil es erhält nur Gelegenheit, sich dauernd zu betätigen.	ch24_clean.en-ch24_clean.de
“Several successive acts of exchange have only made the last represent the first” (Sismondi, “Nouveaux Principes, etc.,” p.	"Plusieurs échanges successifs n'ont fait du dernier que le représentant du premier." <"Mehrere aufeinander folgende Tauschakte machen aus dem letzten nur den Repräsentanten des ersten. "> (Sismondi, l.c.p.	ch24_clean.en-ch24_clean.de
70).	70.)	ch24_clean.en-ch24_clean.de
And yet we have seen that simple reproduction suffices to stamp this first operation, in so far as it is conceived as an isolated process, with a totally changed character.	Und dennoch haben wir gesehn, daß die einfache Reproduktion hinreicht, um dieser ersten Operation - soweit sie als isolierter Vorgang gefaßt war - einen total veränderten Charakter aufzuprägen.	ch24_clean.en-ch24_clean.de
“Of those who share the national income among themselves, the one side (the workers) acquire every year a fresh right to their share by fresh work; the others (the capitalists) have already acquired, by work done originally, a permanent right to their share” (Sismondi, l. c., pp. 110, 111).	"Parmi ceux qui se partagent le revenu national, les uns" (die Arbeiter) "y acquièrent chaque année un nouveau droit par un nouveau travail, les autres" (die Kapitalisten) "y ont acquis antérieurement un droit permanent par un travail primitif." <"Von denen, die sich in das nationale Einkommen teilen, erwerben die einen" (die Arbeiter) "jedes Jahr durch neue Arbeit ein neues Recht darauf, die andren" (die Kapitalisten) "haben bereits vorher durch eine ursprüngliche Arbeit ein dauerndes Recht darauf erworben. "> (Sismondi, l.c.p.	ch24_clean.en-ch24_clean.de
It is indeed notorious that the sphere of labour is not the only one in which primogeniture works miracles.	110, 111.) Das Gebiet der Arbeit ist bekanntlich nicht das einzige, wo die Erstgeburt Wunder tut.	ch24_clean.en-ch24_clean.de
Nor does it matter if simple reproduction is replaced by reproduction on an extended scale, by accumulation.	Es verschlägt auch nichts, wenn die einfache Reproduktion ersetzt wird durch die Reproduktion auf erweiterter Stufenleiter, durch die Akkumulation.	ch24_clean.en-ch24_clean.de
In the former case the capitalist squanders the whole surplus-value in dissipation, in the latter he demonstrates his bourgeois virtue by consuming only a portion of it and converting the rest into money.	Bei jener vermöbelt der Kapitalist den gesamten Mehrwert, bei dieser beweist er seine Bürgertugend durch Verzehrung nur eines Teils, und Verwandlung des Restes in Geld.	ch24_clean.en-ch24_clean.de
The surplus-value is his property; it has never belonged to anyone else.	Der Mehrwert ist sein Eigentum, er hat nie einem andern gehört.	ch24_clean.en-ch24_clean.de
If he advances it for the purposes of production, the advances made come from his own funds, exactly as on the day when he first entered the market.	Schießt er ihn zur Produktion vor, so macht er, ganz wie am Tag, wo er zuerst den Markt beschritt, Vorschüsse aus seinem eignen Fonds.	ch24_clean.en-ch24_clean.de
The fact that on this occasion the funds are derived from the unpaid labour of his workers makes absolutely no difference.	Daß dieser Fonds diesmal aus der unbezahlten Arbeit seiner Arbeiter stammt, tut absolut nichts zur Sache.	ch24_clean.en-ch24_clean.de
If worker B is paid out of the surplus-value which worker A produced, then, in the first place, A furnished that surplus-value without having the just price of his commodity cut by a half-penny, and, in the second place, the transaction is no concern of B’s whatever.	Wird Arbeiter B beschäftigt mit dem Mehrwert, den Arbeiter A produziert hat, so hat erstens A diesen Mehrwert geliefert, ohne daß man ihm den gerechten Preis seiner Ware um einen Heller verkürzt hat, und zweitens geht dies Geschäft den B überhaupt nichts an.	ch24_clean.en-ch24_clean.de
What B claims, and has a right to claim, is that the capitalist should pay him the value of his labour-power.	Was B verlangt und das Recht hat zu verlangen, ist, daß der Kapitalist ihm den Wert seiner Arbeitskraft zahle.	ch24_clean.en-ch24_clean.de
“Both were still gainers: the worker because he was advanced the fruits of his labour” (should read: of the unpaid labour of other workers) “before the work was done” (should read: before his own labour had borne fruit); “the employer (le maître), because the labour of this worker was worth more than his wages” (should read: produced more value than the value of his wages). (Sismondi, l. c., p.	"Tous deux gagnaient encore; l'ouvrier parce qu'on lui avançait les fruits de son travail" (soll heißen du travail gratuit d'autres ouvriers) "avant qu'il fût fait;" (soll heißen: avant que le sien ait porté de fruit) "le maître, parce que le travail de cet ouvrier valait plus que le salaire" (soll heißen: produisait plus de valeur que celle de son salaire). <"Alle beide gewannen noch; der Arbeiter, weil man ihm die Früchte seiner Arbeit vorgeschossen" (soll heißen: unbezahlter Arbeit andrer Arbeiter), "bevor sie getan war;" (soll heißen: bevor seine eigne Früchte getragen) "der Unternehmer, weil die Arbeit dieses Arbeiters mehr wert war als sein Lohn" (soll heißen: mehr Wert erzeugte als den seines Lohns).> (Sismondi, l.c.p.	ch24_clean.en-ch24_clean.de
135.)	135.)	ch24_clean.en-ch24_clean.de
To be sure, the matter looks quite different if we consider capitalist production in the uninterrupted flow of its renewal, and if, in place of the individual capitalist and the individual worker, we view in their totality, the capitalist class and the working class confronting each other.	Allerdings sieht die Sache ganz anders aus, wenn wir die kapitalistische Produktion im ununterbrochnen Fluß ihrer Erneuerung betrachten und statt des einzelnen Kapitalisten und des einzelnen Arbeiters die Gesamtheit, die Kapitalistenklasse und ihr gegenüber die Arbeiterklasse ins Auge fassen.	ch24_clean.en-ch24_clean.de
But in so doing we should be applying standards entirely foreign to commodity production.	Damit aber würden wir einen Maßstab anlegen, der der Warenproduktion total fremd ist.	ch24_clean.en-ch24_clean.de
Only buyer and seller, mutually independent, face each other in commodity production.	In der Warenproduktion stehn sich nur, voneinander unabhängig, Verkäufer und Käufer gegenüber.	ch24_clean.en-ch24_clean.de
The relations between them cease on the day when the term stipulated in the contract they concluded expires.	Ihre gegenseitigen Beziehungen sind zu Ende mit dem Verfalltag des zwischen ihnen abgeschloßnen Vertrags.	ch24_clean.en-ch24_clean.de
If the transaction is repeated, it is repeated as the result of a new agreement which has nothing to do with the previous one and which only by chance brings the same seller together again with the same buyer.	Wiederholt sich das Geschäft, dann <4. Auflage: denn> infolge eines neuen Vertrags, der mit dem vorhergehenden nichts zu tun hat und bei dem nur ein Zufall denselben Käufer mit demselben Verkäufer wieder zusammenbringt.	ch24_clean.en-ch24_clean.de
If, therefore, commodity production, or one of its associated processes, is to be judged according to its own economic laws, we must consider each act of exchange by itself, apart from any connexion with the act of exchange preceding it and that following it.	Soll also die Warenproduktion oder ein ihr angehöriger Vorgang nach ihren eignen ökonomischen Gesetzen beurteilt werden, so müssen wir jeden Austauschakt für sich betrachten, außerhalb alles Zusammenhangs mit dem Austauschakt, der ihm vorherging, wie mit dem, der ihm nachfolgt.	ch24_clean.en-ch24_clean.de
And since sales and purchases are negotiated solely between particular individuals, it is not admissible to seek here for relations between whole social classes.	Und da Käufe und Verkäufe nur zwischen einzelnen Individuen abgeschlossen werden, so ist es unzulässig, Beziehungen zwischen ganzen Gesellschaftsklassen darin zu suchen.	ch24_clean.en-ch24_clean.de
However long a series of periodical reproductions and preceding accumulations the capital functioning today may have passed through, it always preserves its original virginity.	Wie lang auch die Reihenfolge der periodischen Reproduktionen und vorhergegangnen Akkumulationen, die das heute funktionierende Kapital durchgemacht hat, es bewahrt immer seine ursprüngliche Jungfräulichkeit.	ch24_clean.en-ch24_clean.de
So long as the laws of exchange are observed in every single act of exchange the mode of appropriation can be completely revolutionised without in any way affecting the property rights which correspond to commodity production.	Solange bei jedem Austauschakt - einzeln genommen - die Gesetze des Austausches eingehalten werden, kann die Aneignungsweise eine totale Umwälzung erfahren, ohne das, der Warenproduktion gemäße, Eigentumsrecht irgendwie zu berühren.	ch24_clean.en-ch24_clean.de
These same rights remain in force both at the outset, when the product belongs to its producer, who, exchanging equivalent for equivalent, can enrich himself only by his own labour, and also in the period of capitalism, when social wealth becomes to an ever-increasing degree the property of those who are in a position to appropriate continually and ever afresh the unpaid labour of others.	Dieses selbe Recht steht in Kraft wie am Anfang, wo das Produkt dem Produzenten gehört und wo dieser, Äquivalent gegen Äquivalent austauschend, sich nur durch eigne Arbeit bereichern kann, so auch in der kapitalistischen Periode, wo der gesellschaftliche Reichtum in stets steigendem Maß das Eigentum derer wird, die in der Lage sind, sich stets aufs neue die unbezahlte Arbeit andrer anzueignen.	ch24_clean.en-ch24_clean.de
This result becomes inevitable from the moment there is a free sale, by the labourer himself, of labour-power as a commodity.	Dies Resultat wird unvermeidlich, sobald die Arbeitskraft durch den Arbeiter selbst als Ware frei verkauft wird.	ch24_clean.en-ch24_clean.de
But it is also only from then onwards that commodity production is generalised and becomes the typical form of production; it is only from then onwards that, from the first, every product is produced for sale and all wealth produced goes through the sphere of circulation.	Aber auch erst von da an verallgemeinert sich die Warenproduktion und wird sie typische Produktionsform; erst von da an wird jedes Produkt von vornherein für den Verkauf produziert und geht aller produzierte Reichtum durch die Zirkulation hindurch.	ch24_clean.en-ch24_clean.de
Only when and where wage labour is its basis does commodity production impose itself upon society as a whole; but only then and there also does it unfold all its hidden potentialities.	Erst da, wo die Lohnarbeit ihre Basis, zwingt die Warenproduktion sich der gesamten Gesellschaft auf; aber auch erst da entfaltet sie alle ihre verborgnen Potenzen.	ch24_clean.en-ch24_clean.de
To say that the supervention of wage labour adulterates commodity production is to say that commodity production must not develop if it is to remain unadulterated.	Sagen, daß die Dazwischenkunft der Lohnarbeit die Warenproduktion fälscht, heißt sagen, daß die Warenproduktion, will sie unverfälscht bleiben, sich nicht entwickeln darf.	ch24_clean.en-ch24_clean.de
To the extent that commodity production, in accordance with its own inherent laws, develops further, into capitalist production, the property laws of commodity production change into the laws of capitalist appropriation.	Im selben Maß, wie sie nach ihren eignen immanenten Gesetzen sich zur kapitalistischen Produktion fortbildet, in demselben Maß schlagen die Eigentumsgesetze der Warenproduktion um in Gesetze der kapitalistischen Aneignung.	ch24_clean.en-ch24_clean.de
We have seen that even in the case of simple reproduction, all capital, whatever its original source, becomes converted into accumulated capital, capitalised surplus-value.	Man sah, daß selbst bei einfacher Reproduktion alles vorgeschoßne Kapital, wie immer ursprünglich erworben, sich in akkumuliertes Kapital oder kapitalisierten Mehrwert verwandelt.	ch24_clean.en-ch24_clean.de
But in the flood of production all the capital originally advanced becomes a vanishing quantity (magnitudo evanescens, in the mathematical sense), compared with the directly accumulated capital, i.e., with the surplus-value or surplus-product that is reconverted into capital, whether it functions in the hands of its accumulator, or in those of others.	Aber im Strom der Produktion wird überhaupt alles ursprünglich vorgeschoßne Kapital eine verschwindende Größe (magnitudo evanescens im mathematischen Sinn), verglichen mit dem direkt akkumulierten Kapital, d.h. dem in Kapital rückverwandelten Mehrwert oder Mehrprodukt, ob nun funktionierend in der Hand, die akkumuliert hat, oder in fremder Hand.	ch24_clean.en-ch24_clean.de
Hence, Political Economy describes capital in general as “accumulated wealth” (converted surplus-value or revenue), “that is employed over again in the production of surplus-value,” and the capitalist as “the owner of surplus-value.”	Die politische Ökonomie stellt das Kapital daher überhaupt dar als "akkumulierten Reichtum" (verwandelten Mehrwert oder Revenue), "der von neuem zur Produktion von Mehrwert verwandt wird" , oder auch den Kapitalisten als "Besitzer des Mehrprodukts" .	ch24_clean.en-ch24_clean.de
It is merely another way of expressing the same thing to say that all existing capital is accumulated or capitalised interest, for interest is a mere fragment of surplus-value.	Dieselbe Anschauungsweise besitzt nur andre Form in dem Ausdruck, daß alles vorhandne Kapital akkumulierter oder kapitalisierter Zins sei, denn der Zins ist ein bloßes Bruchstück des Mehrwerts.	ch24_clean.en-ch24_clean.de
Section 2: Erroneous Conception, by Political Economy, of Reproduction on a Progressively Increasing Scale Before we further investigate accumulation or the reconversion of surplus-value into capital, we must brush on one side an ambiguity introduced by the classical economists.	2. Irrige Auffassung der Reproduktion auf erweiterter Stufenleiter seitens der politischen Ökonomie Bevor wir nun auf einige nähere Bestimmungen der Akkumulation oder der Rückverwandlung von Mehrwert in Kapital eingehn, ist eine von der klassischen Ökonomie ausgeheckte Zweideutigkeit zu beseitigen.	ch24_clean.en-ch24_clean.de
Just as little as the commodities that the capitalist buys with a part of the surplus-value for his own consumption, serve the purpose of production and of creation of value, so little is the labour that he buys for the satisfaction of his natural and social requirements, productive labour.	So wenig die Waren, die der Kapitalist mit einem Teil des Mehrwerts für seine eigne Konsumtion kauft, ihm als Produktions- und Verwertungsmittel dienen, so wenig ist die Arbeit, die er zur Befriedigung seiner natürlichen und sozialen Bedürfnisse kauft, produktive Arbeit.	ch24_clean.en-ch24_clean.de
Instead of converting surplus-value into capital, he, on the contrary, by the purchase of those commodities and that labour, consumes or expends it as revenue.	Statt durch den Kauf jener Waren und Arbeit den Mehrwert in Kapital zu verwandeln, verzehrt oder verausgabt er ihn umgekehrt als Revenue.	ch24_clean.en-ch24_clean.de
In the face of the habitual mode of life of the old feudal nobility, which, as Hegel rightly says, “consists in consuming what is in hand,” and more especially displays itself in the luxury of personal retainers, it was extremely important for bourgeois economy to promulgate the doctrine that accumulation of capital is the first duty of every citizen, and to preach without ceasing, that a man cannot accumulate, if he eats up all his revenue, instead of spending a good part of it in the acquisition of additional productive labourers, who bring in more than they cost.	Gegenüber der altadligen Gesinnung, die, wie Hegel richtig sagt, "im Verzehren des Vorhandenen besteht" und namentlich auch im Luxus persönlicher Dienste sich breitmacht, war es für die bürgerliche Ökonomie entscheidend wichtig, die Akkumulation des Kapitals als erste Bürgerpflicht zu verkünden und unermüdlich zu predigen: man kann nicht akkumulieren, wenn man seine ganze Revenue aufißt, statt einen guten Teil davon zu verausgaben in Werbung zuschüssiger produktiver Arbeiter, die mehr einbringen, als sie kosten.	ch24_clean.en-ch24_clean.de
On the other hand the economists had to contend against the popular prejudice, that confuses capitalist production with hoarding, and fancies that accumulated wealth is either wealth that is rescued from being destroyed in its existing form, i.e., from being consumed, or wealth that is withdrawn from circulation.	Andrerseits hatte sie gegen das Volksvorurteil zu polemisieren, welches die kapitalistische Produktion mit der Schatzbildung verwechselt und daher wähnt, akkumulierter Reichtum sei Reichtum, welcher der Zerstörung in seiner vorhandnen Naturalform, also dem Verbrauch entzogen oder auch vor der Zirkulation gerettet werde.	ch24_clean.en-ch24_clean.de
Exclusion of money from circulation would also exclude absolutely its self-expansion as capital, while accumulation of a hoard in the shape of commodities would be sheer tomfoolery.	Verschluß des Geldes gegen die Zirkulation wäre grade das Gegenteil seiner Verwertung als Kapital und Warenakkumulation im schatzbildnerischen Sinn reine Narrheit.	ch24_clean.en-ch24_clean.de
The accumulation of commodities in great masses is the result either of over-production or of a stoppage of circulation.	(28a) Akkumulation von Waren in großen Massen ist Resultat einer Zirkulationsstockung oder der Überproduktion.	ch24_clean.en-ch24_clean.de
It is true that the popular mind is impressed by the sight, on the one hand, of the mass of goods that are stored up for gradual consumption by the rich, and on the other hand, by the formation of reserve stocks; the latter, a phenomenon that is common to all modes of production, and on which we shall dwell for a moment, when we come to analyse circulation.	Allerdings läuft in der Volksvorstellung einerseits das Bild der im Konsumtionsfonds der Reichen gehäuften, langsam sich verzehrenden Güter unter, andrerseits die Vorratbildung, ein Phänomen, das allen Produktionsweisen angehört und wobei wir einen Augenblick in der Analyse des Zirkulationsprozesses verweilen werden.	ch24_clean.en-ch24_clean.de
Classical economy is therefore quite right, when it maintains that the consumption of surplus-products by productive, instead of by unproductive labourers, is a characteristic feature of the process of accumulation.	Soweit also ist die klassische Ökonomie im Recht, wenn sie den Verzehr von Mehrprodukt durch produktive Arbeiter statt durch unproduktive als charakteristisches Moment des Akkumulationsprozesses betont.	ch24_clean.en-ch24_clean.de
But at this point the mistakes also begin.	Aber hier beginnt auch ihr Irrtum.	ch24_clean.en-ch24_clean.de
Adam Smith has made it the fashion, to represent accumulation as nothing more than consumption of surplus products by productive labourers, which amounts to saying, that the capitalising of surplus-value consists in merely turning surplus-value into labour-power.	A. Smith hat es zur Mode gemacht, die Akkumulation bloß als Konsumtion des Mehrprodukts durch produktive Arbeiter oder die Kapitalisierung des Mehrwerts als dessen bloßen Umsatz in Arbeitskraft darzustellen.	ch24_clean.en-ch24_clean.de
Let us see what Ricardo, e.g., says: “It must be understood that all the productions of a country are consumed; but it makes the greatest difference imaginable whether they are consumed by those who reproduce, or by those who do not reproduce another value.	Hören wir z.B. Ricardo: "Man muß verstehn, daß alle Produkte eines Landes konsumiert werden; aber es macht den größten Unterschied, den man denken kann, ob sie konsumiert werden durch solche, die einen andren Wert reproduzieren, oder durch solche, die ihn nicht reproduzieren.	ch24_clean.en-ch24_clean.de
When we say that revenue is saved, and added to capital, what we mean is, that the portion of revenue, so said to be added to capital, is consumed by productive instead of unproductive labourers.	Wenn wir sagen, daß Revenue erspart und zum Kapital geschlagen wird, so meinen wir, daß der Teil der Revenue, von dem es heißt, er sei zum Kapital geschlagen, durch produktive statt durch unproduktive Arbeiter verzehrt wird.	ch24_clean.en-ch24_clean.de
There can be no greater error than in supposing that capital is increased by non-consumption.” 16 There can be no greater error than that which Ricardo and all subsequent economists repeat after A. Smith, viz., that “the part of revenue, of which it is said, it has been added to capital, is consumed by productive labourers.”	Es gibt keinen größern Irrtum, als zu unterstellen, daß Kapital durch Nicht-Konsum vermehrt wird." Es gibt keinen größern Irrtum als der dem A. Smith von Ricardo und allen späteren nachgeplauderte, daß "der Teil der Revenue, von dem es heißt, er sei zum Kapital geschlagen, von produktiven Arbeitern verzehrt wird".	ch24_clean.en-ch24_clean.de
According to this, all surplus-value that is changed into capital becomes variable capital.	Nach dieser Vorstellung würde aller Mehrwert, der in Kapital verwandelt wird, zu variablem Kapital.	ch24_clean.en-ch24_clean.de
So far from this being the case, the surplus-value, like the original capital, divides itself into constant capital and variable capital, into means of production and labour-power.	Er teilt sich vielmehr, wie der ursprünglich vorgeschoßne Wert, in konstantes Kapital und variables Kapital, in Produktionsmittel und Arbeitskraft.	ch24_clean.en-ch24_clean.de
Labour-power is the form under which variable capital exists during the process of production.	Arbeitskraft ist die Form, worin das variable Kapital innerhalb des Produktionsprozesses existiert.	ch24_clean.en-ch24_clean.de
In this process the labour-power is itself consumed by the capitalist while the means of production are consumed by the labour-power in the exercise of its function, labour.	In diesem Prozeß wird sie selbst vom Kapitalisten verzehrt. Sie verzehrt durch ihre Funktion - die Arbeit - Produktionsmittel.	ch24_clean.en-ch24_clean.de
At the same time, the money paid for the purchase of the labour-power, is converted into necessaries, that are consumed, not by “productive labour,” but by the “productive labourer.”	Zugleich verwandelt sich das im Ankauf der Arbeitskraft gezahlte Geld in Lebensmittel, die nicht von der "produktiven Arbeit", sondern vom "produktiven Arbeiter" verzehrt werden.	ch24_clean.en-ch24_clean.de
Adam Smith, by a fundamentally perverted analysis, arrives at the absurd conclusion, that even though each individual capital is divided into a constant and a variable part, the capital of society resolves itself only into variable capital, i.e., is laid out exclusively in payment of wages. For instance, suppose a cloth manufacturer converts £2, into capital.	A. Smith gelangt durch eine grundverkehrte Analyse zu dem abgeschmackten Resultat daß, wenn auch jedes individuelle Kapital sich in konstanten und variablen Bestandteil teilt, das gesellschaftliche Kapital sich in nur variables Kapital auflöst oder nur in Zahlung von Arbeitslohn verausgabt wird.	ch24_clean.en-ch24_clean.de
One portion he lays out in buying weavers, the other in woollen yarn, machinery, &c.	Z.B. ein Tuchfabrikant verwandle 2.000 Pfd.St. in Kapital.	ch24_clean.en-ch24_clean.de
But the people, from whom he buys the yarn and the machinery, pay for labour with a part of the purchase money, and so on until the whole £2, are spent in the payment of wages, i.e., until the entire product represented by the £2, has been consumed by productive labourers.	Er legt einen Teil des Geldes im Ankauf von Webern aus, den andern Teil in Wollengarn, Wollenmaschinerie usw. Aber die Leute, von denen er das Garn und die Maschinerie kauft, zahlen wieder mit einem Teil davon Arbeit usw., bis die ganzen 2.000 Pfd.St. in Zahlung von Arbeitslohn verausgabt sind oder das ganze durch die 2.000 Pfd.St. repräsentierte Produkt durch produktive Arbeiter verzehrt ist.	ch24_clean.en-ch24_clean.de
It is evident that the whole gist of this argument lies in the words “and so on,” which send us from pillar to post.	Man sieht: die ganze Wucht dieses Arguments liegt in dem Wort "usw.", das uns von Pontius zu Pilatus schickt.	ch24_clean.en-ch24_clean.de
In truth, Adam Smith breaks his investigation off, just where its difficulties begin.	In der Tat, A. Smith bricht die Untersuchung grade da ab, wo ihre Schwierigkeit beginnt.	ch24_clean.en-ch24_clean.de
The annual process of reproduction is easily understood, so long as we keep in view merely the sum total of the year’s production.	Solange man nur den Fonds der Gesamt-Jahresproduktion ins Auge faßt, ist der jährliche Reproduktionsprozeß leicht verständlich.	ch24_clean.en-ch24_clean.de
But every single component of this product must be brought into the market as a commodity, and there the difficulty begins.	Aber alle Bestandteile der Jahresproduktion müssen auf den Warenmarkt gebracht werden, und da beginnt die Schwierigkeit.	ch24_clean.en-ch24_clean.de
The movements of the individual capitals, and of the personal revenues, cross and intermingle and are lost in the general change of places, in the circulation of the wealth of society; this dazes the sight, and propounds very complicated problems for solution. In the third part of Book II.	Die Bewegungen der Einzelkapitale und persönlichen Revenuen kreuzen, vermengen, verlieren sich in einem allgemeinen Stellenwechsel - der Zirkulation des gesellschaftlichen Reichtums - , der den Blick verwirrt und der Untersuchung sehr verwickelte Aufgaben zu lösen gibt.	ch24_clean.en-ch24_clean.de
I shall give the analysis of the real bearings of the facts. It is one of the great merits of the Physiocrats, that in their Tableau économique they were the first to attempt to depict the annual production in the shape in which it is presented to us after passing through the process of circulation.	Im dritten Abschnitt des Zweiten Buches werde ich die Analyse des wirklichen Zusammenhanges geben. - Es ist das große Verdienst der Physiokraten, in ihrem Tableau economique zum ersten Mal den Versuch gemacht zu haben, ein Bild der Jahresproduktion zu geben in der Gestalt, in welcher sie aus der Zirkulation hervorgeht.	ch24_clean.en-ch24_clean.de
For the rest, it is a matter of course, that Political Economy, acting in the interests of the capitalist class, has not failed to exploit the doctrine of Adam Smith, viz., that the whole of that part of the surplus-product which is converted into capital, is consumed by the working class.	Es versteht sich übrigens von selbst, daß die politische Ökonomie nicht verfehlt hat, im Interesse der Kapitalistenklasse A. Smiths Satz auszubeuten: daß der ganze in Kapital verwandelte Teil des Nettoprodukts von der Arbeiterklasse verzehrt wird.	ch24_clean.en-ch24_clean.de
Section 3: Separation of Surplus-Value into Capital and Revenue.	3. Teilung des Mehrwerts in Kapital und Revenue.	ch24_clean.en-ch24_clean.de
The Abstinence Theory In the last preceding chapter, we treated surplus-value (or the surplus-product) solely as a fund for supplying the individual consumption of the capitalist. In this chapter we have, so far, treated it solely as a fund for accumulation.	Die Abstinenztheorie Im vorigen Kapitel betrachteten wir den Mehrwert, resp. das Mehrprodukt, nur als individuellen Konsumtionsfonds des Kapitalisten, in diesem Kapitel bisher nur als einen Akkumulationsfonds.	ch24_clean.en-ch24_clean.de
It is, however, neither the one nor the other, but is both together.	Er ist aber weder nur das eine noch das andre, sondern beides zugleich.	ch24_clean.en-ch24_clean.de
One portion is consumed by the capitalist as revenue, the other is employed as capital, is accumulated.	Ein Teil des Mehr- werts wird vom Kapitalisten als Revenue verzehrt , ein andrer Teil als Kapital angewandt oder akkumuliert.	ch24_clean.en-ch24_clean.de
Given the mass of surplus-value, then, the larger the one of these parts, the smaller is the other.	Bei gegebner Masse des Mehrwerts wird der eine dieser Teile um so größer sein, je kleiner der andre ist.	ch24_clean.en-ch24_clean.de
Caeteris paribus, the ratio of these parts determines the magnitude of the accumulation.	Alle andern Umstände als gleichbleibend genommen, bestimmt das Verhältnis, worin diese Teilung sich vollzieht, die Größe der Akkumulation.	ch24_clean.en-ch24_clean.de
But it is by the owner of the surplus-value, by the capitalist alone, that the division is made.	Wer aber diese Teilung vornimmt, das ist der Eigentümer des Mehrwerts, der Kapitalist.	ch24_clean.en-ch24_clean.de
It is his deliberate act.	Sie ist also sein Willensakt.	ch24_clean.en-ch24_clean.de
That part of the tribute exacted by him which he accumulates, is said to be saved by him, because he does not eat it, i.e., because he performs the function of a capitalist, and enriches himself.	Von dem Teil des von ihm erhobnen Tributs, den er akkumuliert, sagt man, er spare ihn, weil er ihn nicht aufißt, d.h., weil er seine Funktion als Kapitalist ausübt, nämlich die Funktion, sich zu bereichern.	ch24_clean.en-ch24_clean.de
Except as personified capital, the capitalist has no historical value, and no right to that historical existence, which, to use an expression of the witty Lichnowsky, “hasn’t got no date.”	Nur soweit der Kapitalist personifiziertes Kapital ist, hat er einen historischen Wert und jenes historische Existenzrecht, das, wie der geistreiche Lichnowski sagt, keinen Datum nicht hat.	ch24_clean.en-ch24_clean.de
And so far only is the necessity for his own transitory existence implied in the transitory necessity for the capitalist mode of production.	Nur soweit steckt seine eigne transitorische Notwendigkeit in der transitorischen Notwendigkeit der kapitalistischen Produktionsweise.	ch24_clean.en-ch24_clean.de
But, so far as he is personified capital, it is not values in use and the enjoyment of them, but exchange-value and its augmentation, that spur him into action.	Aber soweit sind auch nicht Gebrauchswert und Genuß, sondern Tauschwert und dessen Vermehrung sein treibendes Motiv.	ch24_clean.en-ch24_clean.de
Fanatically bent on making value expand itself, he ruthlessly forces the human race to produce for production’s sake; he thus forces the development of the productive powers of society, and creates those material conditions, which alone can form the real basis of a higher form of society, a society in which the full and free development of every individual forms the ruling principle.	Als Fanatiker der Verwertung des Werts zwingt er rücksichtslos die Menschheit zur Produktion um der Produktion willen, daher zu einer Entwicklung der gesellschaftlichen Produktivkräfte und zur Schöpfung von materiellen Produktionsbedingungen, welche allein die reale Basis einer höheren Gesellschaftsform bilden können, deren Grundprinzip die volle und freie Entwicklung jedes Individuums ist.	ch24_clean.en-ch24_clean.de
Only as personified capital is the capitalist respectable.	Nur als Personifikation des Kapitals ist der Kapitalist respektabel.	ch24_clean.en-ch24_clean.de
As such, he shares with the miser the passion for wealth as wealth.	Als solche teilt er mit dem Schatzbildner den absoluten Bereicherungstrieb.	ch24_clean.en-ch24_clean.de
But that which in the miser is a mere idiosyncrasy, is, in the capitalist, the effect of the social mechanism, of which he is but one of the wheels.	Was aber bei diesem als individuelle Manie erscheint, ist beim Kapitalisten Wirkung des gesellschaftlichen Mechanismus, worin er nur ein Triebrad ist.	ch24_clean.en-ch24_clean.de
Moreover, the development of capitalist production makes it constantly necessary to keep increasing the amount of the capital laid out in a given industrial undertaking, and competition makes the immanent laws of capitalist production to be felt by each individual capitalist, as external coercive laws.	Außerdem macht die Entwicklung der kapitalistischen Produktion eine fortwährende Steigerung des in einem industriellen Unternehmen angelegten Kapitals zur Notwendigkeit, und die Konkurrenz herrscht jedem individuellen Kapitalisten die immanenten Gesetze der kapitalistischen Produktionsweise als äußere Zwangsgesetze auf.	ch24_clean.en-ch24_clean.de
It compels him to keep constantly extending his capital, in order to preserve it, but extend it he cannot, except by means of progressive accumulation.	Sie zwingt ihn, sein Kapital fortwährend auszudehnen, um es zu erhalten, und ausdehnen kann er es nur vermittelst progressiver Akkumulation.	ch24_clean.en-ch24_clean.de
So far, therefore, as his actions are a mere function of capital – endowed as capital is, in his person, with consciousness and a will – his own private consumption is a robbery perpetrated on accumulation, just as in book-keeping by double entry, the private expenditure of the capitalist is placed on the debtor side of his account against his capital.	Soweit daher sein Tun und Lassen nur Funktion des in ihm mit Willen und Bewußtsein begabten Kapitals, gilt ihm sein eigner Privatkonsum als ein Raub an der Akkumulation seines Kapitals, wie in der italienischen Buchhaltung Privatausgaben auf der Debetseite des Kapitalisten gegen das Kapital figurieren.	ch24_clean.en-ch24_clean.de
To accumulate, is to conquer the world of social wealth, to increase the mass of human beings exploited by him, and thus to extend both the direct and the indirect sway of the capitalist.	Die Akkumulation ist Eroberung der Welt des gesellschaftlichen Reichtums. Sie dehnt mit der Masse des exploitierten Menschenmaterials zugleich die direkte und indirekte Herrschaft des Kapitalisten aus.	ch24_clean.en-ch24_clean.de
But original sin is at work everywhere.	Aber die Erbsünde wirkt überall.	ch24_clean.en-ch24_clean.de
As capitalist production, accumulation, and wealth, become developed, the capitalist ceases to be the mere incarnation of capital.	Mit der Entwicklung der kapitalistischen Produktionsweise, der Akkumulation und des Reichtums, hört der Kapitalist auf, bloße Inkarnation des Kapitals zu sein.	ch24_clean.en-ch24_clean.de
He has a fellow-feeling for his own Adam, and his education gradually enables him to smile at the rage for asceticism, as a mere prejudice of the old-fashioned miser.	Er fühlt ein "menschliches Rühren" für seinen eignen Adam und wird so gebildet, die Schwärmerei für Askese als Vorurteil des altmodischen Schatzbildners zu belächeln.	ch24_clean.en-ch24_clean.de
While the capitalist of the classical type brands individual consumption as a sin against his function, and as “abstinence” from accumulating, the modernised capitalist is capable of looking upon accumulation as “abstinence” from pleasure.	Während der klassische Kapitalist den individuellen Konsum als Sünde gegen seine Funktion und "Enthaltung" von der Akkumulation brandmarkt, ist der modernisierte Kapitalist imstande, die Akkumulation als "Entsagung" seines Genußtriebs aufzufassen.	ch24_clean.en-ch24_clean.de
“Two souls, alas, do dwell with in his breast; The one is ever parting from the other.”	"Zwei Seelen wohnen, ach! in seiner Brust, die eine will sich von der andren trennen!"	ch24_clean.en-ch24_clean.de
At the historical dawn of capitalist production, – and every capitalist upstart has personally to go through this historical stage – avarice, and desire to get rich, are the ruling passions.	In den historischen Anfängen der kapitalistischen Produktionsweise, und jeder kapitalistische Parvenü macht dies historische Stadium individuell durch - herrschen Bereicherungstrieb und Geiz als absolute Leidenschaften vor.	ch24_clean.en-ch24_clean.de
But the progress of capitalist production not only creates a world of delights; it lays open, in speculation and the credit system, a thousand sources of sudden enrichment.	Aber der Fortschritt der kapitalistischen Produktion schafft nicht nur eine Welt von Genüssen. Er öffnet mit der Spekulation und dem Kreditwesen tausend Quellen plötzlicher Bereicherung.	ch24_clean.en-ch24_clean.de
When a certain stage of development has been reached, a conventional degree of prodigality, which is also an exhibition of wealth, and consequently a source of credit, becomes a business necessity to the “unfortunate” capitalist.	Auf einer gewissen Entwicklungshöhe wird ein konventioneller Grad von Verschwendung, die zugleich Schaustellung des Reichtums und daher Kreditmittel ist, sogar zu einer Geschäftsnotwendigkeit des "unglücklichen" Kapitalisten.	ch24_clean.en-ch24_clean.de
Luxury enters into capital’s expenses of representation.	Der Luxus geht in die Repräsentationskosten des Kapitals ein.	ch24_clean.en-ch24_clean.de
Moreover, the capitalist gets rich, not like the miser, in proportion to his personal labour and restricted consumption, but at the same rate as he squeezes out the labour-power of others, and enforces on the labourer abstinence from all life’s enjoyments.	Ohnehin bereichert sich der Kapitalist nicht, gleich dem Schatzbildner, im Verhältnis seiner persönlichen Arbeit und seines persönlichen Nichtkonsums, sondern im Maß, worin er fremde Arbeitskraft aussaugt und dem Arbeiter Entsagung aller Lebensgenüsse aufzwingt.	ch24_clean.en-ch24_clean.de
Although, therefore, the prodigality of the capitalist never possesses the bona fide character of the open-handed feudal lord’s prodigality, but, on the contrary, has always lurking behind it the most sordid avarice and the most anxious calculation, yet his expenditure grows with his accumulation, without the one necessarily restricting the other.	Obgleich daher die Verschwendung des Kapitalisten nie den bona fide Charakter der Verschwendung des flotten Feudalherrn besitzt, in ihrem Hintergrund vielmehr stets schmutzigster Geiz und ängstlichste Berechnung lauern, wächst dennoch seine Verschwendung mit seiner Akkumulation, ohne daß die eine die andre zu beabbruchen braucht.	ch24_clean.en-ch24_clean.de
But along with this growth, there is at the same time developed in his breast, a Faustian conflict between the passion for accumulation, and the desire for enjoyment.	Damit entwickelt sich gleichzeitig in der Hochbrust des Kapitalindividuums ein faustischer Konflikt zwischen Akkumulations- und Genußtrieb.	ch24_clean.en-ch24_clean.de
Dr. Aikin says in a work published in 1795: “The trade of Manchester may be divided into four periods.	"Die Industrie von Manchester", heißt es in einer Schrift, die Dr. Aikin 1795 veröffentlichte, "kann in vier Perioden geteilt werden.	ch24_clean.en-ch24_clean.de
First, when manufacturers were obliged to work hard for their livelihood.”	In der ersten waren die Fabrikanten gezwungen, hart für ihren Lebensunterhalt zu arbeiten."	ch24_clean.en-ch24_clean.de
They enriched themselves chiefly by robbing the parents, whose children were bound as apprentices to them; the parents paid a high premium, while the apprentices were starved.	Sie bereicherten sich besonders durch Bestehlung der Eltern, die ihnen Jungen als apprentices (Lehrlinge) zuwiesen und dafür schwer blechen mußten, während die Lehrlinge ausgehungert wurden.	ch24_clean.en-ch24_clean.de
On the other hand, the average profits were low, and to accumulate, extreme parsimony was requisite.	Andrerseits waren die Durchschnittsprofite niedrig, und die Akkumulation verlangte große Sparsamkeit.	ch24_clean.en-ch24_clean.de
They lived like misers and were far from consuming even the interest on their capital.	Sie lebten wie Schatzbildner und verzehrten bei weitem nicht einmal die Zinsen ihres Kapitals.	ch24_clean.en-ch24_clean.de
“The second period, when they had begun to acquire little fortunes, but worked as hard as before,” – for direct exploitation of labour costs labour, as every slave-driver knows – “and lived in as plain a manner as before....	"In der zweiten Periode hatten sie begonnen, kleine Vermögen zu erwerben, arbeiteten aber ebenso hart als zuvor", denn die unmittelbare Exploitation der Arbeit kostet Arbeit, wie jeder Sklaventreiber weiß, "und lebten nach wie vor in demselben frugalen Stil ...	ch24_clean.en-ch24_clean.de
The third, when luxury began, and the trade was pushed by sending out riders for orders into every market town in the Kingdom....	In der dritten Periode begann der Luxus, und das Geschäft wurde ausgedehnt durch Aussendung von Reitern" (berittenen Commis voyageurs) "für Ordres in jeder Marktstadt des Königreichs.	ch24_clean.en-ch24_clean.de
It is probable that few or no capitals of £3, to £4, acquired by trade existed here before 1690.	Es ist wahrscheinlich, daß wenige oder keine Kapitale von 3.000 bis 4.000 Pfd.St., in der Industrie erworben, vor 1690 existierten.	ch24_clean.en-ch24_clean.de
However, about that time, or a little later, the traders had got money beforehand, and began to build modern brick houses, instead of those of wood and plaster.”	Um diese Zeit jedoch oder etwas später hatten die Industriellen schon Geld akkumuliert und begannen steinerne Häuser statt der von Holz und Mörtel aufzuführen ...	ch24_clean.en-ch24_clean.de
Even in the early part of the 18th century, a Manchester manufacturer, who placed a pint of foreign wine before his guests, exposed himself to the remarks and headshakings of all his neighbours.	Noch in den ersten Dezennien des 18. Jahrhunderts setzte sich ein Manchester Fabrikant, der eine Pint fremden Weins seinen Gästen vorsetzte, den Glossen und dem Kopfschütteln aller seiner Nachbarn aus."	ch24_clean.en-ch24_clean.de
Before the rise of machinery, a manufacturer’s evening expenditure at the public house where they all met, never exceeded sixpence for a glass of punch, and a penny for a screw of tobacco.	Vor dem Aufkommen der Maschinerie betrug der abendliche Konsum der Fabrikanten in den Kneipen, wo sie zusammenkamen, nie mehr als 6 d. für ein Glas Punsch und 1 d. für eine Rolle Tabak.	ch24_clean.en-ch24_clean.de
It was not till 1758, and this marks an epoch, that a person actually engaged in business was seen with an equipage of his own.	Erst 1758, und dies macht Epoche, sah man "eine im Geschäft wirklich engagierte Person mit eigner Equipage!"	ch24_clean.en-ch24_clean.de
“The fourth period,” the last 30 years of the 18th century, “is that in which expense and luxury have made great progress, and was supported by a trade extended by means of riders and factors through every part of Europe.”	"Die vierte Periode", das letzte Dritteil des 18. Jahrhunderts, "ist die von großem Luxus und Verschwendung, unterstützt durch die Ausdehnung des Geschäfts."	ch24_clean.en-ch24_clean.de
What would the good Dr. Aikin say if he could rise from his grave and see the Manchester of today?	Was würde der gute Dr. Aikin sagen, wenn er heutzutag in Manchester auferstände!	ch24_clean.en-ch24_clean.de
Accumulate, accumulate!	Akkumuliert, Akkumuliert!	ch24_clean.en-ch24_clean.de
That is Moses and the prophets!	Das ist Moses und die Propheten!	ch24_clean.en-ch24_clean.de
“Industry furnishes the material which saving accumulates.”	"Die Industrie liefert das Material, welches die Sparsamkeit akkumuliert."	ch24_clean.en-ch24_clean.de
Therefore, save, save, i.e., reconvert the greatest possible portion of surplus-value, or surplus-product into capital!	Also spart, spart, d.h., rückverwandelt möglichst großen Teil des Mehrwerts oder Mehrprodukts in Kapital!	ch24_clean.en-ch24_clean.de
Accumulation for accumulation’s sake, production for production’s sake: by this formula classical economy expressed the historical mission of the bourgeoisie, and did not for a single instant deceive itself over the birth-throes of wealth.	Akkumulation um der Akkumulation, Produktion um der Produktion willen, in dieser Formel sprach die klassische Ökonomie den historischen Beruf der Bourgeoisperiode aus.	ch24_clean.en-ch24_clean.de
But what avails lamentation in the face of historical necessity?	Sie täuschte sich keinen Augenblick über die Geburtswehn des Reichtums , aber was nützt der Jammer über historische Notwendigkeit?	ch24_clean.en-ch24_clean.de
If to classical economy, the proletarian is but a machine for the production of surplus-value; on the other hand, the capitalist is in its eyes only a machine for the conversion of this surplus-value into additional capital.	Wenn der klassischen Ökonomie der Proletarier nur als Maschine zur Produktion von Mehrwert, gilt ihr aber auch der Kapitalist nur als Maschine zur Verwandlung dieses Mehrwerts in Mehrkapital.	ch24_clean.en-ch24_clean.de
Political Economy takes the historical function of the capitalist in bitter earnest.	Sie nimmt seine historische Funktion in bitterm Ernst.	ch24_clean.en-ch24_clean.de
In order to charm out of his bosom the awful conflict between the desire for enjoyment and the chase after riches, Malthus, about the year 1820, advocated a division of labour, which assigns to the capitalist actually engaged in production, the business of accumulating, and to the other sharers in surplus-value, to the landlords, the place-men, the beneficed clergy, &c., the business of spending.	Um seinen Busen vor dem unheilvollen Konflikt zwischen Genußtrieb und Bereicherungstrieb zu feien, verteidigte Malthus, im Anfang der zwanziger Jahre dieses Jahrhunderts, eine Teilung der Arbeit, welche dem wirklich in der Produktion begriffenen Kapitalisten das Geschäft der Akkumulation, den andren Teilnehmern am Mehrwert, der Landaristokratie, Staats-, Kirchenpfründnern usw., das Geschäft der Verschwendung zuweist.	ch24_clean.en-ch24_clean.de
It is of the highest importance, he says, “to keep separate the passion for expenditure and the passion for accumulation.”	Es ist von der höchsten Wichtigkeit, sagt er, "die Leidenschaft für Ausgabe und die Leidenschaft für Akkumulation (the passion for expenditure and the passion for accumulation) getrennt zu halten" .	ch24_clean.en-ch24_clean.de
The capitalists having long been good livers and men of the world, uttered loud cries.	Die Herrn Kapitalisten, seit lange in Lebe- und Weltmänner verwandelt, schrien auf.	ch24_clean.en-ch24_clean.de
What, exclaimed one of their spokesmen, a disciple of Ricardo, Mr. Malthus preaches high rents, heavy taxes, &c., so that the pressure of the spur may constantly be kept on the industrious by unproductive consumers!	Was, rief einer ihrer Wortführer, ein Ricardianer, Herr Malthus predigt hohe Grundrenten, hohe Steuern usw., um dem Industriellen einen fortwährenden Stachel durch unproduktive Konsumenten aufzudrücken!	ch24_clean.en-ch24_clean.de
By all means, production, production on a constantly increasing scale, runs the shibboleth; but “production will, by such a process, be far more curbed in than spurred on.	Allerdings Produktion, Produktion auf stets erweiterter Stufenleiter, lautet das Schibboleth, aber "Produktion wird durch einen solchen Prozeß weit mehr gehemmt als gefördert.	ch24_clean.en-ch24_clean.de
Nor is it quite fair thus to maintain in idleness a number of persons, only to pinch others, who are likely, from their characters, if you can force them to work, to work with success.”	Auch ist es nicht ganz billig (nor is it quite fair), eine Anzahl Personen so im Müßiggang zu erhalten, nur um andre zu kneipen, aus deren Charakter man schließen darf (who are likely, from their characters), daß, wenn ihr sie zu funktionieren zwingen könnt, sie mit Erfolg funktionieren."	ch24_clean.en-ch24_clean.de
Unfair as he finds it to spur on the industrial capitalist, by depriving his bread of its butter, yet he thinks it necessary to reduce the labourer’s wages to a minimum "to keep him industrious.”	So unbillig er es findet, den industriellen Kapitalisten zur Akkumulation zu stacheln, indem man ihm das Fett von der Suppe weggchöpft, so notwendig dünkt ihm, den Arbeiter möglichst auf den Minimallohn zu beschränken, "um ihn arbeitsam zu erhalten".	ch24_clean.en-ch24_clean.de
Nor does he for a moment conceal the fact, that the appropriation of unpaid labour is the secret of surplus-value.	Auch verheimlicht er keinen Augenblick, daß Aneignung unbezahlter Arbeit das Geheimnis der Plusmacherei ist.	ch24_clean.en-ch24_clean.de
“Increased demand on the part of the labourers means nothing more than their willingness to take less of their own product for themselves, and leave a greater part of it to their employers; and if it be said, that this begets glut, by lessening consumption” (on the part of the labourers), “I can only reply that glut is synonymous with large profits.”	"Vermehrte Nachfrage von Seite der Arbeiter meint durchaus nichts als ihre Geneigtheit, weniger von ihrem eignen Produkt für sich selbst zu nehmen und einen größren Teil davon ihren Anwendern zu überlassen; und wenn man sagt, daß dies, durch Verminderung der Konsumtion" (auf seiten der Arbeiter) "glut" (Marktüberfüllung, Überproduktion) "erzeugt, so kann ich nur antworten, daß glut synonym mit hohem Profit ist."	ch24_clean.en-ch24_clean.de
The learned disputation, how the booty pumped out of the labourer may be divided, with most advantage to accumulation, between the industrial capitalist and the rich idler, was hushed in face of the revolution of July.	Der gelehrte Zank, wie die dem Arbeiter ausgepumpte Beute förderlichst für die Akkumulation zu verteilen sei zwischen industriellem Kapitalist und müßigem Grundeigentümer usw., verstummte vor der Julirevolution.	ch24_clean.en-ch24_clean.de
Shortly afterwards, the town proletariat at Lyons sounded the tocsin of revolution, and the country proletariat in England began to set fire to farm-yards and corn-stacks.	Kurz nachher läutete das städtische Proletariat die Sturmglocke zu Lyon und ließ das Landproletariat den roten Hahn in England fliegen.	ch24_clean.en-ch24_clean.de
On this side of the Channel Owenism began to spread; on the other side, St. Simonism and Fourierism.	Diesseits des Kanals grassierte der Owenismus, jenseits St.-Simonismus und Fourierismus.	ch24_clean.en-ch24_clean.de
The hour of vulgar economy had struck.	Die Stunde der Vulgärökonomie hatte geschlagen.	ch24_clean.en-ch24_clean.de
Exactly a year before Nassau W. Senior discovered at Manchester, that the profit (including interest) of capital is the product of the last hour of the twelve, he had announced to the world another discovery.	Grade ein Jahr, bevor Nassau W. Senior zu Manchester ausfand, daß der Profit (inkl. Zins) des Kapitals das Produkt der unbezahlten "letzten zwölften Arbeitsstunde" ist, hatte er der Welt eine andre Entdeckung angekündigt.	ch24_clean.en-ch24_clean.de
“I substitute,” he proudly says, “for the word capital, considered as an instrument of production, the word abstinence.”	"Ich", sagte er feierlich, "ich ersetze das Wort Kapital, als Produktionsinstrument betrachtet, durch das Wort Abstinenz (Enthaltung)."	ch24_clean.en-ch24_clean.de
An unparalleled sample this, of the discoveries of vulgar economy!	Ein unübertroffenes Muster dies von den "Entdeckungen" der Vulgärökonomie!	ch24_clean.en-ch24_clean.de
It substitutes for an economic category, a sycophantic phrase – voilà tout. [that’s all] “When the savage,” says Senior, “makes bows, he exercises an industry, but he does not practise abstinence.”	Sie ersetzt eine ökonomische Kategorie durch eine sykophantische Phrase. Voila tout. <Das ist alles.> "Wenn der Wilde", doziert Senior, "Bogen fabriziert, so übt er eine Industrie aus, aber er praktiziert nicht die Abstinenz."	ch24_clean.en-ch24_clean.de
This explains how and why, in the earlier states of society, the implements of labour were fabricated without abstinence on the part of the capitalist.	Dies erklärt uns, wie und warum in früheren Gesellschaftszuständen "ohne die Abstinenz" des Kapitalisten Arbeitsmittel fabriziert wurden.	ch24_clean.en-ch24_clean.de
“The more society progresses, the more abstinence is demanded,” Namely, from those who ply the industry of appropriating the fruits of others’ industry.	"Je mehr die Gesellschaft fortschreitet, um so mehr Abstinenz erfordert sie" , nämlich von denen, welche die Industrie ausüben, sich die fremde Industrie und ihr Produkt anzueignen.	ch24_clean.en-ch24_clean.de
All the conditions for carrying on the labour process are suddenly converted into so many acts of abstinence on the part of the capitalist.	Alle Bedingungen des Arbeitsprozesses verwandeln sich von nun in ebenso viele Abstinenzpraktiken des Kapitalisten.	ch24_clean.en-ch24_clean.de
If the corn is not all eaten, but part of it also sown – abstinence of the capitalist.	Daß Korn nicht nur gegessen, sondern auch gesät wird, Abstinenz des Kapitalisten!	ch24_clean.en-ch24_clean.de
If the wine gets time to mature – abstinence of the capitalist The capitalist robs his own self, whenever he “lends (!) the instruments of production to the labourer,” that is, whenever by incorporating labour-power with them, he uses them to extract surplus-value out of that labour-power, instead of eating them up, steam-engines, cotton, railways, manure, horses, and all; or as the vulgar economist childishly puts it, instead of dissipating “their value” in luxuries and other articles of consumption.	Daß der Wein die Zeit erhält, auszugären, Abstinenz des Kapitalisten! Der Kapitalist beraubt seinen eignen Adam, wenn er die "Produk- tionsinstrumente dem Arbeiter leiht" (! ), alias sie durch Einverleibung der Arbeitskraft als Kapital verwertet, statt Dampfmaschinen, Baumwolle, Eisenbahnen, Dünger, Zugpferde usf. aufzuessen oder, wie der Vulgärökonom sich das kindlich vorstellt, "ihren Wert" in Luxus und andren Konsumtionsmitteln zu verprassen.	ch24_clean.en-ch24_clean.de
How the capitalists as a class are to perform that feat, is a secret that vulgar economy has hitherto obstinately refused to divulge.	Wie die Kapitalistenklasse das anstellen soll, ist ein von der Vulgärökonomie bisher hartnäckig bewahrtes Geheimnis.	ch24_clean.en-ch24_clean.de
Enough, that the world still jogs on, solely through the self-chastisement of this modern penitent of Vishnu, the capitalist.	Genug, die Welt lebt nur noch von der Selbstkasteiung dieses modernen Büßers des Wischnu, des Kapitalisten.	ch24_clean.en-ch24_clean.de
Not only accumulation, but the simple “conservation of a capital requires a constant effort to resist the temptation of consuming it.”	Nicht nur die Akkumulation, die einfache "Erhaltung eines Kapitals erheischt beständige Kraftanstrengung, um der Versuchung zu widerstehn, es aufzuessen".	ch24_clean.en-ch24_clean.de
The simple dictates of humanity therefore plainly enjoin the release of the capitalist from this martyrdom and temptation, in the same way that the Georgian slave-owner was lately delivered, by the abolition of slavery, from the painful dilemma, whether to squander the surplus-product, lashed out of his niggers, entirely in champagne, or whether to reconvert a part of it into more niggers and more land.	Die einfache Humanität gebeut also offenbar, den Kapitalisten von Martyrtum und Versuchung zu erlösen, in derselben Weise, wie der georgische Sklavenhalter jüngst durch Abschaffung der Sklaverei von dem schmerzlichen Dilemma erlöst ward, ob das dem Negersklaven ausgepeitschte Mehrprodukt ganz in Champagner zu verjubeln oder auch teilweis in mehr Neger und mehr Land rückzuverwandeln.	ch24_clean.en-ch24_clean.de
In economic forms of society of the most different kinds, there occurs, not only simple reproduction, but, in varying degrees, reproduction on a progressively increasing scale.	In den verschiedensten ökonomischen Gesellschaftsformationen findet nicht nur einfache Reproduktion statt, sondern, obgleich auf verschiednem Maßstab, Reproduktion auf erweiterter Stufenleiter.	ch24_clean.en-ch24_clean.de
By degrees more is produced and more consumed, and consequently more products have to be converted into means of production.	Es wird progressiv mehr produziert und mehr konsumiert, also auch mehr Produkt in Produktionsmittel verwandelt.	ch24_clean.en-ch24_clean.de
This process, however, does not present itself as accumulation of capital, nor as the function of a capitalist, so long as the labourer’s means of production, and with them, his product and means of subsistence, do not confront him in the shape of capital.	Dieser Prozeß erscheint aber nicht als Akkumulation von Kapital und daher auch nicht als Funktion des Kapitalisten, solange dem Arbeiter seine Produktionsmittel, daher auch sein Produkt und seine Lebensmittel, noch nicht in der Form von Kapital gegenüberstehn.	ch24_clean.en-ch24_clean.de
Richard Jones, who died a few years ago, and was the successor of Malthus in the chair of Political Economy at Haileybury College, discusses this point well in the light of two important facts.	Der vor einigen Jahren verstorbene Richard Jones, Nachfolger von Malthus auf dem Lehrstuhl der politischen Ökonomie am ostindischen College zu Haileybury, erörtert dies gut an zwei großen Tatsachen.	ch24_clean.en-ch24_clean.de
Since the great mass of the Hindu population are peasants cultivating their land themselves, their products, their instruments of labour and means of subsistence never take “the shape of a fund saved from revenue, which fund has, therefore, gone through a previous process of accumulation.”	Da der zahlreichste Teil des indischen Volks selbstwirtschaftende Bauern, existiert ihr Produkt, ihre Arbeits- und Lebensmittel, auch nie "in der Form (in the shape) eines Fonds, der aus fremder Revenue erspart wird (saved from Revenue) und daher einen vorläufigen Prozeß der Akkumulation (a previous process of accumulation) durchlaufen hat" .	ch24_clean.en-ch24_clean.de
On the other hand, the non-agricultural labourers in those provinces where the English rule has least disturbed the old system, are directly employed by the magnates, to whom a portion of the agricultural surplus-product is rendered in the shape of tribute or rent.	Andrerseits werden die nicht-agrikolen Arbeiter in den Provinzen, wo die englische Herrschaft das alte System am wenigsten aufgelöst hat, direkt von den Großen beschäftigt, denen eine Portion des ländlichen Mehrprodukts als Tribut oder Grundrente zufließt.	ch24_clean.en-ch24_clean.de
One portion of this product is consumed by the magnates in kind, another is converted, for their use, by the labourers, into articles of luxury and such like things, while the rest forms the wages of the labourers, who own their implements of labour.	Ein Teil dieses Produkts wird in Naturalform von den Großen verzehrt, ein andrer Teil für sie von den Arbeitern in Luxus- und sonstige Konsumtionsmittel verwandelt, während der Rest den Lohn der Arbeiter bildet, die Eigentümer ihrer Arbeitsinstrumente sind.	ch24_clean.en-ch24_clean.de
Here, production and reproduction on a progressively increasing scale, go on their way without any intervention from that queer saint, that knight of the woeful countenance, the capitalist “abstainer.”	Produktion und Reproduktion auf erweiterter Stufenleiter gehn hier ihren Gang ohne alle Dazwischenkunft jenes wunderlichen Heiligen, jenes Ritters von der traurigen Gestalt, des "entsagenden" Kapitalisten.	ch24_clean.en-ch24_clean.de
Section 4: Circumstances that, Independently of the Proportional Division of Surplus-Value into Capital and Revenue, Determine the Amount of Accumulation.		ch24_clean.en-ch24_clean.de
Degree of Exploitation of Labour-Power.		ch24_clean.en-ch24_clean.de
Productivity of Labour.		ch24_clean.en-ch24_clean.de
Growing Difference in Amount Between Capital Employed and Capital Consumed. Magnitude of Capital Advanced The proportion in which surplus-value breaks up into capital and revenue being given, the magnitude of the capital accumulated clearly depends on the absolute magnitude of the surplus-value.	4. Umstände, welche unabhängig von der proportionellen Teilung des Mehrwerts in Kapital und Revenue den Umfang der Akkumulation bestimmen: Exploitationsgrad der Arbeitskraft - Produktivkraft der Arbeit - Wachsende Differenz zwischen angewandtem und konsumiertem Kapital - Größe des vorgeschoßnen Kapitals Das Verhältnis, wonach der Mehrwert sich in Kapital und Revenue spaltet, als gegeben vorausgesetzt, richtet sich die Größe des akkumulierten Kapitals offenbar nach der absoluten Größe des Mehrwerts.	ch24_clean.en-ch24_clean.de
Suppose that 80 per cent. were capitalised and 20 per cent. eaten up, the accumulated capital will be £2, or £200, according as the total surplus-value has amounted to £3, or £500.	Angenommen 80% würden kapitalisiert und 20% aufgegessen, so wird das akkumulierte Kapital 2.400 Pfd.St. oder 1.200 Pfd.St. betragen, je nachdem der Gesamt- Mehrwert sich auf 3.000 oder auf 1.500 Pfd.St. belaufen hat.	ch24_clean.en-ch24_clean.de
Hence all the circumstances that determine the mass of surplus-value operate to determine the magnitude of the accumulation.	Demnach wirken bei Bestimmung der Größe der Akkumulation alle die Umstände mit, die die Masse des Mehrwerts bestimmen.	ch24_clean.en-ch24_clean.de
We sum them up once again, but only in so far as they afford new points of view in regard to accumulation.	Wir fassen sie hier nochmals zusammen, aber nur insofern sie mit Bezug auf die Akkumulation neue Gesichtspunkte bieten.	ch24_clean.en-ch24_clean.de
It will be remembered that the rate of surplus-value depends, in the first place, on the degree of exploitation of labour-power.	Man erinnert sich, daß die Rate des Mehrwerts in erster Instanz abhängt vom Exploitationsgrad der Arbeitskraft.	ch24_clean.en-ch24_clean.de
Political Economy values this fact so highly, that it occasionally identifies the acceleration of accumulation due to increased productiveness of labour, with its acceleration due to increased exploitation of the labourer.	Die politische Ökonomie würdigt diese Rolle so sehr, daß sie gelegentlich die Beschleunigung der Akkumulation durch erhöhte Produktionskraft der Arbeit identifiziert mit ihrer Beschleunigung durch erhöhte Exploitation des Arbeiters.	ch24_clean.en-ch24_clean.de
In the chapters on the production of surplus-value it was constantly presupposed that wages are at least equal to the value of labour-power.	In den Abschnitten über die Produktion des Mehrwerts ward beständig unterstellt, daß der Arbeitslohn wenigstens gleich dem Wert der Arbeitskraft ist.	ch24_clean.en-ch24_clean.de
Forcible reduction of wages below this value plays, however, in practice too important a part, for us not to pause upon it for a moment.	Die gewaltsame Herabsetzung des Arbeitslohns unter diesen Wert spielt jedoch in der praktischen Bewegung eine zu wichtige Rolle, um uns nicht einen Augenblick dabei aufzuhalten.	ch24_clean.en-ch24_clean.de
It, in fact, transforms, within certain limits, the labourer’s necessary consumption fund into a fund for the accumulation of capital.	Sie verwandelt faktisch, innerhalb gewisser Grenzen, den notwendigen Konsumtionsfonds des Arbeiters in einen Akkumulationsfonds von Kapital.	ch24_clean.en-ch24_clean.de
“Wages,” says John Stuart Mill, “have no productive power; they are the price of a productive power. Wages do not contribute, along with labour, to the production of commodities, no more than the price of tools contributes along with the tools themselves.	"Arbeitslöhne", sagt J. St. Mill, "haben keine Produktivkraft; sie sind der Preis einer Produktivkraft; Arbeitslöhne tragen nicht, neben der Arbeit selbst, zur Warenproduktion bei, so wenig als der Preis der Maschinerie selbst.	ch24_clean.en-ch24_clean.de
If labour could be had without purchase, wages might be dispensed with.”	Könnte Arbeit ohne Kauf gehabt werden, so wären Arbeitslöhne überflüssig."	ch24_clean.en-ch24_clean.de
But if the labourers could live on air they could not be bought at any price.	Wenn aber die Arbeiter von der Luft leben könnten, so wären sie auch um keinen Preis zu kaufen.	ch24_clean.en-ch24_clean.de
The zero of their cost is therefore a limit in a mathematical sense, always beyond reach, although we can always approximate more and more nearly to it.	Ihr Nichtkosten ist also eine Grenze im mathematischen Sinn, stets unerreichbar, obgleich stets annäherbar.	ch24_clean.en-ch24_clean.de
The constant tendency of capital is to force the cost of labour back towards this zero.	Es ist die beständige Tendenz des Kapitals, sie auf diesen nihilistischen Standpunkt herabzudrücken.	ch24_clean.en-ch24_clean.de
A writer of the 18th century, often quoted already, the author of the “Essay on Trade and Commerce,” only betrays the innermost secret soul of English capitalism, when he declares the historic mission of England to be the forcing down of English wages to the level of the French and the Dutch.	Ein oft von mir zitierter Schriftsteller des 18. Jahrhunderts, der Verfasser des "Essay on Trade and Commerce", verrät nur das innerste Seelengeheimnis des englischen Kapitals, wenn er es für die historische Lebensaufgabe Englands erklärt, den englischen Arbeitslohn auf das französische und holländische Niveau herabzudrücken.	ch24_clean.en-ch24_clean.de
With other things he says naively: “But if our poor” (technical term for labourers) “will live luxuriously ... then labour must, of course, be dear ...	Er sagt u.a. naiv: "Wenn aber unsre Armen" (Kunstausdruck für Arbeiter) "luxuriös leben wollen ... muß ihre Arbeit natürlich teuer sein ...	ch24_clean.en-ch24_clean.de
When it is considered what luxuries the manufacturing populace consume, such as brandy, gin, tea, sugar, foreign fruit, strong beer, printed linens, snuff, tobacco, &c.”	Man betrachte nur die haarsträubende Masse von Überflüssigkeiten (heap of superfluities), die unsre Manufakturarbeiter verzehren, als da sind Branntwein, Gin, Tee, Zucker, fremde Früchte, starkes Bier, gedruckte Leinwand, Schnupf- und Rauchtabak etc."	ch24_clean.en-ch24_clean.de
He quotes the work of a Northamptonshire manufacturer, who, with eyes squinting heavenward moans: “Labour is one-third cheaper in France than in England; for their poor work hard, and fare hard, as to their food and clothing. Their chief diet is bread, fruit, herbs, roots, and dried fish; for they very seldom eat flesh; and when wheat is dear, they eat very little bread.”	Er zitiert die Schrift eines Fabrikanten von Northamptonshire, der mit himmelwärts schielendem Blick jammert: "Arbeit ist ein ganzes Dritteil wohlfeiler in Frankreich als in England: denn die französischen Armen arbeiten hart und fahren hart an Nahrung und Kleidung, und ihr Hauptkonsum sind Brot, Früchte, Kräuter, Wurzeln und getrockneter Fisch; denn sie essen sehr selten Fleisch, und wenn der Weizen teuer ist, sehr wenig Brot."	ch24_clean.en-ch24_clean.de
“To which may be added,” our essayist goes on, “that their drink is either water or other small liquors, so that they spend very little money....	"Wozu", fährt der Essayist fort, "wozu noch kommt, daß ihr Getränk aus Wasser besteht oder ähnlichen schwachen Likören, so daß sie in der Tat erstaunlich wenig Geld ausgeben ...	ch24_clean.en-ch24_clean.de
These things are very difficult to be brought about; but they are not impracticable, since they have been effected both in France and in Holland.”	Ein derartiger Zustand der Dinge ist sicherlich schwer herbeizuführen aber er ist nicht unerreichbar, wie seine Existenz sowohl in Frankreich als Holland schlagend beweist."	ch24_clean.en-ch24_clean.de
Twenty years later, an American humbug, the baronised Yankee, Benjamin Thompson (alias Count Rumford) followed the same line of philanthropy to the great satisfaction of God and man.	Zwei Jahrzehnte später verfolgte ein amerikanischer Humbug, der baronisierte Yankee Benjamin Thompson (alias Graf Rumford), dieselbe Philanthropielinie mit großem Wohlgefallen vor Gott und den Menschen.	ch24_clean.en-ch24_clean.de
His “Essays” are a cookery book with receipts of all kinds for replacing by some succedaneum the ordinary dear food of the labourer.	Seine "Essays" sind ein Kochbuch mit Rezepten aller Art, um Surrogate an die Stelle der teuren Normalspeisen des Arbeiters zu setzen.	ch24_clean.en-ch24_clean.de
The following is a particularly successful receipt of this wonderful philosopher: “ lbs. of barleymeal, 7½d. ; 5 lbs. of Indian corn, 6¼d. ; 3d. worth of red herring, 1d. salt, 1d. vinegar, 2d. pepper and sweet herbs, in all 20¾. ; make a soup for 64 men, and at the medium price of barley and of Indian corn ... this soup may be provided at ¼d., the portion of 20 ounces.”	Ein besonders gelungnes Rezept dieses wunderlichen "Philosophen" ist folgendes: "Fünf Pfund Gerste, fünf Pfund Mais, für 3 d. Heringe, 1 d. Salz, 1 d. Essig, 2 d. Pfeffer und Kräuter - Summa von 20 3/4 d. gibt eine Suppe für 64 Menschen, ja mit den Durchschnittspreisen von Korn kann die Kost auf 1/4 d. per Kopf" (noch nicht 3 Pfennige) "herabgedrückt werden."	ch24_clean.en-ch24_clean.de
With the advance of capitalistic production, the adulteration of food rendered Thompson’s ideal superfluous.	Mit dem Fortschritt der kapitalistischen Produktion hat die Warenfälschung Thompsons Ideale überflüssig gemacht.	ch24_clean.en-ch24_clean.de
At the end of the 18th and during the first ten years of the 19th century, the English farmers and landlords enforced the absolute minimum of wage, by paying the agricultural labourers less than the minimum in the form of wages, and the remainder in the shape of parochial relief.	Ende des 18. und während der ersten Dezennien des 19. Jahrhunderts erzwangen die englischen Pächter und Landlords das absolute Minimalsalair, indem sie den Ackerbautaglöhnern weniger als das Minimum in der Form des Arbeitslohns, den Rest aber in der Form von Pfarreiunterstützung auszahlten.	ch24_clean.en-ch24_clean.de
An example of the waggish way in which the English Dogberries acted in their “legal” fixing of a wages tariff: “The squires of Norfolk had dined, says Mr. Burke, when they fixed the rate of wages; the squires of Berks evidently thought the labourers ought not to do so, when they fixed the rate of wages at Speenhamland, 1795....	Ein Beispiel der Possenreißerei, womit die englischen Dogberries in ihrer "legalen" Festsetzung des Lohntarifs verfuhren: "Als die Squires die Arbeitslöhne für Speenhamland 1795 festsetzten, hatten sie zu Mittag gespeist, dachten aber offenbar, daß die Arbeiter nicht desgleichen nötig hatten ...	ch24_clean.en-ch24_clean.de
There they decide that ‘income (weekly) should be 3s. for a man,’ when the gallon or half-peck loaf of 8 lbs. oz. is at 1s., and increase regularly till bread is 1s.	Sie entschieden, der Wochenlohn solle 3 sh. per Mann sein, wenn der Laib Brot von 8 Pfund 11 Unzen auf 1 sh. stünde, und er solle regelmäßig wachsen, bis der Laib 1 sh.	ch24_clean.en-ch24_clean.de
5d. ; when it is above that sum decrease regularly till it be at 2s., and then his food should be 1/ th less.” 43 Before the Committee of Inquiry of the House of Lords, 1814, a certain A. Bennett, a large farmer, magistrate, poor-law guardian, and wage-regulator, was asked: “Has any proportion of the value of daily labour been made up to the labourers out of the poors’ rate?”	5 d. koste. Sobald er über diesen Preis stiege, sollte der Lohn proportionell abnehmen, bis der Preis des Laibes 2 sh. erreicht hätte; und dann sollte die Nahrung des Mannes 1/5 weniger als vorher sein." Vor dem Untersuchungskomitee des House of Lords, 1814, wird ein gewisser A. Bennett, großer Pächter, Magistrat, Armenhausverwalter und Lohnregulator, gefragt: "Wird irgendeine Proportion zwischen dem Wert der Tagesarbeit und der Pfarreiunterstützung der Arbeiter beobachtet?" Antwort: "Ja.	ch24_clean.en-ch24_clean.de
Answer: “Yes, it has; the weekly income of every family is made up to the gallon loaf ( lbs. oz. ), and 3d. per head!...	Das wöchentliche Einkommen jeder Familie wird über ihren Nominallohn hinaus voll gemacht bis zum Gallonlaib Brot (8 Pf.	ch24_clean.en-ch24_clean.de
The gallon loaf per week is what we suppose sufficient for the maintenance of every person in the family for the week; and the 3d. is for clothes, and if the parish think proper to find clothes; the 3d. is deducted.	11 Unzen) und 3 d. per Kopf ... Wir unterstellen den Gallonlaib hinreichend für die Erhaltung jeder Person in der Familie während der Woche; und die 3 d. sind für Kleider; und wenn es der Pfarrei beliebt, die Kleider selbst zu stellen, werden die 3 d. abgezogen.	ch24_clean.en-ch24_clean.de
This practice goes through all the western part of Wiltshire, and, I believe, throughout the country.”	Diese Praxis herrscht nicht nur im ganzen Westen von Wiltshire, sondern, wie ich glaube, im ganzen Land."	ch24_clean.en-ch24_clean.de
“For years,” exclaims a bourgeois author of that time, “they (the farmers) have degraded a respectable class of their countrymen, by forcing them to have recourse to the workhouse ... the farmer, while increasing his own gains, has prevented any accumulation on the part of his labouring dependents.”	"So", ruft ein Bourgeoisschriftsteller jener Zeit, "haben die Pächter jahrelang eine respektable Klasse ihrer Landsleute degradiert, indem sie dieselben zwangen, zum Workhouse ihre Zuflucht zu nehmen ... Der Pächter hat seine eignen Gewinne vermehrt, indem er selbst die Akkumulation des unentbehrlichsten Konsumfonds auf Seite der Arbeiter verhinderte."	ch24_clean.en-ch24_clean.de
The part played in our days by the direct robbery from the labourer’s necessary consumption fund in the formation of surplus-value, and, therefore, of the accumulation fund of capital, the so-called domestic industry has served to show.	Welche Rolle heutzutag der direkte Raub am notwendigen Konsumtionsfonds des Arbeiters in der Bildung des Mehrwerts und daher des Akkumulationsfonds des Kapitals spielt, hat beispielsweis die sog. Hausarbeit (s. Kap.	ch24_clean.en-ch24_clean.de
(Ch. xv., sect. 8, c.)	XV, 8, c.) gezeigt.	ch24_clean.en-ch24_clean.de
Further facts on this subject will be given later.	Weitere Tatsachen im Verlauf dieses Abschnitts.	ch24_clean.en-ch24_clean.de
Although in all branches of industry that part of the constant capital consisting of instruments of labour must be sufficient for a certain number of labourers (determined by the magnitude of the undertaking), it by no means always necessarily increases in the same proportion as the quantity of labour employed.	Obschon in allen Industriezweigen der aus Arbeitsmitteln bestehende Teil des konstanten Kapitals genügen muß für eine gewisse, durch die Größe der Anlage bestimmte Anzahl Arbeiter, so braucht er doch keineswegs immer in demselben Verhältnis zu wachsen wie die beschäftigte Arbeitsmenge.	ch24_clean.en-ch24_clean.de
In a factory, suppose that 100 labourers working 8 hours a day yield 800 working-hours.	In einer Fabrikanlage mögen hundert Arbeiter bei acht- stündiger Arbeit 800 Arbeitsstunden liefern.	ch24_clean.en-ch24_clean.de
If the capitalist wishes to raise this sum by one half, he can employ 50 more workers; but then he must also advance more capital, not merely for wages, but for instruments of labour.	Will der Kapitalist diese Summe um die Hälfte steigern, so kann er 50 neue Arbeiter anstellen; dann muß er aber auch ein neues Kapital vorschießen, nicht nur für Löhne, sondern auch für Arbeitsmittel.	ch24_clean.en-ch24_clean.de
But he might also let the 100 labourers work 12 hours instead of 8, and then the instruments of labour already to hand would be enough. These would then simply be more rapidly consumed.	Er kann aber auch die alten 100 Arbeiter 12 Stunden arbeiten lassen statt 8, und dann genügen die schon vorhandnen Arbeitsmittel, die sich dann bloß rascher verschleißen.	ch24_clean.en-ch24_clean.de
Thus additional labour, begotten of the greater tension of labour-power, can augment surplus-product and surplus-value (i.e., the subject-matter of accumulation), without corresponding augmentation in the constant part of capital.	So kann durch höhere Anspannung der Arbeitskraft erzeugte, zusätzliche Arbeit das Mehrprodukt und den Mehrwert, die Substanz der Akkumulation, steigern ohne verhältnismäßige Steigerung des konstanten Kapitalteils.	ch24_clean.en-ch24_clean.de
In the extractive industries, mines, &c., the raw materials form no part of the capital advanced.	In der extraktiven Industrie, den Bergwerken z.B., bilden die Rohstoffe keinen Bestandteil des Kapitalvorschusses.	ch24_clean.en-ch24_clean.de
The subject of labour is in this case not a product of previous labour, but is furnished by Nature gratis, as in the case of metals, minerals, coal, stone, &c.	Der Arbeitsgegenstand ist hier nicht Produkt vorhergegangner Arbeit, sondern von der Natur gratis geschenkt.	ch24_clean.en-ch24_clean.de
In these cases the constant capital consists almost exclusively of instruments of labour, which can very well absorb an increased quantity of labour (day and night shifts of labourers, e.g.).	So Metallerz, Minerale, Steinkohlen, Steine etc. Hier besteht das konstante Kapital fast ausschließlich in Arbeitsmitteln, die ein vermehrtes Arbeitsquantum sehr gut vertragen können (Tag- und Nachtschicht von Arbeitern z.B.).	ch24_clean.en-ch24_clean.de
All other things being equal, the mass and value of the product will rise in direct proportion to the labour expended.	Alle andern Umstände gleichgesetzt, wird aber Masse und Wert des Produkts steigen in direktem Verhältnis der angewandten Arbeit.	ch24_clean.en-ch24_clean.de
As on the first day of production, the original produce-formers, now turned into the creators of the material elements of capital – man and Nature – still work together.	Wie am ersten Tag der Produktion, gehn hier die ursprünglichen Produktbildner, daher auch die Bildner der stofflichen Elemente des Kapitals, Mensch und Natur, zusammen.	ch24_clean.en-ch24_clean.de
Thanks to the elasticity of labour-power, the domain of accumulation has extended without any previous enlargement of constant capital.	Dank der Elastizität der Arbeitskraft hat sich das Gebiet der Akkumulation erweitert ohne vorherige Vergrößerung des konstanten Kapitals.	ch24_clean.en-ch24_clean.de
In agriculture the land under cultivation cannot be increased without the advance of more seed and manure.	In der Agrikultur kann man das bebaute Land nicht ausdehnen ohne Vorschuß von zusätzlichem Samen und Dünger.	ch24_clean.en-ch24_clean.de
But this advance once made, the purely mechanical working of the soil itself produces a marvellous effect on the amount of the product.	Aber dieser Vorschuß einmal gemacht, übt selbst die rein mechanische Bearbeitung des Bodens eine wundertätige Wirkung auf die Massenhaftigkeit des Produkts.	ch24_clean.en-ch24_clean.de
A greater quantity of labour, done by the same number of labourers as before, thus increases the fertility, without requiring any new advance in the instruments of labour.	Eine größere Arbeitsmenge, geleistet von der bisherigen Anzahl Arbeiter, steigert so die Fruchtbarkeit, ohne neuen Vorschuß an Arbeitsmitteln zu erfordern.	ch24_clean.en-ch24_clean.de
It is once again the direct action of man on Nature which becomes an immediate source of greater accumulation, without the intervention of any new capital.	Es ist wieder direkte Wirkung des Menschen auf die Natur, welche zur unmittelbaren Quelle gesteigerter Akkumulation wird, ohne Dazwischenkunft eines neuen Kapitals.	ch24_clean.en-ch24_clean.de
Finally, in what is called manufacturing industry, every additional expenditure of labour presupposes a corresponding additional expenditure of raw materials, but not necessarily of instruments of labour.	Endlich in der eigentlichen Industrie setzt jede zusätzliche Ausgabe an Arbeit eine entsprechende Zusatzausgabe an Rohstoffen voraus, aber nicht notwendig auch an Arbeitsmitteln.	ch24_clean.en-ch24_clean.de
And as extractive industry and agriculture supply manufacturing industry with its raw materials and those of its instruments of labour, the additional product the former have created without additional advance of capital, tells also in favour of the latter.	Und da die extraktive Industrie und Agrikultur der fabrizierenden Industrie ihre eignen Rohstoffe und die ihrer Arbeitsmittel liefern, kommt dieser auch der Produktenzuschuß zugute, den jene ohne zusätzlichen Kapitalzuschuß erzeugt haben.	ch24_clean.en-ch24_clean.de
General result: by incorporating with itself the two primary creators of wealth, labour-power and the land, capital acquires a power of expansion that permits it to augment the elements of its accumulation beyond the limits apparently fixed by its own magnitude, or by the value and the mass of the means of production, already produced, in which it has its being.	Allgemeines Resultat: Indem das Kapital sich die beiden Urbildner des Reichtums, Arbeitskraft und Erde, einverleibt, erwirbt es eine Expansions- -kraft, die ihm erlaubt, die Elemente seiner Akkumulation auszudehnen jenseits der scheinbar durch seine eigne Größe gesteckten Grenzen, gesteckt durch den Wert und die Masse der bereits produzierten Produktionsmittel, in denen es sein Dasein hat.	ch24_clean.en-ch24_clean.de
Another important factor in the accumulation of capital is the degree of productivity of social labour.	Ein andrer wichtiger Faktor in der Akkumulation des Kapitals ist der Produktivitätsgrad der gesellschaftlichen Arbeit.	ch24_clean.en-ch24_clean.de
With the productive power of labour increases the mass of the products, in which a certain value, and, therefore, a surplus-value of a given magnitude, is embodied.	Mit der Produktivkraft der Arbeit wächst die Produktenmasse, worin sich ein bestimmter Wert, also auch Mehrwert von gegebner Größe, darstellt.	ch24_clean.en-ch24_clean.de
The rate of surplus-value remaining the same or even falling, so long as it only falls more slowly, than the productive power of labour rises, the mass of the surplus-product increases.	Bei gleichbleibender und selbst bei fallender Rate des Mehrwerts, sofern sie nur langsamer fällt, als die Produktivkraft der Arbeit steigt, wächst die Masse des Mehrprodukts.	ch24_clean.en-ch24_clean.de
The division of this product into revenue and additional capital remaining the same, the consumption of the capitalist may, therefore, increase without any decrease in the fund of accumulation.	Bei gleichbleibender Teilung desselben in Revenue und Zusatzkapital kann daher die Konsumtion des Kapitalisten wachsen ohne Abnahme des Akkumulationsfonds.	ch24_clean.en-ch24_clean.de
The relative magnitude of the accumulation fund may even increase at the expense of the consumption fund, whilst the cheapening of commodities places at the disposal of the capitalist as many means of enjoyment as formerly, or even more than formerly.	Die proportionelle Größe des Akkumulationsfonds kann selbst auf Kosten des Konsumtionsfonds wachsen, während die Verwohlfeilerung der Waren dem Kapitalisten ebenso viele oder mehr Genußmittel als vorher zur Verfügung stellt.	ch24_clean.en-ch24_clean.de
But hand-in-hand with the increasing productivity of labour, goes, as we have seen, the cheapening of the labourer, therefore a higher rate of surplus-value, even when the real wages are rising.	Aber mit der wachsenden Produktivität der Arbeit geht, wie man gesehn, die Verwohlfeilerung des Arbeiters, also wachsende Rate des Mehrwerts, Hand in Hand, selbst wenn der reelle Arbeitslohn steigt.	ch24_clean.en-ch24_clean.de
The latter never rise proportionally to the productive power of labour.	Er steigt nie verhältnismäßig mit der Produktivität der Arbeit.	ch24_clean.en-ch24_clean.de
The same value in variable capital therefore sets in movement more labour-power, and, therefore, more labour.	Derselbe variable Kapitalwert setzt also mehr Arbeitskraft und daher mehr Arbeit in Bewegung.	ch24_clean.en-ch24_clean.de
The same value in constant capital is embodied in more means of production, i.e., in more instruments of labour, materials of labour and auxiliary materials; it therefore also supplies more elements for the production both of use value and of value, and with these more absorbers of labour.	Derselbe konstante Kapitalwert stellt sich in mehr Produktionsmitteln, d.h. mehr Arbeitsmitteln, Arbeitsmaterial und Hilfsstoffen dar, liefert also sowohl mehr Produktbildner als Wertbildner oder Arbeitseinsauger.	ch24_clean.en-ch24_clean.de
The value of the additional capital, therefore, remaining the same or even diminishing, accelerated accumulation still takes place.	Bei gleichbleibendem und selbst abnehmendem Wert des Zusatzkapitals findet daher beschleunigte Akkumulation statt.	ch24_clean.en-ch24_clean.de
Not only does the scale of reproduction materially extend, but the production of surplus-value increases more rapidly than the value of the additional capital.	Nicht nur erweitert sich die Stufenleiter der Reproduktion stofflich, sondern die Produktion des Mehrwerts wächst schneller als der Wert des Zusatzkapitals.	ch24_clean.en-ch24_clean.de
The development of the productive power of labour reacts also on the original capital already engaged in the process of production.	Die Entwicklung der Produktivkraft der Arbeit reagiert auch auf das Originalkapital oder das bereits im Produktionsprozeß befindliche Kapital.	ch24_clean.en-ch24_clean.de
A part of the functioning constant capital consists of instruments of labour, such as machinery, &c., which are not consumed, and therefore not reproduced, or replaced by new ones of the same kind, until after long periods of time.	Ein Teil des funktionierenden konstanten Kapitals besteht aus Arbeitsmitteln, wie Maschinerie usw., die nur in längeren Perioden konsumiert und daher reproduziert oder durch neue Exemplare derselben Art ersetzt werden.	ch24_clean.en-ch24_clean.de
But every year a part of these instruments of labour perishes or reaches the limit of its productive function.	Aber jedes Jahr stirbt ein Teil dieser Arbeitsmittel ab oder erreicht das Endziel seiner produktiven Funktion.	ch24_clean.en-ch24_clean.de
It reaches, therefore, in that year, the time for its periodical reproduction, for its replacement by new ones of the same kind. If the productiveness of labour has, during the using up of these instruments of labour, increased (and it develops continually with the uninterrupted advance of science and technology), more efficient and (considering their increased efficiency), cheaper machines, tools, apparatus, &c., replace the old.	Er befindet sich daher jedes Jahr im Stadium seiner periodischen Reproduktion oder seines Ersatzes durch neue Exemplare derselben Art. Hat die Produktivkraft der Arbeit sich in der Geburtsstätte dieser Arbeitsmittel erweitert, und sie entwickelt sich fortwährend mit dem ununterbrochenen Fluß der Wissen- schaft und der Technik, so tritt wirkungsvollere und, ihren Leistungsumfang betrachtet, wohlfeilere Maschine, Werkzeug, Apparat usw. an die Stelle der alten.	ch24_clean.en-ch24_clean.de
The old capital is reproduced in a more productive form, apart from the constant detail improvements in the instruments of labour already in use.	Das alte Kapital wird in einer produktiveren Form reproduziert, abgesehn von der fortwährenden Detailveränderung an den vorhandnen Arbeitsmitteln.	ch24_clean.en-ch24_clean.de
The other part of the constant capital, raw material and auxiliary substances, is constantly reproduced in less than a year; those produced by agriculture, for the most part annually.	Der andre Teil des konstanten Kapitals, Rohmaterial und Hilfsstoffe, wird fortwährend innerhalb des Jahrs, der der Agrikultur entstammende meist jährlich reproduziert.	ch24_clean.en-ch24_clean.de
Every introduction of improved methods, therefore, works almost simultaneously on the new capital and on that already in action.	Jede Einführung beßrer Methoden usw. wirkt hier also fast gleichzeitig auf Zuschußkapital und bereits in Funktion begriffnes Kapital.	ch24_clean.en-ch24_clean.de
Every advance in Chemistry not only multiplies the number of useful materials and the useful applications of those already known, thus extending with the growth of capital its sphere of investment.	Jeder Fortschritt der Chemie vermannigfacht nicht nur die Zahl der nützlichen Stoffe und die Nutzanwendungen der schon bekannten, und dehnt daher mit dem Wachstum des Kapitals seine Anlagesphären aus.	ch24_clean.en-ch24_clean.de
It teaches at the same time how to throw the excrements of the processes of production and consumption back again into the circle of the process of reproduction, and thus, without any previous outlay of capital, creates new matter for capital.	Er lehrt zugleich die Exkremente des Produktions- und Konsumtionsprozesses in den Kreislauf des Reproduktionsprozesses zurückschleudern, schafft also ohne vorherige Kapitalauslage neuen Kapitalstoff.	ch24_clean.en-ch24_clean.de
Like the increased exploitation of natural wealth by the mere increase in the tension of labour-power, science and technology give capital a power of expansion independent of the given magnitude of the capital actually functioning.	Gleich vermehrter Ausbeutung des Naturreichtums durch bloß höhere Spannung der Arbeitskraft, bilden Wissenschaft und Technik eine von der gegebnen Größe des funktionierenden Kapitals unabhängige Potenz seiner Expansion.	ch24_clean.en-ch24_clean.de
They react at the same time on that part of the original capital which has entered upon its stage of renewal.	Sie reagiert zugleich auf den in sein Erneuerungsstadium eingetretenen Teil des Originalkapitals.	ch24_clean.en-ch24_clean.de
This, in passing into its new shape, incorporates gratis the social advance made while its old shape was being used up.	In seine neue Form einverleibt es gratis den hinter dem Rücken seiner alten Form vollzogenen gesellschaftlichen Fortschritt.	ch24_clean.en-ch24_clean.de
Of course, this development of productive power is accompanied by a partial depreciation of functioning capital.	Allerdings ist diese Entwicklung der Produktivkraft zugleich begleitet von teilweiser Depreziation funktionierender Kapitale.	ch24_clean.en-ch24_clean.de
So far as this depreciation makes itself acutely felt in competition, the burden falls on the labourer, in the increased exploitation of whom the capitalist looks for his indemnification.	Soweit diese Depreziation sich durch die Konkurrenz akut fühlbar macht, fällt die Hauptwucht auf den Arbeiter, in dessen gesteigerter Exploitation der Kapitalist Schadenersatz sucht.	ch24_clean.en-ch24_clean.de
Labour transmits to its product the value of the means of production consumed by it.	Die Arbeit überträgt auf das Produkt den Wert der von ihr konsumierten Produktionsmittel.	ch24_clean.en-ch24_clean.de
On the other hand, the value and mass of the means of production set in motion by a given quantity of labour increase as the labour becomes more productive.	Andrerseits wächst Wert und Masse der durch gegebne Arbeitsmenge in Bewegung gesetzten Produktionsmittel im Verhältnis, wie die Arbeit produktiver wird.	ch24_clean.en-ch24_clean.de
Though the same quantity of labour adds always to its products only the same sum of new value, still the old capital value, transmitted by the labour to the products, increases with the growing productivity of labour.	Setzt also auch dieselbe Arbeitsmenge ihren Produkten immer nur dieselbe Summe Neuwert zu, so wächst doch der alte Kapitalwert, den sie ihnen gleichzeitig überträgt, mit steigender Produktivität der Arbeit.	ch24_clean.en-ch24_clean.de
An English and a Chinese spinner, e.g., may work the same number of hours with the same intensity; then they will both in a week create equal values.	Ein englischer und ein chinesischer Spinner z.B. mögen dieselbe Stundenzahl mit derselben Intensität arbeiten, so werden beide in einer Woche gleiche Werte erzeugen.	ch24_clean.en-ch24_clean.de
But in spite of this equality, an immense difference will obtain between the value of the week’s product of the Englishman, who works with a mighty automaton, and that of the Chinaman, who has but a spinning-wheel.	Trotz dieser Gleichheit besteht ein ungeheurer Unterschied zwischen dem Wert des Wochenprodukts des Engländers, der mit einem gewaltigen Automaten arbeitet, und des Chinesen, der nur ein Spinnrad hat.	ch24_clean.en-ch24_clean.de
In the same time as the Chinaman spins one pound of cotton, the Englishman spins several hundreds of pounds.	In derselben Zeit, wo der Chinese ein Pfund Baumwolle, verspinnt der Engländer mehrere hundert Pfund.	ch24_clean.en-ch24_clean.de
A sum, many hundred times as great, of old values swells the value of his product, in which those re-appear in a new, useful form, and can thus function anew as capital.	Eine um mehrere hundert Mal größere Summe alter Werte schwellt den Wert seines Produkts an, in welchem sie in neuer nutzbarer Form erhalten werden und so von neuem als Kapital funktionieren können.	ch24_clean.en-ch24_clean.de
“In 1782,” as Frederick Engels teaches us, “all the wool crop in England of the three preceding years, lay untouched for want of labourers, and so it must have lain, if newly invented machinery had not come to its aid and spun it.”	"1782", belehrt uns F. Engels, "lag die ganze Wollernte der vorhergehenden drei Jahre" (in England) "aus Mangel an Arbeitern noch unverarbeitet da und hätte liegenbleiben müssen, wenn nicht die neuerfundne Maschinerie zu Hilfe gekommen wäre und sie versponnen hätte."	ch24_clean.en-ch24_clean.de
Labour embodied in the form of machinery of course did not directly force into life a single man, but it made it possible for a smaller number of labourers, with the addition of relatively less living labour, not only to consume the wool productively, and put into it new value, but to preserve in the form of yarn, &c., its old value.	Die in der Form von Maschinerie vergegenständlichte Arbeit stampfte natürlich unmittelbar keinen Menschen aus dem Boden, aber sie erlaubte einer geringen Arbeiteranzahl durch Zusatz von relativ wenig lebendiger Arbeit nicht nur die Wolle produktiv zu konsumieren und ihr Neuwert zuzusetzen, sondern in der Form von Garn usw. ihren alten Wert zu erhalten.	ch24_clean.en-ch24_clean.de
At the same time, it caused and stimulated increased reproduction of wool.	Sie lieferte damit zugleich Mittel und Sporn zur erweiterten Reproduktion von Wolle.	ch24_clean.en-ch24_clean.de
It is the natural property of living labour, to transmit old value, whilst it creates new.	Es ist die Naturgabe der lebendigen Arbeit, alten Wert zu erhalten, während sie Neuwert schafft.	ch24_clean.en-ch24_clean.de
Hence, with the increase in efficacy, extent and value of its means of production, consequently with the accumulation that accompanies the development of its productive power, labour keeps up and eternises an always increasing capital value in a form ever new.”	Mit dem Wachstum von Wirksamkeit, Umfang und Wert ihrer Produktionsmittel, also mit der die Entwicklung ihrer Produktivkraft begleitenden Akkumulation erhält und verewigt die Arbeit daher in stets neuer Form einen stets schwellenden Kapitalwert.	ch24_clean.en-ch24_clean.de
This natural power of labour takes the appearance of an intrinsic property of capital, in which it is incorporated, just as the productive forces of social labour take the appearance of inherent properties of capital, and as the constant appropriation of surplus labour by the capitalists, takes that of a constant self-expansion of capital.	Diese Naturkraft der Arbeit erscheint als Selbsterhaltungskraft des Kapitals, dem sie einverleibt ist, ganz wie ihre gesellschaftlichen Produktivkräfte als seine Eigenschaften, und wie die beständige Aneignung der Mehrarbeit durch den Kapitalisten als beständige Selbstverwertung des Kapitals. Alle Kräfte der Arbeit projektieren sich als Kräfte des Kapitals, wie alle Wertformen der Ware als Formen des Geldes.	ch24_clean.en-ch24_clean.de
With the increase of capital, the difference between the capital employed and the capital consumed increases.	Mit dem Wachstum des Kapitals wächst die Differenz zwischen angewandtem und konsumiertem Kapital.	ch24_clean.en-ch24_clean.de
In other words, there is increase in the value and the material mass of the instruments of labour, such as buildings, machinery, drain-pipes, working-cattle, apparatus of every kind that function for a longer or shorter time in processes of production constantly repeated, or that serve for the attainment of particular useful effects, whilst they themselves only gradually wear out, therefore only lose their value piecemeal, therefore transfer that value to the product only bit by bit.	In andren Worten: Es wächst die Wert- und Stoffmasse der Arbeitsmittel, wie Baulichkeiten, Maschinerie, Drainierungsröhren, Arbeitsvieh, Apparate jeder Art, die während längerer oder kürzerer Perioden, in beständig wiederholten Produktionsprozessen, ihrem ganzen Umfang nach funktionieren oder zur Erzielung bestimmter Nutzeffekte dienen, während sie nur allmählich verschleißen, daher ihren Wert nur stückweis verlieren, also auch nur stückweis auf das Produkt übertragen.	ch24_clean.en-ch24_clean.de
In the same proportion as these instruments of labour serve as product-formers without adding value to the product, i.e., in the same proportion as they are wholly employed but only partly consumed, they perform, as we saw earlier, the same gratuitous service as the natural forces, water, steam, air, electricity, etc. This gratuitous service of past labour, when seized and filled with a soul by living labour, increases with the advancing stages of accumulation.	Im Verhältnis, worin diese Arbeitsmittel als Produktbildner dienen, ohne dem Produkt Wert zuzusetzen, also ganz angewandt, aber nur teilweis konsumiert werden, leisten sie, wie früher erwähnt, denselben Gratisdienst wie Naturkräfte, Wasser, Dampf, Luft, Elektrizität usw. Dieser Gratisdienst der vergangnen Arbeit, wenn ergriffen und beseelt von der lebendigen Arbeit, akkumuliert mit der wachsenden Stufenleiter der Akkumulation.	ch24_clean.en-ch24_clean.de
Since past labour always disguises itself as capital, i.e., since the passive of the labour of A, B, C, etc., takes the form of the active of the non-labourer X, bourgeois and political economists are full of praises of the services of dead and gone labour, which, according to the Scotch genius MacCulloch, ought to receive a special remuneration in the shape of interest, profit, etc.	Da die vergangne Arbeit sich stets in Kapital verkleidet, d.h. das Passivum der Arbeit von A, B, C usw. in das Aktivum des Nichtarbeiters X, sind Bürger und politische Ökonomen voll des Lobes für die Verdienste der vergangnen Arbeit, welche nach dem schottischen Genie MacCulloch sogar einen eignen Sold (Zins, Profit usw.) beziehn muß.	ch24_clean.en-ch24_clean.de
The powerful and ever-increasing assistance given by past labour to the living labour process under the form of means of production is, therefore, attributed to that form of past labour in which it is alienated, as unpaid labour, from the worker himself, i.e., to its capitalistic form.	Das stets wachsende Gewicht der im lebendigen Arbeitsprozeß unter der Form von Produktionsmitteln mitwirkenden vergangnen Arbeit wird also ihrer dem Arbeiter selbst, dessen vergangne und unbezahlte Arbeit sie ist, entfremdeten Gestalt zugeschrieben, ihrer Kapitalgestalt.	ch24_clean.en-ch24_clean.de
The practical agents of capitalistic production and their pettifogging ideologists are as unable to think of the means of production as separate from the antagonistic social mask they wear today, as a slave-owner to think of the worker himself as distinct from his character as a slave.	Die praktischen Agenten der kapitalistischen Produktion und ihre ideologischen Zungendrescher sind ebenso unfähig, das Produktionsmittel von der antagonistischen gesellschaftlichen Charaktermaske, die ihm heutzutag anklebt, getrennt zu denken, als ein Sklavenhalter den Arbeiter selbst von seinem Charakter als Sklave.	ch24_clean.en-ch24_clean.de
With a given degree of exploitation of labour-power, the mass of the surplus-value produced is determined by the number of workers simultaneously exploited; and this corresponds, although in varying proportions, with the magnitude of the capital.	Bei gegebnem Exploitationsgrad der Arbeitskraft ist die Masse des Mehrwerts bestimmt durch die Anzahl der gleichzeitig ausgebeuteten Arbeiter, und diese entspricht, obgleich in wechselndem Verhältnis, der Größe des Kapitals.	ch24_clean.en-ch24_clean.de
The more, therefore, capital increases by means of successive accumulations, the more does the sum of the value increase that is divided into consumption fund and accumulation fund.	Je mehr also das Kapital vermittelst sukzessiver Akkumulationen wächst, desto mehr wächst auch die Wertsumme, die sich in Konsumtionsfonds und Akkumulationsfonds spaltet.	ch24_clean.en-ch24_clean.de
The capitalist can, therefore, live a more jolly life, and at the same time show more “abstinence.”	Der Kapitalist kann daher flotter leben und zugleich mehr "entsagen".	ch24_clean.en-ch24_clean.de
And, finally, all the springs of production act with greater elasticity, the more its scale extends with the mass of the capital advanced.	Und schließlich spielen alle Springfedern der Produktion um so energischer, je mehr ihre Stufenleiter sich erweitert mit der Masse des vorgeschossenen Kapitals.	ch24_clean.en-ch24_clean.de
Section 5: The So-Called Labour Fund It has been shown in the course of this inquiry that capital is not a fixed magnitude, but is a part of social wealth, elastic and constantly fluctuating with the division of fresh surplus-value into revenue and additional capital.	5. Der sogenannte Arbeitsfonds Es ergab sich im Verlauf dieser Untersuchung, daß das Kapital keine fixe Größe ist, sondern ein elastischer und mit der Teilung des Mehrwerts in Revenue und Zusatzkapital beständig fluktuierender Teil des gesellschaftlichen Reichtums.	ch24_clean.en-ch24_clean.de
It has been seen further that, even with a given magnitude of functioning capital, the labour-power, the science, and the land (by which are to be understood, economically, all conditions of labour furnished by Nature independently of man), embodied in it, form elastic powers of capital, allowing it, within certain limits, a field of action independent of its own magnitude.	Man sah ferner, daß selbst bei gegebner Größe des funktionierenden Kapitals die ihm einverleibte Arbeitskraft, Wissenschaft und Erde (worunter ökonomisch alle ohne Zutat des Menschen von Natur vorhandnen Arbeitsgegenstände zu verstehn sind) elastische Potenzen desselben bilden, die ihm innerhalb gewisser Grenzen einen von seiner eignen Größe unabhängigen Spielraum gestatten.	ch24_clean.en-ch24_clean.de
In this inquiry we have neglected all effects of the process of circulation, effects which may produce very different degrees of efficiency in the same mass of capital.	Es wurde dabei von allen Verhältnissen des Zirkulationsprozesses abgesehn, die sehr verschiedne Wirkungsgrade derselben Kapitalmasse verursachen.	ch24_clean.en-ch24_clean.de
And as we presupposed the limits set by capitalist production, that is to say, presupposed the process of social production in a form developed by purely spontaneous growth, we neglected any more rational combination, directly and systematically practicable with the means of production, and the mass of labour-power at present disposable.	Es wurde, da wir die Schranken der kapitalistischen Produktion voraussetzen, also eine rein naturwüchsige Gestalt des gesellschaftlichen Produktionsprozesses, abgesehn von jeder mit den vorhandnen Produktionsmitteln und Arbeitskräften unmittelbar und planmäßig bewirkbaren rationelleren Kombination.	ch24_clean.en-ch24_clean.de
Classical economy always loved to conceive social capital as a fixed magnitude of a fixed degree of efficiency.	Die klassische Ökonomie liebte es von jeher, das gesellschaftliche Kapital als eine fixe Größe von fixem Wirkungsgrad aufzufassen.	ch24_clean.en-ch24_clean.de
But this prejudice was first established as a dogma by the arch-Philistine, Jeremy Bentham, that insipid, pedantic, leather-tongued oracle of the ordinary bourgeois intelligence of the 19th century.	Aber das Vorurteil ward erst zum Dogma befestigt durch den Urphilister Jeremias Bentham, dies nüchtern pedantische, schwatzlederne Orakel des gemeinen Bürgerverstandes des 19. Jahrhunderts.	ch24_clean.en-ch24_clean.de
Bentham is among philosophers what Martin Tupper is among poets.	Bentham ist unter den Philosophen, was Martin Tupper unter den Dichtern.	ch24_clean.en-ch24_clean.de
Both could only have been manufactured in England.	Beide waren nur in England fabrizierbar.	ch24_clean.en-ch24_clean.de
In the light of his dogma the commonest phenomena of the process of production, as, e.g., its sudden expansions and contractions, nay, even accumulation itself, become perfectly inconceivable.	Mit seinem Dogma werden die gewöhnlichsten Erscheinungen des Produktionsprozesses, wie z.B. dessen plötzliche Expansionen und Kontraktionen, ja sogar die Akkumulation, völlig unbegreif- bar.	ch24_clean.en-ch24_clean.de
51The dogma was used by Bentham himself, as well as by Malthus, James Mill, MacCulloch, etc., for an apologetic purpose, and especially in order to represent one part of capital, namely, variable capital, or that part convertible into labour-power, as a fixed magnitude.	Das Dogma wurde sowohl von Bentham selbst als von Malthus, James Mill, MacCulloch usw. zu apologetischen Zwecken vernutzt, namentlich um einen Teil des Kapitals, das variable oder in Arbeitskraft umsetzbare Kapital als eine fixe Größe darzustellen.	ch24_clean.en-ch24_clean.de
The material of variable capital, i.e., the mass of the means of subsistence it represents for the labourer, or the so-called labour fund, was fabled as a separate part of social wealth, fixed by natural laws and unchangeable.	Die stoffliche Existenz des variablen Kapitals, d.h. die Masse der Lebensmittel, die es für den Arbeiter repräsentiert, oder der sog. Arbeitsfonds, wurde in einem durch Naturketten abgeringten und unüberschreitbaren Sonderteil des gesellschaftlichen Reichtums verfabelt.	ch24_clean.en-ch24_clean.de
To set in motion the part of social wealth which is to function as constant capital, or, to express it in a material form, as means of production, a definite mass of living labour is required.	Um den Teil des gesellschaftlichen Reichtums, der als konstantes Kapital oder, stofflich ausgedrückt, als Produktionsmittel funktionieren soll, in Bewegung zu setzen, ist eine bestimmte Masse lebendiger Arbeit erheischt.	ch24_clean.en-ch24_clean.de
This mass is given technologically.	Diese ist technologisch gegeben.	ch24_clean.en-ch24_clean.de
But neither is the number of labourers required to render fluid this mass of labour-power given (it changes with the degree of exploitation of the individual labour-power), nor is the price of this labour-power given, but only its minimum limit, which is moreover very variable.	Aber weder ist die Anzahl der Arbeiter gegeben, erheischt, um diese Arbeitsmasse flüssig zu machen, denn das wechselt mit dem Exploitationsgrad der individuellen Arbeitskraft, noch der Preis dieser Arbeitskraft, sondern nur seine zudem sehr elastische Minimalschranke.	ch24_clean.en-ch24_clean.de
The facts that lie at the bottom of this dogma are these: on the one hand, the labourer has no right to interfere in the division of social wealth into means of enjoyment for the non-labourer and means of production.	Die Tatsachen, die dem Dogma zu Grund liegen, sind die: Einerseits hat der Arbeiter nicht mitzusprechen bei der Teilung des gesellschaftlichen Reichtums in Genußmittel der Nichtarbeiter und in Produktionsmittel.	ch24_clean.en-ch24_clean.de
On the other hand, only in favourable and exceptional cases, has he the power to enlarge the so-called labour fund at the expense of the “revenue” of the wealthy.	Andrerseits kann er nur in günstigen Ausnahmsfällen den sog. "Arbeitsfonds" auf Kosten der "Revenue" des Reichen erweitern.	ch24_clean.en-ch24_clean.de
What silly tautology results from the attempt to represent the capitalistic limits of the labour fund as its natural and social limits may be seen, e.g., in Professor Fawcett.	Zu welch abgeschmackter Tautologie es führt, die kapitalistische Schranke des Arbeitsfonds in seine gesellschaftliche Naturschranke umzudichten, zeige u.a. Professor Fawcett: "Das zirkulierende Kapital eines Landes", sagt er, "ist sein Arbeitsfonds.	ch24_clean.en-ch24_clean.de
“The circulating capital of a country,” he says, “is its wage-fund.	Um daher den durchschnittlichen Geldlohn, den jeder Arbeiter erhält, zu berechnen, haben wir nur einfach dies Kapital durch die Anzahl der Arbeiterbevölkerung zu dividieren."	ch24_clean.en-ch24_clean.de
Hence, if we desire to calculate the average money wages received by each labourer, we have simply to divide the amount of this capital by the number of the labouring population.” 54 That is to say, we first add together the individual wages actually paid, and then we affirm that the sum thus obtained, forms the total value of the “labour fund” determined and vouchsafed to us by God and Nature.	D.h. also, erst rechnen wir die wirklich gezahlten individuellen Arbeitslöhne in eine Summe zusammen, dann behaupten wir, daß diese Addition die Wertsumme des von Gott und Natur oktroyierten "Arbeitsfonds" bildet.	ch24_clean.en-ch24_clean.de
Lastly, we divide the sum thus obtained by the number of labourers to find out again how much may come to each on the average.	Endlich dividieren wir die so erhaltne Summe durch die Kopfzahl der Arbeiter, um hinwiederum zu entdecken, wieviel jedem Arbeiter individuell im Durchschnitt zufallen kann.	ch24_clean.en-ch24_clean.de
An uncommonly knowing dodge this.	Eine ungemein pfiffige Prozedur dies.	ch24_clean.en-ch24_clean.de
It did not prevent Mr. Fawcett saying in the same breath: “The aggregate wealth which is annually saved in England, is divided into two portions; one portion is employed as capital to maintain our industry, and the other portion is exported to foreign countries...	Sie verhindert Herrn Fawcett nicht, im selben Atemzug zu sagen: "Der in England jährlich akkumulierte Gesamtreichtum wird in zwei Teile geteilt. Ein Teil wird in England zur Erhaltung unsrer eignen Industrie verwandt. Ein andrer Teil wird in andre Länder exportiert ...	ch24_clean.en-ch24_clean.de
Only a portion, and perhaps, not a large portion of the wealth which is annually saved in this country, is invested in our own industry.	Der in unsrer Industrie angewandte Teil bildet keine bedeutende Portion des jährlich in diesem Land akkumulierten Reichtums."	ch24_clean.en-ch24_clean.de
The greater part of the yearly accruing surplus-product, embezzled, because abstracted without return of an equivalent, from the English labourer, is thus used as capital, not in England, but in foreign countries.	Der größere Teil des jährlich zuwachsenden Mehrprodukts, dem englischen Arbeiter ohne Äquivalent entwandt, wird also nicht in England, sondern in fremden Länder verkapitalisiert.	ch24_clean.en-ch24_clean.de
But with the additional capital thus exported, a part of the “labour fund” invented by God and Bentham is also exported.	Aber mit dem so exportierten Zusatzkapital wird ja auch ein Teil des von Gott und Bentham erfundnen "Arbeitsfonds" exportiert.	ch24_clean.en-ch24_clean.de

