Chapter 26: The Secret of Primitive Accumulation We have seen how money is changed into capital; how through capital surplus-value is made, and from surplus-value more capital.	VIERUNDZWANZIGSTES KAPITEL Die sogenannte ursprüngliche Akkumulation 1. Das Geheimnis der ursprünglichen Akkumulation Man hat gesehn, wie Geld in Kapital verwandelt, durch Kapital Mehrwert und aus Mehrwert mehr Kapital gemacht wird.	ch26_clean.en-ch26_clean.de
But the accumulation of capital presupposes surplus-value; surplus-value presupposes capitalistic production; capitalistic production presupposes the pre-existence of considerable masses of capital and of labour power in the hands of producers of commodities.	Indes setzt die Akkumulation des Kapitals den Mehrwert, der Mehrwert die kapitalistische Produktion, dieser aber das Vorhandensein größerer Massen von Kapital und Arbeitskraft in den Händen von Warenproduzenten voraus.	ch26_clean.en-ch26_clean.de
The whole movement, therefore, seems to turn in a vicious circle, out of which we can only get by supposing a primitive accumulation (previous accumulation of Adam Smith) preceding capitalistic accumulation; an accumulation not the result of the capitalistic mode of production, but its starting point.	Diese ganze Bewegung scheint sich also in einem fehlerhaften Kreislauf herumzudrehn, aus dem wir nur hinauskommen, indem wir eine der kapitalistischen Akkumulation vorausgehende "ursprüngliche" Akkumulation ("previous accumulation" bei Adam Smith) unterstellen, eine Akkumulation, welche nicht das Resultat der kapitalistischen Produktionsweise ist, sondern ihr Ausgangspunkt.	ch26_clean.en-ch26_clean.de
This primitive accumulation plays in Political Economy about the same part as original sin in theology.	Diese ursprüngliche Akkumulation spielt in der politischen Ökonomie ungefähr dieselbe Rolle wie der Sündenfall in der Theologie.	ch26_clean.en-ch26_clean.de
Adam bit the apple, and thereupon sin fell on the human race.	Adam biß in den Apfel, und damit kam über das Menschengeschlecht die Sünde.	ch26_clean.en-ch26_clean.de
Its origin is supposed to be explained when it is told as an anecdote of the past.	Ihr Ursprung wird erklärt, indem er als Anekdote der Vergangenheit erzählt wird.	ch26_clean.en-ch26_clean.de
In times long gone by there were two sorts of people; one, the diligent, intelligent, and, above all, frugal elite; the other, lazy rascals, spending their substance, and more, in riotous living.	In einer längst verfloßnen Zeit gab es auf der einen Seite eine fleißige, intelligente und vor allem sparsame Elite und auf der andren faulenzende, ihr alles und mehr verjubelnde Lumpen.	ch26_clean.en-ch26_clean.de
The legend of theological original sin tells us certainly how man came to be condemned to eat his bread in the sweat of his brow; but the history of economic original sin reveals to us that there are people to whom this is by no means essential.	Die Legende vom theologischen Sündenfall erzählt uns allerdings, wie der Mensch dazu verdammt worden sei, sein Brot im Schweiß seines Angesichts zu essen; die Historie vom ökonomischen Sündenfall aber enthüllt uns, wieso es Leute gibt, die das keineswegs nötig haben.	ch26_clean.en-ch26_clean.de
Never mind!	Einerlei.	ch26_clean.en-ch26_clean.de
Thus it came to pass that the former sort accumulated wealth, and the latter sort had at last nothing to sell except their own skins.	So kam es, daß die ersten Reichtum akkumulierten und die letztren schließlich nichts zu verkaufen hatten als ihre eigne Haut.	ch26_clean.en-ch26_clean.de
And from this original sin dates the poverty of the great majority that, despite all its labour, has up to now nothing to sell but itself, and the wealth of the few that increases constantly although they have long ceased to work.	Und von diesem Sündenfall datiert die Armut der großen Masse, die immer noch, aller Arbeit zum Trotz, nichts zu verkaufen hat als sich selbst, und der Reichtum der wenigen, der fortwährend wächst, obgleich sie längst aufgehört haben zu arbeiten.	ch26_clean.en-ch26_clean.de
Such insipid childishness is every day preached to us in the defence of property. M. Thiers, e.g., had the assurance to repeat it with all the solemnity of a statesman to the French people, once so spirituel.	Solche fade Kinderei kaut Herr Thiers z.B. noch mit staatsfeierlichem Ernst, zur Verteidigung der propriété <des Eigentums>, den einst so geistreichen Franzosen vor.	ch26_clean.en-ch26_clean.de
But as soon as the question of property crops up, it becomes a sacred duty to proclaim the intellectual food of the infant as the one thing fit for all ages and for all stages of development.	Aber sobald die Eigentumsfrage ins Spiel kommt, wird es heilige Pflicht, den Standpunkt der Kinderfibel als den allen Altersklassen und Entwicklungsstufen allein gerechten festzuhalten.	ch26_clean.en-ch26_clean.de
In actual history it is notorious that conquest, enslavement, robbery, murder, briefly force, play the great part.	In der wirklichen Geschichte spielen bekanntlich Eroberung, Unterjochung, Raubmord, kurz Gewalt die große Rolle.	ch26_clean.en-ch26_clean.de
In the tender annals of Political Economy, the idyllic reigns from time immemorial.	In der sanften politischen Ökonomie herrschte von jeher die Idylle.	ch26_clean.en-ch26_clean.de
Right and “labour” were from all time the sole means of enrichment, the present year of course always excepted.	Recht und "Arbeit" waren von jeher die einzigen Bereicherungsmittel, natürlich mit jedesmaliger Ausnahme von "diesem Jahr".	ch26_clean.en-ch26_clean.de
As a matter of fact, the methods of primitive accumulation are anything but idyllic.	In der Tat sind die Methoden der ursprünglichen Akkumulation alles andre, nur nicht idyllisch.	ch26_clean.en-ch26_clean.de
In themselves money and commodities are no more capital than are the means of production and of subsistence.	Geld und Ware sind nicht von vornherein Kapital, sowenig wie Produktions- und Lebensmittel.	ch26_clean.en-ch26_clean.de
They want transforming into capital.	Sie bedürfen der Verwandlung in Kapital.	ch26_clean.en-ch26_clean.de
But this transformation itself can only take place under certain circumstances that centre in this, viz., that two very different kinds of commodity-possessors must come face to face and into contact; on the one hand, the owners of money, means of production, means of subsistence, who are eager to increase the sum of values they possess, by buying other people’s labour power; on the other hand, free labourers, the sellers of their own labour power, and therefore the sellers of labour.	Diese Verwandlung selbst aber kann nur unter bestimmten Umständen vorgehn, die sich dahin zusammenspitzen: Zweierlei sehr verschiedne Sorten von Warenbesitzern müssen sich gegenüber und in Kontakt treten, einerseits Eigner von Geld, Produktions- und Lebensmitteln, denen es gilt, die von ihnen geeignete Wertsumme zu verwerten durch Ankauf fremder Arbeitskraft; andrerseits freie Arbeiter, Verkäufer der eignen Arbeitskraft und daher Verkäufer von Arbeit.	ch26_clean.en-ch26_clean.de
Free labourers, in the double sense that neither they themselves form part and parcel of the means of production, as in the case of slaves, bondsmen, &c., nor do the means of production belong to them, as in the case of peasant-proprietors; they are, therefore, free from, unencumbered by, any means of production of their own.	Freie Arbeiter in dem Doppelsinn, daß weder sie selbst unmittelbar zu den Produktionsmitteln gehören, wie Sklaven, Leibeigne usw., noch auch die Produktionsmittel ihnen gehören, wie beim selbstwirtschaftenden Bauer usw., sie davon vielmehr frei, los und ledig sind.	ch26_clean.en-ch26_clean.de
With this polarisation of the market for commodities, the fundamental conditions of capitalist production are given.	Mit dieser Polarisation des Warenmarkts sind die Grundbedingungen der kapitalistischen Produktion gegeben.	ch26_clean.en-ch26_clean.de
The capitalist system presupposes the complete separation of the labourers from all property in the means by which they can realize their labour.	Das Kapitalverhältnis setzt die Scheidung zwischen den Arbeitern und dem Eigentum an den Verwirklichungsbedingungen der Arbeit voraus.	ch26_clean.en-ch26_clean.de
As soon as capitalist production is once on its own legs, it not only maintains this separation, but reproduces it on a continually extending scale.	Sobald die kapitalistische Produktion einmal auf eignen Füßen steht, erhält sie nicht nur jene Scheidung, sondern reproduziert sie auf stets wachsender Stufenleiter.	ch26_clean.en-ch26_clean.de
The process, therefore, that clears the way for the capitalist system, can be none other than the process which takes away from the labourer the possession of his means of production; a process that transforms, on the one hand, the social means of subsistence and of production into capital, on the other, the immediate producers into wage labourers.	Der Prozeß, der das Kapitalverhältnis schafft, kann also nichts andres sein als der Scheidungsprozeß des Arbeiters vom Eigentum an seinen Arbeitsbedingungen, ein Prozeß, der einerseits die gesellschaftlichen Lebens- und Produktionsmittel in Kapital verwandelt, andrerseits die unmittelbaren Produzenten in Lohnarbeiter.	ch26_clean.en-ch26_clean.de
The so-called primitive accumulation, therefore, is nothing else than the historical process of divorcing the producer from the means of production.	Die sog. ursprüngliche Akkumulation ist also nichts als der historische Scheidungsprozeß von Produzent und Produktionsmittel.	ch26_clean.en-ch26_clean.de
It appears as primitive, because it forms the prehistoric stage of capital and of the mode of production corresponding with it.	Er erscheint als "ursprünglich", weil er die Vorgeschichte des Kapitals und der ihm entsprechenden Produktionsweise bildet.	ch26_clean.en-ch26_clean.de
The economic structure of capitalist society has grown out of the economic structure of feudal society.	Die ökonomische Struktur der kapitalistischen Gesellschaft ist hervorgegangen aus der ökonomischen Struktur der feudalen Gesellschaft.	ch26_clean.en-ch26_clean.de
The dissolution of the latter set free the elements of the former.	Die Auflösung dieser hat die Elemente jener freigesetzt.	ch26_clean.en-ch26_clean.de
The immediate producer, the labourer, could only dispose of his own person after he had ceased to be attached to the soil and ceased to be the slave, serf, or bondsman of another.	Der unmittelbare Produzent, der Arbeiter, konnte erst dann über seine Person verfügen, nachdem er aufgehört hatte, an die Scholle gefesselt und einer andern Person leibeigen oder hörig zu sein.	ch26_clean.en-ch26_clean.de
To become a free seller of labour power, who carries his commodity wherever he finds a market, he must further have escaped from the regime of the guilds, their rules for apprentices and journeymen, and the impediments of their labour regulations.	Um freier Verkäufer von Arbeitskraft zu werden, der seine Ware überall hinträgt, wo sie einen Markt findet, mußte er ferner der Herrschaft der Zünfte, ihren Lehrlings- und Gesellenordnungen und hemmenden Arbeitsvorschriften entronnen sein.	ch26_clean.en-ch26_clean.de
Hence, the historical movement which changes the producers into wage-workers, appears, on the one hand, as their emancipation from serfdom and from the fetters of the guilds, and this side alone exists for our bourgeois historians.	Somit erscheint die geschichtliche Bewegung, die die Produzenten in Lohnarbeiter verwandelt, einerseits als ihre Befreiung von Dienstbarkeit und Zunftzwang; und diese Seite allein existiert für unsre bürgerlichen Geschichtschreiber.	ch26_clean.en-ch26_clean.de
But, on the other hand, these new freedmen became sellers of themselves only after they had been robbed of all their own means of production, and of all the guarantees of existence afforded by the old feudal arrangements.	Andrerseits aber werden diese Neubefreiten erst Verkäufer ihrer selbst, nachdem ihnen alle ihre Produktionsmittel und alle durch die alten feudalen Einrichtungen gebotnen Garantien ihrer Existenz geraubt sind.	ch26_clean.en-ch26_clean.de
And the history of this, their expropriation, is written in the annals of mankind in letters of blood and fire.	Und die Geschichte dieser ihrer Expropriation ist in die Annalen der Menschheit eingeschrieben mit Zügen von Blut und Feuer.	ch26_clean.en-ch26_clean.de
The industrial capitalists, these new potentates, had on their part not only to displace the guild masters of handicrafts, but also the feudal lords, the possessors of the sources of wealth.	Die industriellen Kapitalisten, diese neuen Potentaten, mußten ihrerseits nicht nur die zünftigen Handwerksmeister verdrängen, sondern auch die im Besitz der Reichtumsquellen befindlichen Feudalherren.	ch26_clean.en-ch26_clean.de
In this respect, their conquest of social power appears as the fruit of a victorious struggle both against feudal lordship and its revolting prerogatives, and against the guilds and the fetters they laid on the free development of production and the free exploitation of man by man.	Von dieser Seite stellt sich ihr Emporkommen dar als Frucht eines siegreichen Kampfes gegen die Feudalmacht und ihre empörenden Vorrechte sowie gegen die Zünfte und die Fesseln, die diese der freien Entwicklung der Produktion und der freien Ausbeutung des Menschen durch den Menschen angelegt.	ch26_clean.en-ch26_clean.de
The chevaliers d’industrie, however, only succeeded in supplanting the chevaliers of the sword by making use of events of which they themselves were wholly innocent.	Die Ritter von der Industrie brachten es jedoch nur fertig, die Ritter vom Degen zu verdrängen, dadurch, daß sie Ereignisse ausbeuteten, an denen sie ganz unschuldig waren.	ch26_clean.en-ch26_clean.de
They have risen by means as vile as those by which the Roman freedman once on a time made himself the master of his patronus.	Sie haben sich emporgeschwungen durch Mittel, ebenso gemein wie die, wodurch der römische Freigelassene sich einst zum Herrn seines patronus gemacht hat.	ch26_clean.en-ch26_clean.de
The starting point of the development that gave rise to the wage labourer as well as to the capitalist, was the servitude of the labourer.	Der Ausgangspunkt der Entwicklung, die sowohl den Lohnarbeiter wie den Kapitalisten erzeugt, war die Knechtschaft des Arbeiters.	ch26_clean.en-ch26_clean.de
The advance consisted in a change of form of this servitude, in the transformation of feudal exploitation into capitalist exploitation.	Der Fortgang bestand in einem Formwechsel dieser Knechtung, in der Verwandlung der feudalen in kapitalistische Exploitation.	ch26_clean.en-ch26_clean.de
To understand its march, we need not go back very far.	Um ihren Gang zu verstehn, brauchen wir gar nicht so weit zurückzugreifen.	ch26_clean.en-ch26_clean.de
Although we come across the first beginnings of capitalist production as early as the 14th or 15th century, sporadically, in certain towns of the Mediterranean, the capitalistic era dates from the 16th century.	Obgleich die ersten Anfänge kapitalistischer Produktion uns schon im 14. und 15. Jahrhundert in einigen Städten am Mittelmeer sporadisch entgegentreten, datiert die kapitalistische Ära erst vom 16. Jahrhundert.	ch26_clean.en-ch26_clean.de
Wherever it appears, the abolition of serfdom has been long effected, and the highest development of the middle ages, the existence of sovereign towns, has been long on the wane.	Dort, wo sie auftritt, ist die Aufhebung der Leibeigenschaft längst vollbracht und der Glanzpunkt des Mittelalters, der Bestand souveräner Städte, seit geraumer Zeit im Erbleichen.	ch26_clean.en-ch26_clean.de
In the history of primitive accumulation, all revolutions are epoch-making that act as levers for the capital class in course of formation; but, above all, those moments when great masses of men are suddenly and forcibly torn from their means of subsistence, and hurled as free and “unattached” proletarians on the labour-market.	Historisch epochemachend in der Geschichte der ursprünglichen Akkumulation sind alle Umwälzungen, die der sich bildenden Kapitalistenklasse als Hebel dienen; vor allem aber die Momente, worin große Menschenmassen plötzlich und gewaltsam von ihren Subsistenzmitteln losgerissen und als vogelfreie Proletarier auf den Arbeitsmarkt geschleudert werden.	ch26_clean.en-ch26_clean.de
The expropriation of the agricultural producer, of the peasant, from the soil, is the basis of the whole process.	Die Expropriation des ländlichen Produzenten, des Bauern, von Grund und Boden bildet die Grundlage des ganzen Prozesses.	ch26_clean.en-ch26_clean.de
The history of this expropriation, in different countries, assumes different aspects, and runs through its various phases in different orders of succession, and at different periods.	Ihre Geschichte nimmt in verschiedenen Ländern verschiedene Färbung an und durchläuft die verschiedenen Phasen in verschiedener Reihenfolge und in verschiedenen Geschichtsepochen.	ch26_clean.en-ch26_clean.de
In England alone, which we take as our example, has it the classic form.	Nur in England, das wir daher als Beispiel nehmen, besitzt sie klassische Form.	ch26_clean.en-ch26_clean.de

