Chapter 27: Expropriation of the Agricultural Population From the Land In England, serfdom had practically disappeared in the last part of the 14th century.	2. Expropriation des Landvolks von Grund und Boden In England war die Leibeigenschaft im letzten Teil des 14. Jahrhunderts faktisch verschwunden.	ch27_clean.en-ch27_clean.de
The immense majority of the population consisted then, and to a still larger extent, in the 15th century, of free peasant proprietors, whatever was the feudal title under which their right of property was hidden.	Die ungeheure Mehrzahl der Bevölkerung bestand damals und noch mehr im 15. Jahrhundert aus freien, selbstwirtschaf- tenden Bauern, durch welch feudales Aushängeschild ihr Eigentum immer versteckt sein mochte.	ch27_clean.en-ch27_clean.de
In the larger seignorial domains, the old bailiff, himself a serf, was displaced by the free farmer.	Auf den größeren herrschaftlichen Gütern war der früher selbst leibeigne bailiff (Vogt) durch den freien Pächter verdrängt.	ch27_clean.en-ch27_clean.de
The wage labourers of agriculture consisted partly of peasants, who utilised their leisure time by working on the large estates, partly of an independent special class of wage labourers, relatively and absolutely few in numbers.	Die Lohnarbeiter der Agrikultur bestanden teils aus Bauern, die ihre Mußezeit durch Arbeit bei großen Grundeigentümern verwerteten, teils aus einer selbständigen, relativ und absolut wenig zahlreichen Klasse eigentlicher Lohnarbeiter.	ch27_clean.en-ch27_clean.de
The latter also were practically at the same time peasant farmers, since, besides their wages, they had allotted to them arable land to the extent of 4 or more acres, together with their cottages.	Auch letztre waren faktisch zugleich selbstwirtschaftende Bauern, indem sie außer ihrem Lohn Ackerland zum Belauf von 4 und mehr Acres nebst Cottages angewiesen erhielten.	ch27_clean.en-ch27_clean.de
Besides they, with the rest of the peasants, enjoyed the usufruct of the common land, which gave pasture to their cattle, furnished them with timber, fire-wood, turf, &c.	Sie genossen zudem mit den eigentlichen Bauern die Nutznießung des Gemeindelandes, worauf ihr Vieh weidete und das ihnen zugleich die Mittel der Feuerung, Holz, Torf usw. bot.	ch27_clean.en-ch27_clean.de
In all countries of Europe, feudal production is characterised by division of the soil amongst the greatest possible number of subfeudatories.	In allen Ländern Europas ist die feudale Produktion durch Teilung des Bodens unter möglichst viele Untersassen charakterisiert.	ch27_clean.en-ch27_clean.de
The might of the feudal lord, like that of the sovereign, depended not on the length of his rent roll, but on the number of his subjects, and the latter depended on the number of peasant proprietors.	Die Macht des Feudalherrn, wie die jedes Souveräns, beruhte nicht auf der Länge seiner Rentrolle, sondern auf der Zahl seiner Untertanen, und letzre hing von der Zahl selbstwirtschaftender Bauern ab.	ch27_clean.en-ch27_clean.de
Although, therefore, the English land, after the Norman Conquest, was distributed in gigantic baronies, one of which often included some 900 of the old Anglo-Saxon lordships, it was bestrewn with small peasant properties, only here and there interspersed with great seignorial domains.	Obgleich der englische Boden daher nach der normännischen Eroberung in riesenhafte Baronien verteilt ward, wovon eine einzige oft 900 alte angelsächsische Lordschaften einschloß, war er besät von kleinen Bauernwirtschaften, nur hier und da durchbrochen von größeren herrschaftlichen Gütern.	ch27_clean.en-ch27_clean.de
Such conditions, together with the prosperity of the towns so characteristic of the 15th century, allowed of that wealth of the people which Chancellor Fortescue so eloquently paints in his “Laudes legum Angliae;” but it excluded the possibility of capitalistic wealth.	Solche Verhältnisse, bei gleichzeitiger Blüte des Städtewesens, wie sie das 15. Jahrhundert auszeichnet, erlaubten jenen Volksreichtum, den der Kanzler Fortescue so beredt in seinen "Laudibus Legum Angliae" schildert, aber sie schlossen den Kapitalreichtum aus.	ch27_clean.en-ch27_clean.de
The prelude of the revolution that laid the foundation of the capitalist mode of production, was played in the last third of the 15th, and the first decade of the 16th century.	Das Vorspiel der Umwälzung, welche die Grundlage der kapitalistischen Produktionsweise schuf, ereignet sich im letzten Dritteil des 15. und den ersten Dezennien des 16. Jahrhunderts.	ch27_clean.en-ch27_clean.de
A mass of free proletarians was hurled on the labour market by the breaking-up of the bands of feudal retainers, who, as Sir James Steuart well says, “everywhere uselessly filled house and castle.”	Eine Masse vogelfreier Proletarier ward auf den Arbeitsmarkt geschleudert durch die Auflösung der feudalen Gefolgschaften, die, wie Sir James Steuart richtig bemerkt, "überall nutzlos Haus und Hof füllten".	ch27_clean.en-ch27_clean.de
Although the royal power, itself a product of bourgeois development, in its strife after absolute sovereignty forcibly hastened on the dissolution of these bands of retainers, it was by no means the sole cause of it.	Obgleich die königliche Macht, selbst ein Produkt der bürgerlichen Entwicklung, in ihrem Streben nach absoluter Souveränität die Auflösung dieser Gefolgschaften gewaltsam beschleunigte, war sie keineswegs deren einzige Ursache.	ch27_clean.en-ch27_clean.de
In insolent conflict with king and parliament, the great feudal lords created an incomparably larger proletariat by the forcible driving of the peasantry from the land, to which the latter had the same feudal right as the lord himself, and by the usurpation of the common lands.	Vielmehr im trotzigsten Gegensatz zu Königtum und Parlament schuf der große Feudalherr ein ungleich größeres Proletariat durch gewaltsame Verjagung der Bauernschaft von dem Grund und Boden, worauf sie denselben feudalen Rechtstitel besaß wie er selbst, und durch Usurpation ihres Gemeindelandes.	ch27_clean.en-ch27_clean.de
The rapid rise of the Flemish wool manufactures, and the corresponding rise in the price of wool in England, gave the direct impulse to these evictions.	Den unmittelbaren Anstoß dazu gab in England namentlich das Aufblühn der flandrischen Wollmanufaktur und das entsprechende Steigen der Wollpreise.	ch27_clean.en-ch27_clean.de
The old nobility had been devoured by the great feudal wars. The new nobility was the child of its time, for which money was the power of all powers.	Den alten Feudaladel hatten die großen Feudalkriege verschlungen, der neue war ein Kind seiner Zeit, für welche Geld die Macht aller Mächte.	ch27_clean.en-ch27_clean.de
Transformation of arable land into sheep-walks was, therefore, its cry.	Verwandlung von Ackerland in Schafweide ward also sein Lösungswort.	ch27_clean.en-ch27_clean.de
Harrison, in his “Description of England, prefixed to Holinshed’s Chronicles,” describes how the expropriation of small peasants is ruining the country.	Harrison, in seiner "Description of England. Prefxed to Holinshed's Chronicles", beschreibt, wie die Expropriation der kleinen Bauern das Land ruiniert.	ch27_clean.en-ch27_clean.de
“What care our great encroachers?”	"What care our great incroachers!"	ch27_clean.en-ch27_clean.de
	(Was fragen unsre großen Usurpatoren danach?)	ch27_clean.en-ch27_clean.de
The dwellings of the peasants and the cottages of the labourers were razed to the ground or doomed to decay.	Die Wohnungen der Bauern und die Cottages der Arbeiter wurden gewaltsam niedergerissen oder dem Verfall geweiht.	ch27_clean.en-ch27_clean.de
“If,” says Harrison, “the old records of euerie manour be sought... it will soon appear that in some manour seventeene, eighteene, or twentie houses are shrunk... that England was neuer less furnished with people than at the present...	"Wenn man", sagt Harrison, "die älteren Inventarien jedes Ritterguts vergleichen will, so wird man finden, daß unzählige Häuser und kleine Bauernwirtschaften verschwunden sind, daß das Land viel weniger Leute nährt, daß viele Städte verfallen sind, obgleich einige neue aufblühn ...	ch27_clean.en-ch27_clean.de
Of cities and townes either utterly decaied or more than a quarter or half diminished, though some one be a little increased here or there; of townes pulled downe for sheepe-walks, and no more but the lordships now standing in them... I could saie somewhat.”	Von Städten und Dörfern, die man für Schaftriften zerstört hat und worin nur noch die Herrschaftshäuser stehn, könnte ich etwas erzählen."	ch27_clean.en-ch27_clean.de
The complaints of these old chroniclers are always exaggerated, but they reflect faithfully the impression made on contemporaries by the revolution in the conditions of production.	Die Klagen jener alten Chroniken sind immer übertrieben, aber sie zeichnen genau den Eindruck der Revolution in den Produktionsverhältnissen auf die Zeitgenossen selbst.	ch27_clean.en-ch27_clean.de
A comparison of the writings of Chancellor Fortescue and Thomas More reveals the gulf between the 15th and 16th century.	Ein Vergleich zwischen den Schriften der Kanzler Fortescue und Thomas Morus veranschaulicht die Kluft zwischen dem 15. und 16. Jahrhundert.	ch27_clean.en-ch27_clean.de
As Thornton rightly has it, the English working class was precipitated without any transition from its golden into its iron age.	Aus ihrem goldnen Zeitalter, wie Thornton richtig sagt, stürzte die englische Arbeiterklasse ohne alle Zwischenübergänge in das eiserne.	ch27_clean.en-ch27_clean.de
Legislation was terrified at this revolution.	Die Gesetzgebung erschrak vor dieser Umwälzung.	ch27_clean.en-ch27_clean.de
It did not yet stand on that height of civilisation where the “wealth of the nation” (i.e., the formation of capital, and the reckless exploitation and impoverishing of the mass of the people) figure as the ultima Thule of all state-craft.	Sie stand noch nicht auf der Zivilisationshöhe, wo "Wealth of the Nation" <"Reichtum der Nation">, d.h. Kapitalbildung und rücksichtslose Exploitation und Verarmung der Volksmasse als ultima Thule aller Staatsweisheit gelten.	ch27_clean.en-ch27_clean.de
In his history of Henry VII., Bacon says: “Inclosures at that time (1489) began to be more frequent, whereby arable land (which could not be manured without people and families) was turned into pasture, which was easily rid by a few herdsmen; and tenancies for years, lives, and at will (whereupon much of the yeomanry lived) were turned into demesnes.	In seiner Geschichte Heinrichs VII. sagt Baco: "Um diese Zeit" "mehrten sich die Klagen über Verwandlung von Ackerland in Weide" (zur Schaftrift usw.), "leicht zu versehn durch wenige Hirten; und Pachtungen auf Zeit, auf Lebzeit und auf jährliche Kündigung (wovon ein großer Teil der Yeomen lebte) wurden in Dominialgüter verwandelt.	ch27_clean.en-ch27_clean.de
This bred a decay of people, and (by consequence) a decay of towns, churches, tithes, and the like...	Dies brachte einen Verfall des Volks hervor und infolgedessen einen Verfall von Städten, Kirchen, Zehnten ...	ch27_clean.en-ch27_clean.de
In remedying of this inconvenience the king’s wisdom was admirable, and the parliament’s at that time... they took a course to take away depopulating enclosures, and depopulating pasturage.”	In der Kur dieses Mißstandes war die Weisheit des Königs und des Parlaments zu dieser Zeit bewundernswert ...	ch27_clean.en-ch27_clean.de
An Act of Henry VII., 1489, cap.	Sie ergriffen Maßregeln wider diese entvölkernde Usurpation der Gemeindeländereien (depopulating inclosures) und die ihr auf dem Fuß folgende entvölkernde Weidewirtschaft (depopulating pasture)."	ch27_clean.en-ch27_clean.de
19, forbad the destruction of all “houses of husbandry” to which at least 20 acres of land belonged.	Ein Akt Heinrich des Siebenten, 1489, c. 19, verbot die Zerstörung aller Bauernhäuser, zu denen wenigstens 20 Acres Land gehörten.	ch27_clean.en-ch27_clean.de
By an Act, 25 Henry VIII., the same law was renewed.	In einem Akt 25, Heinrich VIII., wird dasselbe Gesetz erneuert.	ch27_clean.en-ch27_clean.de
It recites, among other things, that many farms and large flocks of cattle, especially of sheep, are concentrated in the hands of a few men, whereby the rent of land has much risen and tillage has fallen off, churches and houses have been pulled down, and marvellous numbers of people have been deprived of the means wherewith to maintain themselves and their families.	Es heißt u.a., daß "viele Pachtungen und große Viehherden, besonders Schafe, sich in wenigen Händen aufhäufen, wodurch die Grundrenten sehr gewachsen und der Ackerbau (tillage) sehr verfallen, Kirchen und Häuser niedergerissen, wunderbare Volksmassen verunfähigt seien, sich selbst und Familien zu erhalten".	ch27_clean.en-ch27_clean.de
The Act, therefore, ordains the rebuilding of the decayed farmsteads, and fixes a proportion between corn land and pasture land, &c. An Act of 1533 recites that some owners possess 24, sheep, and limits the number to be owned to 2,000.	Das Gesetz verordnet daher den Wiederbau der verfallnen Hofstätten, bestimmt das Verhältnis zwischen Kornland und Weideland usw. Ein Akt von 1533 klagt, daß manche Eigentümer 24.000 Schafe besitzen, und beschränkt deren Zahl auf 2.000.	ch27_clean.en-ch27_clean.de
The cry of the people and the legislation directed, for 150 years after Henry VII., against the expropriation of the small farmers and peasants, were alike fruitless.	Die Volksklage und die seit Heinrich dem VII. an 150 Jahre fortdauernde Gesetzgebung wider die Expropriation der kleinen Pächter und Bauern waren gleich fruchtlos.	ch27_clean.en-ch27_clean.de
The secret of their inefficiency Bacon, without knowing it, reveals to us.	Das Geheimnis ihrer Erfolglosigkeit verrät uns Baco wider Wissen.	ch27_clean.en-ch27_clean.de
“The device of King Henry VII.,” says Bacon, in his “Essays, Civil and Moral,” Essay 29, “was profound and admirable, in making farms and houses of husbandry of a standard; that is, maintained with such a proportion of land unto them as may breed a subject to live in convenient plenty, and no servile condition, and to keep the plough in the hands of the owners and not mere hirelings.”	"Der Akt Heinrichs des Siebenten", sagt er in seinen "Essays, civil and moral", Sect. 29, "war tief und bewunderungswürdig, indem er Landwirtschaften und Ackerbauhäuser von bestimmtem Normalmaß schuf, d.h. eine Proportion von Land für sie erhielt, die sie befähigte, Untertanen von genügendem Reichtum und ohne servile Lage auf die Welt zu setzen und den Pflug in der Hand von Eigentümern, nicht von Mietlingen zu halten (to keep the plough in the hand of the owners and not hirelings).	ch27_clean.en-ch27_clean.de
What the capitalist system demanded was, on the other hand, a degraded and almost servile condition of the mass of the people, the transformation of them into mercenaries, and of their means of labour into capital.	"(193a) Was das kapitalistische System erheischte, war umgekehrt servile Lage der Volksmasse, ihre eigne Verwandlung in Mietlinge und Verwandlung ihrer Arbeitsmittel in Kapital.	ch27_clean.en-ch27_clean.de
During this transformation period, legislation also strove to retain the 4 acres of land by the cottage of the agricultural wage labourer, and forbad him to take lodgers into his cottage.	Während dieser Übergangsperiode suchte die Gesetzgebung auch die 4 Acres Land bei der Cottage des ländlichen Lohnarbeiters zu erhalten und verbot ihm die Aufnahme von Mietsleuten in seine Cottage.	ch27_clean.en-ch27_clean.de
In the reign of James I., 1627, Roger Crocker of Front Mill, was condemned for having built a cottage on the manor of Front Mill without 4 acres of land attached to the same in perpetuity. As late as Charles I.’s reign, 1638, a royal commission was appointed to enforce the carrying out of the old laws, especially that referring to the 4 acres of land.	Noch 1627, unter Karl I., wurde Roger Crocker von Fontmill verurteilt wegen Baus einer Cottage im Manor von Fontmill ohne 4 Acres Land als beständiges Annex an dieselbe; noch 1638, unter Karl I., wurde eine königliche Kommission ernannt, um die Durchführung der alten Gesetze, namentlich auch über die 4 Acres Land, zu erzwingen; noch Cromwell verbot Erbauung eines Hauses in 4 Meilen weitem Umkreis von London ohne Ausstattung desselben mit 4 Acres Land.	ch27_clean.en-ch27_clean.de
Even in Cromwell’s time, the building of a house within 4 miles of London was forbidden unless it was endowed with 4 acres of land.	Noch in der ersten Hälfte des 18. Jahrhunderts wird geklagt, wenn die Cottage des Landarbeiters kein Zubehör von l bis 2 Acres hat.	ch27_clean.en-ch27_clean.de
As late as the first half of the 18th century complaint is made if the cottage of the agricultural labourer has not an adjunct of one or two acres of land.		ch27_clean.en-ch27_clean.de
Nowadays he is lucky if it is furnished with a little garden, or if he may rent, far away from his cottage, a few roods.	Heutzutag ist er glücklich, wenn sie mit einem Gärtchen ausgestattet ist oder wenn er weitab von ihr ein Paar Ruten Land mieten kann.	ch27_clean.en-ch27_clean.de
“Landlords and farmers,” says Dr. Hunter, “work here hand in hand.	"Grundherren und Pächter", sagt Dr. Hunter, "handeln hier Hand in. Hand.	ch27_clean.en-ch27_clean.de
A few acres to the cottage would make the labourers too independent.”	Wenige Acres zur Cottage würden den Arbeiter zu unabhängig machen."	ch27_clean.en-ch27_clean.de
The process of forcible expropriation of the people received in the 16th century a new and frightful impulse from the Reformation, and from the consequent colossal spoliation of the church property.	Einen neuen furchtbaren Anstoß erhielt der gewaltsame Expropriationsprozeß der Volksmasse im 16. Jahrhundert durch die Reformation und, in ihrem Gefolge, den kolossalen Diebstahl der Kirchengüter.	ch27_clean.en-ch27_clean.de
The Catholic church was, at the time of the Reformation, feudal proprietor of a great part of the English land.	Die katholische Kirche war zur Zeit der Reformation Feudaleigentümerin eines großen Teils des englischen Grund und Bodens.	ch27_clean.en-ch27_clean.de
The suppression of the monasteries, &c., hurled their inmates into the proletariat.	Die Unterdrückung der Klöster usw. schleuderte deren Einwohner ins Proletariat.	ch27_clean.en-ch27_clean.de
The estates of the church were to a large extent given away to rapacious royal favourites, or sold at a nominal price to speculating farmers and citizens, who drove out, en masse, the hereditary sub-tenants and threw their holdings into one.	Die Kirchengüter selbst wurden großenteils an raubsüchtige königliche Günstlinge verschenkt oder zu einem Spottpreis an spekulierende Pächter und Stadtbürger verkauft, welche die alten erblichen Untersassen massenhaft verjagten und ihre Wirtschaften zusammenwarfen.	ch27_clean.en-ch27_clean.de
The legally guaranteed property of the poorer folk in a part of the church’s tithes was tacitly confiscated.	Das gesetzlich garantierte Eigentum verarmter Landleute an einem Teil der Kirchenzehnten ward stillschweigend konfisziert.	ch27_clean.en-ch27_clean.de
“Pauper ubique jacet,” cried Queen Elizabeth, after a journey through England.	"Pauper ubique jacet" <"der Arme ist überall unterjocht">, rief Königin Elisabeth nach einer Rundreise durch England.	ch27_clean.en-ch27_clean.de
In the 43rd year of her reign the nation was obliged to recognise pauperism officially by the introduction of a poor-rate.	Im 43. Jahre ihrer Regierung war man endlich gezwungen, den Pauperismus offiziell anzuerkennen durch Einführung der Armensteuer.	ch27_clean.en-ch27_clean.de
“The authors of this law seem to have been ashamed to state the grounds of it, for [contrary to traditional usage] it has no preamble whatever.”	"Die Urheber dieses Gesetzes schämten sich, seine Gründe auszusprechen, und schickten es daher, wider alles Herkommen, ohne irgendein preamble (Eingangsmotivierung) in die Welt."	ch27_clean.en-ch27_clean.de
By the 16th of Charles I., ch.	Durch 16. Car.	ch27_clean.en-ch27_clean.de
4, it was declared perpetual, and in fact only in 1834 did it take a new and harsher form.	I., 4 <4. Gesetz aus dem 16. Regierungsjahr Karl I.> wurde es perpetuell erklärt und erhielt in der Tat erst 1834 eine neue härtere Form.	ch27_clean.en-ch27_clean.de
These immediate results of the Reformation were not its most lasting ones.	Diese unmittelbaren Wirkungen der Reformation waren nicht ihre nachhaltigsten.	ch27_clean.en-ch27_clean.de
The property of the church formed the religious bulwark of the traditional conditions of landed property.	Das Kircheneigentum bildete das religiöse Bollwerk der altertümlichen Grundeigentumsverhältnisse.	ch27_clean.en-ch27_clean.de
With its fall these were no longer tenable.	Mit seinem Fall waren sie nicht länger haltbar.	ch27_clean.en-ch27_clean.de
Even in the last decade of the 17th century, the yeomanry, the class of independent peasants, were more numerous than the class of farmers.	Noch in den letzten Dezennien des 17. Jahrhunderts war die Yeomanry, eine unabhängige Bauerschaft, zahlreicher als die Klasse der Pächter.	ch27_clean.en-ch27_clean.de
They had formed the backbone of Cromwell’s strength, and, even according to the confession of Macaulay, stood in favourable contrast to the drunken squires and to their servants, the country clergy, who had to marry their masters’ cast-off mistresses.	Sie hatte die Hauptstärke Cromwells gebildet und stand, selbst nach Macaulays Geständnis, in vorteilhaftem Gegensatz zu den versoffen Mistjunkern und ihren Bedienten, den Landpfaffen, welche die herrschaftliche "Lieblingsmagd" unter die Haube bringen mußten.	ch27_clean.en-ch27_clean.de
	Noch waren selbst die ländlichen Lohnarbeiter Mitbesitzer am Gemeindeeigentum.	ch27_clean.en-ch27_clean.de
About 1750, the yeomanry had disappeared, and so had, in the last decade of the 18th century, the last trace of the common land of the agricultural labourer.	1750 ungefähr war die Yeomanry verschwunden , und in den letzten Dezennien des 18. Jahr- hunderts die letzte Spur von Gemeindeeigentum der Ackerbauer.	ch27_clean.en-ch27_clean.de
We leave on one side here the purely economic causes of the agricultural revolution.	Wir sehn hier ab von den rein ökonomischen Triebfedern der Agrikulturrevolution.	ch27_clean.en-ch27_clean.de
We deal only with the forcible means employed.	Wir fragen nach ihren gewaltsamen Hebeln.	ch27_clean.en-ch27_clean.de
After the restoration of the Stuarts, the landed proprietors carried, by legal means, an act of usurpation, effected everywhere on the Continent without any legal formality.	Unter der Restauration der Stuarts setzten die Grundeigentümer eine Usurpation gesetzlich durch, die sich überall auf dem Kontinent auch ohne gesetzliche Weitläufigkeit vollzog.	ch27_clean.en-ch27_clean.de
They abolished the feudal tenure of land, i.e., they got rid of all its obligations to the State, “indemnified” the State by taxes on the peasantry and the rest of the mass of the people, vindicated for themselves the rights of modern private property in estates to which they had only a feudal title, and, finally, passed those laws of settlement, which, mutatis mutandis, had the same effect on the English agricultural labourer, as the edict of the Tartar Boris Godunof on the Russian peasantry.	Sie hoben die Feudalverfassung des Bodens auf, d.h., sie schüttelten seine Leistungspflichten an den Staat ab, "entschädigten" den Staat durch Steuern auf die Bauerschaft und übrige Volksmasse, vindizierten modernes Privateigentum an Gütern, worauf sie nur Feudaltitel besaßen, und oktroyierten schließlich jene Niederlassungsgesetze (laws of settlement), die, mutatis mutandis, auf die englischen Ackerbauer wirkten wie des Tataren Boris Godunow Edikt auf die russische Bauerschaft.	ch27_clean.en-ch27_clean.de
The “glorious Revolution” brought into power, along with William of Orange, the landlord and capitalist appropriators of surplus-value.	Die "glorious Revolution" (glorreiche Revolution) brachte mit dem Oranier Wilhelm III. die grundherrlichen und kapitalistischen Plusmacher zur Herrschaft.	ch27_clean.en-ch27_clean.de
They inaugurated the new era by practising on a colossal scale thefts of state lands, thefts that had been hitherto managed more modestly.	Sie weihten die neue Ära ein, indem sie den bisher nur bescheiden betriebenen Diebstahl an den Staatsdomänen auf kolossaler Stufenleiter ausübten.	ch27_clean.en-ch27_clean.de
These estates were given away, sold at a ridiculous figure, or even annexed to private estates by direct seizure.	Diese Ländereien wurden verschenkt, zu Spottpreisen verkauft oder auch durch direkte Usurpation an Privatgüter annexiert.	ch27_clean.en-ch27_clean.de
All this happened without the slightest observation of legal etiquette.	Alles das geschah ohne die geringste Beobachtung gesetzlicher Etikette.	ch27_clean.en-ch27_clean.de
The Crown lands thus fraudulently appropriated, together with the robbery of the Church estates, as far as these had not been lost again during the republican revolution, form the basis of the today princely domains of the English oligarchy.	Das so fraudulent angeeignete Staatsgut samt dem Kirchenraub, soweit er während der republikanischen Revolution nicht abhanden gekommen, bildet die Grundlage der heutigen fürstlichen Domänen der englischen Oligarchie.	ch27_clean.en-ch27_clean.de
The bourgeois capitalists favoured the operation with the view, among others, to promoting free trade in land, to extending the domain of modern agriculture on the large farm-system, and to increasing their supply of the free agricultural proletarians ready to hand. Besides, the new landed aristocracy was the natural ally of the new bankocracy, of the newly-hatched haute finance, and of the large manufacturers, then depending on protective duties.	Die bürgerlichen Kapitalisten begünstigten die Operation, u.a. um den Grund und Boden in einen reinen Handelsartikel zu verwandeln, das Gebiet des agrikolen Großbetriebs auszudehnen, ihre Zufuhr vogelfreier Proletarier vom Lande zu vermehren usw. Zudem war die neue Grundaristokratie die natürliche Bundesgenossin der neuen Bankokratie, der eben aus dem Ei gekrochnen hohen Finanz und der damals auf Schutzzölle sich stützenden großen Manufakturisten.	ch27_clean.en-ch27_clean.de
The English bourgeoisie acted for its own interest quite as wisely as did the Swedish bourgeoisie who, reversing the process, hand in hand with their economic allies, the peasantry, helped the kings in the forcible resumption of the Crown lands from the oligarchy. This happened since 1604 under Charles X. and Charles XI.	Die englische Bourgeoisie handelte für ihr Interesse ganz so richtig wie die schwedischen Stadtbürger, die umgekehrt, Hand in Hand mit ihrem ökonomischen Bollwerk, der Bauerschaft, die Könige in der gewaltsamen Resumption der Kronländereien von der Oligarchie (seit 1604, später unter Karl X. und Karl XI.) unterstützten.	ch27_clean.en-ch27_clean.de
Communal property – always distinct from the State property just dealt with – was an old Teutonic institution which lived on under cover of feudalism.	Das Gemeindeeigentum - durchaus verschieden von dem eben betrachteten Staatseigentum - war eine altgermanische Einrichtung, die unter der Decke der Feudalität fortlebte.	ch27_clean.en-ch27_clean.de
We have seen how the forcible usurpation of this, generally accompanied by the turning of arable into pasture land, begins at the end of the 15th and extends into the 16th century.	Man hat gesehn, wie die gewaltsame Usurpation desselben, meist begleitet von Verwandlung des Ackerlands in Viehweide, Ende des 15. Jahrhunderts beginnt und im 16. Jahrhundert fortdauert.	ch27_clean.en-ch27_clean.de
But, at that time, the process was carried on by means of individual acts of violence against which legislation, for a hundred and fifty years, fought in vain.	Aber damals vollzog sich der Prozeß als individuelle Gewalttat, wogegen die Gesetzgebung 150 Jahre lang vergeblich ankämpft.	ch27_clean.en-ch27_clean.de
The advance made by the 18th century shows itself in this, that the law itself becomes now the instrument of the theft of the people’s land, although the large farmers make use of their little independent methods as well.	Der Fortschritt des 18. Jahrhunderts offenbart sich darin, daß das Gesetz selbst jetzt zum Vehikel des Raubs am Volksland wird, obgleich die großen Pächter nebenbei auch ihre kleinen unabhängigen Privatmethoden anwenden.	ch27_clean.en-ch27_clean.de
The parliamentary form of the robbery is that of Acts for enclosures of Commons, in other words, decrees by which the landlords grant themselves the people’s land as private property, decrees of expropriation of the people.	Die parlamentarische Form des Raubs ist die der "Bills for Inclosures of Commons" (Gesetze für Einhegung des Gemeindelandes), in andren Worten Dekrete, wodurch die Grundherrn Volksland sich selbst als Privateigentum schenken, Dekrete der Volksexpropriation.	ch27_clean.en-ch27_clean.de
Sir F. M. Eden refutes his own crafty special pleading, in which he tries to represent communal property as the private property of the great landlords who have taken the place of the feudal lords, when he, himself, demands a “general Act of Parliament for the enclosure of Commons” (admitting thereby that a parliamentary coup d’état is necessary for its transformation into private property), and moreover calls on the legislature for the indemnification for the expropriated poor.	Sir F. M. Eden widerlegt sein pfiffiges Advokatenplädoyer, worin er das Gemeindeeigentum als Privateigentum der an die Stelle der Feudalen getretenen großen Grundeigentümer darzustellen sucht, indem er selbst einen "allgemeinen Parlamentsakt für Einhegung der Gemeindeländereien" verlangt, also zugibt, daß ein parlamentarischer Staatsstreich zu ihrer Verwandlung in Privateigentum nötig ist, andrerseits aber von der Legislatur "Schadensersatz" für die expropriierten Armen fordert.	ch27_clean.en-ch27_clean.de
Whilst the place of the independent yeoman was taken by tenants at will, small farmers on yearly leases, a servile rabble dependent on the pleasure of the landlords, the systematic robbery of the Communal lands helped especially, next to the theft of the State domains, to swell those large farms, that were called in the 18th century capital farms or merchant farms, and to “set free” the agricultural population as proletarians for manufacturing industry.	Während an die Stelle der unabhängigen Yeomen tenants-at-will traten, kleinere Pächter auf einjährige Kündigung, eine servile und von der Willkür der Landlords abhängige Rotte, half, neben dem Raub der Staatsdomänen, namentlich der systematisch betriebne Diebstahl des Gemeindeeigentums jene großen Pachten anschwellen, die man im 18. Jahrhundert Kapital-Pachten oder Kaufmanns-Pachten nannte, und das Landvolk als Proletariat für die Industrie "freisetzen".	ch27_clean.en-ch27_clean.de
The 18th century, however, did not yet recognise as fully as the 19th, the identity between national wealth and the poverty of the people.	Das 18. Jahrhundert begriff jedoch noch nicht in demselben Maß wie das 19. die Identität zwischen Nationalreichtum und Volksarmut.	ch27_clean.en-ch27_clean.de
Hence the most vigorous polemic, in the economic literature of that time, on the “enclosure of commons.”	Daher heftigste Polemik in der ökonomischen Literatur jener Zeit über die "inclosure of commons".	ch27_clean.en-ch27_clean.de
From the mass of materials that lie before me, I give a few extracts that will throw a strong light on the circumstances of the time.	Ich gebe aus dem massenhaften Material, das mir vorliegt, einige wenige Stellen, weil dadurch lebhaft die Zustände veranschaulicht werden.	ch27_clean.en-ch27_clean.de
“In several parishes of Hertfordshire,” writes one indignant person, “ farms, numbering on the average 50- acres, have been melted up into three farms.”	"In vielen Pfarreien von Hertfordshire", schreibt eine entrüstete Feder, "sind 24 im Durchschnitt 50-150 Acres zählende Pachten in 3 Pachten zusammengeschmolzen."	ch27_clean.en-ch27_clean.de
“In Northamptonshire and Leicestershire the enclosure of common lands has taken place on a very large scale, and most of the new lordships, resulting from the enclosure, have been turned into pasturage, in consequence of which many lordships have not now 50 acres ploughed yearly, in which 1, were ploughed formerly.	"In Northamptonshire und Lincolnshire hat die Einhegung der Gemeindeländereien sehr vorgeherrscht und die meisten aus den Einhegungen entsprungnen neuen Lordschaften sind in Weide verwandelt; infolge davon haben viele Lordschaften jetzt nicht 50 Acres unter dem Pflug, wo früher 1.500 gepflügt wurden ...	ch27_clean.en-ch27_clean.de
The ruins of former dwelling-houses, barns, stables, &c.,” are the sole traces of the former inhabitants.	Ruinen früherer Wohnhäuser, Scheunen, Ställe usw." sind die einzigen Spuren der früheren Einwohner.	ch27_clean.en-ch27_clean.de
“An hundred houses and families have in some open-field villages dwindled to eight or ten....	"Hundert Häuser und Familien sind an manchen Plätzen zusammengeschrumpft ... auf 8 oder 10 ...	ch27_clean.en-ch27_clean.de
The landholders in most parishes that have been enclosed only 15 or 20 years, are very few in comparison of the numbers who occupied them in their open-field state.	Der Grundeigentümer in den meisten Pfarreien, wo die Einhegung erst seit 15 oder 20 Jahren vorging, sind sehr wenige in Vergleich zu den Zahlen, von denen das Land im offnen Feldzustand bebaut wurde.	ch27_clean.en-ch27_clean.de
It is no uncommon thing for 4 or 5 wealthy graziers to engross a large enclosed lordship which was before in the hands of 20 or 30 farmers, and as many smaller tenants and proprietors.	Es ist nichts Ungewöhnliches, 4 oder 5 reiche Viehmäster große, jüngst eingehegte Lordschaften usurpieren zu sehn, die sich früher in der Hand von 20-30 Pächtern und von ebenso vielen kleineren Eigentümern und Insassen befanden.	ch27_clean.en-ch27_clean.de
All these are hereby thrown out of their livings with their families and many other families who were chiefly employed and supported by them.”	Alle diese sind mit ihren Familien aus ihrem Besitztum herausgeworfen nebst vielen andren Familien, die durch sie beschäftigt und erhalten wurden."	ch27_clean.en-ch27_clean.de
It was not only the land that lay waste, but often land cultivated either in common or held under a definite rent paid to the community, that was annexed by the neighbouring landlords under pretext of enclosure.	Es war nicht nur brachliegendes, sondern oft, unter bestimmter Zahlung an die Gemeinde, oder gemeinschaftlich, bebautes Land, das unter dem Vorwand der Einhegung vom angrenzenden Landlord annexiert wurde.	ch27_clean.en-ch27_clean.de
“I have here in view enclosures of open fields and lands already improved.	"Ich spreche hier vom Einschluß offner Felder und Ländereien, die bereits bebaut sind.	ch27_clean.en-ch27_clean.de
It is acknowledged by even the writers in defence of enclosures that these diminished villages increase the monopolies of farms, raise the prices of provisions, and produce depopulation ... and even the enclosure of waste lands (as now carried on) bears hard on the poor, by depriving them of a part of their subsistence, and only goes towards increasing farms already too large.”	Selbst die Schriftsteller, welche die Inclosures verteidigen, geben zu, daß letztre das Monopol großer Pachtungen vermehren, die Preise der Lebensmittel erhöhen und Entvölkerung produzieren ... und selbst die Einhegung wüster Ländereien, wie jetzt betrieben, raubt dem Armen einen Teil seiner Subsistenzmittel und schwellt Pachtungen auf, die bereits zu groß sind."	ch27_clean.en-ch27_clean.de
“When,” says Dr. Price, “this land gets into the hands of a few great farmers, the consequence must be that the little farmers” (earlier designated by him “a multitude of little proprietors and tenants, who maintain themselves and families by the produce of the ground they occupy by sheep kept on a common, by poultry, hogs, &c., and who therefore have little occasion to purchase any of the means of subsistence”) “will be converted into a body of men who earn their subsistence by working for others, and who will be under a necessity of going to market for all they want....	"Wenn", sagt Dr. Price, "das Land in die Hände einiger weniger großen Pächter gerät, werden die kleinen Pächter" (früher von ihm bezeichnet als "eine Menge kleiner Eigentümer und Pächter, die sich selbst und Familien erhalten durch das Produkt des von ihnen bestellten Landes, durch Schafe, Geflügel, Schweine usw., die sie auf das Gemeindeland schicken, so daß sie wenig Anlaß zum Kauf von Subsistenzmitteln haben") "verwandelt in Leute, die ihre Subsistenz durch Arbeit für andre gewinnen müssen und gezwungen sind, für alles, was sie brauchen, zu Markt zu gehen ...	ch27_clean.en-ch27_clean.de
There will, perhaps, be more labour, because there will be more compulsion to it....	Es wird vielleicht mehr Arbeit verrichtet, weil mehr Zwang dazu herrscht ...	ch27_clean.en-ch27_clean.de
Towns and manufactures will increase, because more will be driven to them in quest of places and employment.	Städte und Manufakturen werden wachsen, weil mehr Leute zu ihnen verjagt werden, welche Beschäftigung suchen.	ch27_clean.en-ch27_clean.de
This is the way in which the engrossing of farms naturally operates.	Dies ist der Weg, worin die Konzentration der Pachtungen naturgemäß wirkt und worin sie, seit vielen Jahren, in diesem Königreich tatsächlich gewirkt hat."	ch27_clean.en-ch27_clean.de
And this is the way in which, for many years, it has been actually operating in this kingdom.” He sums up the effect of the enclosures thus: “Upon the whole, the circumstances of the lower ranks of men are altered in almost every respect for the worse. From little occupiers of land, they are reduced to the state of day-labourers and hirelings; and, at the same time, their subsistence in that state has become more difficult.”	Er faßt die Gesamtwirkung der inclosures so zusammen: "Im ganzen hat sich die Lage der niederen Volksklassen fast in jeder Hinsicht verschlechtert, die kleineren Grundbesitzer und Pächter sind herabgedrückt auf den Stand von Taglöhnern und Mietlingen; und zur selben Zeit ist der Lebensgewinn in diesem Zustand schwieriger geworden."	ch27_clean.en-ch27_clean.de
In fact, usurpation of the common lands and the revolution in agriculture accompanying this, told so acutely on the agricultural labourers that, even according to Eden, between 1765 and 1780, their wages began to fall below the minimum, and to be supplemented by official poor-law relief.	In der Tat wirkten Usurpation des Gemeindelands und die sie begleitende Revolution der Agrikultur so akut auf die Ackerbauarbeiter, daß, nach Eden selbst, zwischen 1765 und 1780 ihr Lohn anfing, unter das Minimum zu fallen und durch offizielle Armenunterstützung ergänzt zu werden.	ch27_clean.en-ch27_clean.de
Their wages, he says, “were not more than enough for the absolute necessaries of life.”	Ihr Arbeitslohn, sagt er, "genügte nur noch eben für die absoluten Lebensbedürfnisse".	ch27_clean.en-ch27_clean.de
Let us hear for a moment a defender of enclosures and an opponent of Dr. Price.	Hören wir noch einen Augenblick einen Verteidiger der enclosures und Gegner des Dr. Price.	ch27_clean.en-ch27_clean.de
“Not is it a consequence that there must be depopulation, because men are not seen wasting their labour in the open field....	"Es ist kein richtiger Schluß, daß Entvölkerung vorhanden, weil man Leute nicht länger ihre Arbeit im offnen Feld verschwenden sieht ...	ch27_clean.en-ch27_clean.de
If, by converting the little farmers into a body of men who must work for others, more labour is produced, it is an advantage which the nation” (to which, of course, the “converted” ones do not belong) “should wish for ... the produce being greater when their joint labours are employed on one farm, there will be a surplus for manufactures, and by this means manufactures, one of the mines of the nation, will increase, in proportion to the quantity of corn produced.”	Wenn nach Verwandlung kleiner Bauern in Leute, die für andre arbeiten müssen, mehr Arbeit flüssig gemacht wird, so ist das ja ein Vorteil, den die Nation" (wozu die Verwandelten natürlich nicht gehören) "wünschen muß ... Das Produkt wird größer sein, wenn ihre kombinierte Arbeit auf einer Pachtung angewandt wird: so wird Surplusprodukt für die Manufakturen gebildet, und dadurch werden Manufakturen, eine der Goldgruben dieser Nation, im Verhältnis zum produzierten Kornquantum vermehrt."	ch27_clean.en-ch27_clean.de
The stoical peace of mind with which the political economist regards the most shameless violation of the “sacred rights of property” and the grossest acts of violence to persons, as soon as they are necessary to lay the foundations of the capitalistic mode of production, is shown by Sir F. M. Eden, philanthropist and tory to boot.	Die stoische Seelenruhe, womit der politische Ökonom frechste Schändung des "heiligen Rechts des Eigentums" und gröbste Gewalttat wider Personen betrachtet, sobald sie erheischt sind, um die Grundlage der kapitalistischen Produktionsweise herzustellen, zeigt uns u.a. der überdem noch torystisch gefärbte und "philanthropische" Sir F. M. Eden.	ch27_clean.en-ch27_clean.de
The whole series of thefts, outrages, and popular misery, that accompanied the forcible expropriation of the people, from the last third of the 15th to the end of the 18th century, lead him merely to the comfortable conclusion: “The due proportion between arable land and pasture had to be established.	Die ganze Reihe von Raubtaten, Greueln und Volksdrangsalen, welche die gewaltsame Volksexpropriation vom letzten Drittel des 15. bis zum Ende des 18. Jahrhunderts begleiten, treibt ihn nur zur "komfortablen" Schlußreflexion: "Die richtige (due) Proportion zwischen Acker- und Viehland mußte hergestellt werden.	ch27_clean.en-ch27_clean.de
During the whole of the 14th and the greater part of the 15th century, there was one acre of pasture to 2, 3, and even 4 of arable land.	Noch im ganzen 14. und größten Teil des 15. Jahrhunderts kam 1 Acre Viehweide auf 2, 3 und selbst 4 Acres Ackerland.	ch27_clean.en-ch27_clean.de
About the middle of the 16th century the proportion was changed of 2 acres of pasture to 2, later on, of 2 acres of pasture to one of arable, until at last the just proportion of 3 acres of pasture to one of arable land was attained.”	In Mitte des 16. Jahrhunderts verwandelte sich die Proportion in 2 Acres Viehland auf 2, später von 2 Acres Viehweide auf 1 Acre Ackerland, bis endlich die richtige Proportion von 3 Acres Viehland auf 1 Acre Ackerland herauskam."	ch27_clean.en-ch27_clean.de
In the 19th century, the very memory of the connexion between the agricultural labourer and the communal property had, of course, vanished.	Im 19. Jahrhundert verlor sich natürlich selbst die Erinnerung des Zusammenhangs zwischen Ackerbauer und Gemeindeeigentum.	ch27_clean.en-ch27_clean.de
To say nothing of more recent times, have the agricultural population received a farthing of compensation for the 3,511, acres of common land which between 1801 and 1831 were stolen from them and by parliamentary devices presented to the landlords by the landlords?	Von späterer Zeit gar nicht zu reden, welchen Farthing Ersatz erhielt das Landvolk jemals für die 3.511.770 Acres Gemeindeland, die ihm zwischen 1810 und 1831 geraubt und parlamentarisch den Landlords von den Landlords geschenkt wurden?	ch27_clean.en-ch27_clean.de
The last process of wholesale expropriation of the agricultural population from the soil is, finally, the so-called clearing of estates, i.e., the sweeping men off them.	Der letzte große Expropriationsprozeß der Ackerbauer von Grund und Boden endlich ist das sog. Clearing of Estates (Lichten der Güter, in der Tat Wegfegung der Menschen von denselben).	ch27_clean.en-ch27_clean.de
All the English methods hitherto considered culminated in “clearing.”	Alle bisher betrachteten englischen Methoden kulminierten im "Lichten".	ch27_clean.en-ch27_clean.de
As we saw in the picture of modern conditions given in a former chapter, where there are no more independent peasants to get rid of, the “clearing” of cottages begins; so that the agricultural labourers do not find on the soil cultivated by them even the spot necessary for their own housing.	Wie man bei der Schilderung des modernen Zustands im vorigen Abschnitt sah, geht es jetzt, wo keine unabhängigen Bauern mehr wegzufegen sind, bis zum "Lichten" der Cottages fort, so daß die Ackerbauarbeiter auf dem von ihnen bestellten Boden selbst nicht mehr den nötigen Raum zur eignen Behausung finden.	ch27_clean.en-ch27_clean.de
But what “clearing of estates” really and properly signifies, we learn only in the promised land of modern romance, the Highlands of Scotland.	Was aber "Clearing of Estates" im eigentlichen Sinne bedeutet, das lernen wir nur kennen im gelobten Lande der modernen Romanliteratur, in Hochschottland.	ch27_clean.en-ch27_clean.de
There the process is distinguished by its systematic character, by the magnitude of the scale on which it is carried out at one blow (in Ireland landlords have gone to the length of sweeping away several villages at once; in Scotland areas as large as German principalities are dealt with), finally by the peculiar form of property, under which the embezzled lands were held.	Dort zeichnet sich der Vorgang aus durch seinen systematischen Charakter, durch die Größe der Stufenleiter, worauf er mit einem Schlag vollzogen wird (in Irland haben Grundherrn es dahin gebracht, mehrere Dörfer gleichzeitig wegzufegen; in Hochschottland handelt es sich um Bodenflächen von der Größe deutscher Herzogtümer) - und endlich durch die besondre Form des unterschlagenen Grundeigentums.	ch27_clean.en-ch27_clean.de
The Highland Celts were organised in clans, each of which was the owner of the land on which it was settled.	Die Kelten Hochschottlands bestanden aus Clans, deren jeder Eigentümer des von ihm besiedelten Bodens war.	ch27_clean.en-ch27_clean.de
The representative of the clan, its chief or “great man,” was only the titular owner of this property, just as the Queen of England is the titular owner of all the national soil.	Der Repräsentant des Clans, sein Chef oder "großer Mann", war nur Titulareigentümer dieses Bodens, ganz wie die Königin von England Titulareigentümerin des nationalen Gesamtbodens ist.	ch27_clean.en-ch27_clean.de
When the English government succeeded in suppressing the intestine wars of these “great men,” and their constant incursions into the Lowland plains, the chiefs of the clans by no means gave up their time-honoured trade as robbers; they only changed its form.	Als der englischen Regierung gelungen war, die inneren Kriege dieser "großen Männer" und ihre fortwährenden Einfälle in die niederschottischen Ebenen zu unterdrücken, gaben die Clanchefs ihr altes Räuberhandwerk keineswegs auf; sie änderten nur die Form.	ch27_clean.en-ch27_clean.de
On their own authority they transformed their nominal right into a right of private property, and as this brought them into collision with their clansmen, resolved to drive them out by open force.	Aus eigner Autorität verwandelten sie ihr Titular-Eigentumsrecht in Privateigentumsrecht, und da sie bei den Clanleuten auf Widerstand stießen, beschlossen sie, diese mit offner Gewalt zu vertreiben.	ch27_clean.en-ch27_clean.de
“A king of England might as well claim to drive his subjects into the sea,” says Professor Newman.	"Ein König von England könnte mit demselben Recht sich anmaßen, seine Untertanen in die See zu jagen", sagt Professor Newman.	ch27_clean.en-ch27_clean.de
This revolution, which began in Scotland after the last rising of the followers of the Pretender, can be followed through its first phases in the writings of Sir James Steuart and James Anderson.	Diese Revolution, welche in Schottland nach der letzten Schilderhebung des Prätendenten begann, kann man in ihren ersten Phasen verfolgen bei Sir James Steuart und James Anderson .	ch27_clean.en-ch27_clean.de
In the 18th century the hunted-out Gaels were forbidden to emigrate from the country, with a view to driving them by force to Glasgow and other manufacturing towns.	Im 18. Jahrhundert wurde zugleich den vom Land verjagten Gaelen die Auswanderung verboten, um sie gewaltsam nach Glasgow und andren Fabrikstädten zu treiben.	ch27_clean.en-ch27_clean.de
As an example of the method obtaining in the 19th century, the “clearing” made by the Duchess of Sutherland will suffice here.	Als Beispiel der im 19. Jahrhundert herrschenden Methode genügen hier die "Lichtungen" der Herzogin von Suther- land.	ch27_clean.en-ch27_clean.de
This person, well instructed in economy, resolved, on entering upon her government, to effect a radical cure, and to turn the whole country, whose population had already been, by earlier processes of the like kind, reduced to 15,000, into a sheep-walk.	Diese ökonomisch geschulte Person beschloß gleich bei ihrem Regierungsantritt eine ökonomische Radikalkur vorzunehmen und die ganze Grafschaft, deren Einwohnerschaft durch frühere, ähnliche Prozesse bereits auf 15.000 zusammengeschmolzen war, in Schaftrift zu verwandeln.	ch27_clean.en-ch27_clean.de
From 1814 to 1820 these 15, inhabitants, about 3, families, were systematically hunted and rooted out.	Von 1814 bis 1820 wurden diese 15.000 Einwohner, ungefähr 3.000 Familien, systematisch verjagt und ausgerottet.	ch27_clean.en-ch27_clean.de
All their villages were destroyed and burnt, all their fields turned into pasturage.	Alle ihre Dörfer wurden zerstört und niedergebrannt, alle ihre Felder in Weide verwandelt.	ch27_clean.en-ch27_clean.de
British soldiers enforced this eviction, and came to blows with the inhabitants.	Britische Soldaten wurden zur Exekution kommandiert und kamen zu Schlägen mit den Eingebornen.	ch27_clean.en-ch27_clean.de
One old woman was burnt to death in the flames of the hut, which she refused to leave.	Eine alte Frau verbrannte in den Flammen der Hütte, die sie zu verlassen sich weigerte.	ch27_clean.en-ch27_clean.de
Thus this fine lady appropriated 794, acres of land that had from time immemorial belonged to the clan.	So eignete sich diese Madame 794.000 Acres Land an, das seit undenklichen Zeiten dem Clan gehörte.	ch27_clean.en-ch27_clean.de
She assigned to the expelled inhabitants about 6, acres on the sea-shore – 2 acres per family.	Den vertriebnen Eingebornen wies sie am Seegestad ungefähr 6.000 Acres zu, 2 Acres per Familie.	ch27_clean.en-ch27_clean.de
The 6, acres had until this time lain waste, and brought in no income to their owners.	Die 6.000 Acres hatten bisher wüst gelegen und den Eigentümern kein Einkommen abgeworfen.	ch27_clean.en-ch27_clean.de
The Duchess, in the nobility of her heart, actually went so far as to let these at an average rent of 2s.	Die Herzogin ging in ihrem Nobelgefühl so weit, den Acre im Durchschnitt zu 2 sh.	ch27_clean.en-ch27_clean.de
6d. per acre to the clansmen, who for centuries had shed their blood for her family.	6 d. Rente zu verpachten an die Clanleute, die seit Jahrhunderten ihr Blut für die Familie vergossen hatten.	ch27_clean.en-ch27_clean.de
The whole of the stolen clanland she divided into 29 great sheep farms, each inhabited by a single family, for the most part imported English farm-servants.	Das ganze geraubte Clanland teilte sie in 29 große Schafpachtungen, jede bewohnt von einer einzigen Familie, meist englische Pächterknechte.	ch27_clean.en-ch27_clean.de
In the year 1835 the 15, Gaels were already replaced by 131, sheep.	Im Jahre 1825 waren die 15.000 Gaelen bereits ersetzt durch 131.000 Schafe.	ch27_clean.en-ch27_clean.de
The remnant of the aborigines flung on the sea-shore tried to live by catching fish.	Der an das Seegestad geworfne Teil der Aborigines <Eingeborenen> suchte vom Fischfang zu leben.	ch27_clean.en-ch27_clean.de
They became amphibious and lived, as an English author says, half on land and half on water, and withal only half on both.	Sie wurden Amphibien und lebten, wie ein englischer Schriftsteller sagt, halb auf dem Land und halb auf dem Wasser und lebten mit alledem nur halb von beiden.	ch27_clean.en-ch27_clean.de
But the brave Gaels must expiate yet more bitterly their idolatry, romantic and of the mountains, for the “great men” of the clan.	Aber die braven Gaelen sollten noch schwerer ihre bergromantische Idolatrie für die "großen Männer" des Clans abbüßen.	ch27_clean.en-ch27_clean.de
The smell of their fish rose to the noses of the great men.	Der Fischgeruch stieg den großen Männern in die Nase.	ch27_clean.en-ch27_clean.de
They scented some profit in it, and let the sea-shore to the great fishmongers of London.	Sie witterten etwas Profitliches dahinter und verpachteten das Seegestade den großen Fischhändlern von London.	ch27_clean.en-ch27_clean.de
For the second time the Gaels were hunted out.	Die Gaelen wurden zum zweitenmal verjagt.	ch27_clean.en-ch27_clean.de
But, finally, part of the sheep-walks are turned into deer preserves.	Endlich aber wird ein Teil der Schaftriften rückverwandelt in Jagdrevier.	ch27_clean.en-ch27_clean.de
Every one knows that there are no real forests in England.	Man weiß, daß es keine eigentlichen Wälder in England gibt.	ch27_clean.en-ch27_clean.de
The deer in the parks of the great are demurely domestic cattle, fat as London aldermen.	Das Wild in den Parks der Großen ist konstitutionelles Hausvieh, fett wie Londoner Aldermen.	ch27_clean.en-ch27_clean.de
Scotland is therefore the last refuge of the “noble passion.”	Schottland ist daher das letzte Asyl der "noblen Passion".	ch27_clean.en-ch27_clean.de
“In the Highlands,” says Somers in 1848, “new forests are springing up like mushrooms.	"In den Hochlanden", sagt Somers 1848, "sind die Waldungen sehr ausgedehnt worden.	ch27_clean.en-ch27_clean.de
Here, on one side of Gaick, you have the new forest of Glenfeshie; and there on the other you have the new forest of Ardverikie.	Hier auf der einen Seite von Gaick habt ihr den neuen Wald von Glenfeshie und dort auf der andren Seite den neuen Wald von Ardverikie.	ch27_clean.en-ch27_clean.de
In the same line you have the Black Mount, an immense waste also recently erected.	In derselben Linie habt ihr den Bleak-Mount, eine ungeheure Wüste, neulich errichtet.	ch27_clean.en-ch27_clean.de
From east to west – from the neighbourhood of Aberdeen to the crags of Oban – you have now a continuous line of forests; while in other parts of the Highlands there are the new forests of Loch Archaig, Glengarry, Glenmoriston, &c.	Von Ost zu West, von der Nachbarschaft von Aberdeen bis zu den Klippen von Oban, habt ihr jetzt eine fortlaufende Waldlinie, während sich in andren Teilen der Hochlande die neuen Wälder von Loch Archaig, Glengarry, Glenmoriston etc. befinden ...	ch27_clean.en-ch27_clean.de
Sheep were introduced into glens which had been the seats of communities of small farmers; and the latter were driven to seek subsistence on coarser and more sterile tracks of soil.	Die Verwandlung ihres Landes in Schafweide ... trieb die Gaelen auf unfruchtbarern Boden.	ch27_clean.en-ch27_clean.de
Now deer are supplanting sheep; and these are once more dispossessing the small tenants, who will necessarily be driven down upon still coarser land and to more grinding penury.	Jetzt fängt Rotwild an, das Schaf zu ersetzen, und treibt jene in noch zermalmenderes Elend ...	ch27_clean.en-ch27_clean.de
Deer-forests and the people cannot co-exist.	Die Wildwaldungen (219a) und das Volk können nicht nebeneinander existieren.	ch27_clean.en-ch27_clean.de
One or other of the two must yield.	Eins oder das andre muß jedenfalls den Platz räumen.	ch27_clean.en-ch27_clean.de
Let the forests be increased in number and extent during the next quarter of a century, as they have been in the last, and the Gaels will perish from their native soil...	Laßt die Jagden in Zahl und Umfang im nächsten Vierteljahrhundert wachsen wie im vergangenen, und ihr werdet keinen Gaelen mehr auf seiner heimischen Erde finden.	ch27_clean.en-ch27_clean.de
This movement among the Highland proprietors is with some a matter of ambition... with some love of sport... while others, of a more practical cast, follow the trade in deer with an eye solely to profit.	Diese Bewegung unter den Hochlands-Eigentümern ist teils der Mode geschuldet, aristokratischem Kitzel, Jagdliebhaberei usw., teils aber betreiben sie den Wildhandel ausschließlich mit einem Auge auf den Profit.	ch27_clean.en-ch27_clean.de
For it is a fact, that a mountain range laid out in forest is, in many cases, more profitable to the proprietor than when let as a sheep-walk. ...	Denn es ist Tatsache, daß ein Stuck Bergland, in Jagdung angelegt, in vielen Fällen ungleich profitabler ist denn als Schaftrift ...	ch27_clean.en-ch27_clean.de
The huntsman who wants a deer-forest limits his offers by no other calculation than the extent of his purse....	Der Liebhaber, der ein Jagdrevier sucht, beschränkt sein Angebot nur durch die Weite seiner Börse ...	ch27_clean.en-ch27_clean.de
Sufferings have been inflicted in the Highlands scarcely less severe than those occasioned by the policy of the Norman kings.	Leiden sind über die Hochlande verhängt worden nicht minder grausam, als die Politik normännischer Könige sie über England verhing.	ch27_clean.en-ch27_clean.de
Deer have received extended ranges, while men have been hunted within a narrower and still narrower circle....	Rotwild hat freieren Spielraum erhalten, während die Menschen in engen und engem Zirkel gehetzt wurden ...	ch27_clean.en-ch27_clean.de
One after one the liberties of the people have been cloven down....	Eine Freiheit des Volks nach der andren ward ihm geraubt ...	ch27_clean.en-ch27_clean.de
And the oppressions are daily on the increase....	Und die Unterdrückung wächst noch täglich.	ch27_clean.en-ch27_clean.de
The clearance and dispersion of the people is pursued by the proprietors as a settled principle, as an agricultural necessity, just as trees and brushwood are cleared from the wastes of America or Australia; and the operation goes on in a quiet, business-like way, &c.”	Lichtung und Vertreibung des Volks werden von den Eigentümern als festes Prinzip verfolgt, als eine agrikole Notwendigkeit, ganz wie Bäume und Gesträuch in den Wildnissen Amerikas und Australiens weggefegt werden, und die Operation geht ihren ruhigen, geschäftsmäßigen Gang."	ch27_clean.en-ch27_clean.de
The spoliation of the church’s property, the fraudulent alienation of the State domains, the robbery of the common lands, the usurpation of feudal and clan property, and its transformation into modern private property under circumstances of reckless terrorism, were just so many idyllic methods of primitive accumulation.	Der Raub der Kirchengüter, die fraudulente Veräußerung der Staatsdomänen, der Diebstahl des Gemeindeeigentums, die usurpatorische und mit rücksichtslosem Terrorismus vollzogne Verwandlung von feudalem und Claneigentum in modernes Privateigentum, es waren ebenso viele idyllische Methoden der ursprünglichen Akkumulation.	ch27_clean.en-ch27_clean.de
They conquered the field for capitalistic agriculture, made the soil part and parcel of capital, and created for the town industries the necessary supply of a “free” and outlawed proletariat.	Sie eroberten das Feld für die kapitalistische Agrikultur, einverleibten den Grund und Boden dem Kapital und schufen der städtischen Industrie die nötige Zufuhr von vogelfreiem Proletariat.	ch27_clean.en-ch27_clean.de

