Chapter 29: Genesis of the Capitalist Farmer Now that we have considered the forcible creation of a class of outlawed proletarians, the bloody discipline that turned them into wage labourers, the disgraceful action of the State which employed the police to accelerate the accumulation of capital by increasing the degree of exploitation of labour, the question remains: whence came the capitalists originally?	4. Genesis der kapitalistischen Produktion Nachdem wir die gewaltsame Schöpfung vogelfreier Proletarier betrachtet, die blutige Disziplin, welche sie in Lohnarbeiter verwandelt, die schmutzige Haupt- und Staatsaktion, die mit dem Exploitationsgrad der Arbeit die Akkumulation des Kapitals polizeilich steigert, fragt sich, wo kommen die Kapitalisten ursprünglich her?	ch29_clean.en-ch29_clean.de
For the expropriation of the agricultural population creates, directly, none but the greatest landed proprietors.	Denn die Expropriation des Landvolks schafft unmittelbar nur große Grundeigentümer.	ch29_clean.en-ch29_clean.de
As far, however, as concerns the genesis of the farmer, we can, so to say, put our hand on it, because it is a slow process evolving through many centuries.	Was die Genesis des Pächters betrifft, so können wir sie sozusagen mit der Hand betappen, weil sie ein langsamer, über viele Jahrhunderte sich fortwälzender Prozeß ist.	ch29_clean.en-ch29_clean.de
The serfs, as well as the free small proprietors, held land under very different tenures, and were therefore emancipated under very different economic conditions.	Die Leibeignen selbst, woneben auch freie kleine Landeigner, befanden sich in sehr verschiednen Besitzverhältnissen und wurden daher auch unter sehr verschiednen ökonomischen Bedingungen emanzipiert.	ch29_clean.en-ch29_clean.de
In England the first form of the farmer is the bailiff, himself a serf.	In England ist die erste Form des Pächters der selbst leibeigne Bailiff.	ch29_clean.en-ch29_clean.de
His position is similar to that of the old Roman villicus, only in a more limited sphere of action.	Seine Stellung ist ähnlich der des altrömischen Villicus, nur in engerer Wirkungssphäre.	ch29_clean.en-ch29_clean.de
During the second half of the 14th century he is replaced by a farmer, whom the landlord provided with seed, cattle and implements.	Während der zweiten Hälfte des 14. Jahrhunderts wird er ersetzt durch einen Pächter, den der Landlord mit Samen, Vieh und Ackerwerkzeug versieht.	ch29_clean.en-ch29_clean.de
His condition is not very different from that of the peasant.	Seine Lage ist nicht sehr verschieden von der des Bauern.	ch29_clean.en-ch29_clean.de
Only he exploits more wage labour.	Nur beutet er mehr Lohnarbeit aus.	ch29_clean.en-ch29_clean.de
Soon he becomes a metayer, a half-farmer.	Er wird bald Metayer, Halbpächter.	ch29_clean.en-ch29_clean.de
He advances one part of the agricultural stock, the landlord the other.	Er stellt einen Teil des Ackerbaukapitals, der Landlord den andren.	ch29_clean.en-ch29_clean.de
The two divide the total product in proportions determined by contract.	Beide teilen das Gesamtprodukt in kontraktlich bestimmter Proportion.	ch29_clean.en-ch29_clean.de
This form quickly disappears in England, to give the place to the farmer proper, who makes his own capital breed by employing wage labourers, and pays a part of the surplus-product, in money or in kind, to the landlord as rent.	Diese Form verschwindet in England rasch, um der des eigentlichen Pächters Platz zu machen, welcher sein eignes Kapital durch Anwendung von Lohnarbeitern verwertet und einen Teil des Mehrprodukts, in Geld oder in natura, dem Landlord als Grundrente zahlt.	ch29_clean.en-ch29_clean.de
So long, during the 15th century, as the independent peasant and the farm-labourer working for himself as well as for wages, enriched themselves by their own labour, the circumstances of the farmer, and his field of production, were equally mediocre.	Solange, während des 15. Jahrhunderts, der unabhängige Bauer und der neben dem Lohndienst zugleich selbstwirtschaftende Ackerknecht sich selbst durch ihre Arbeit bereichern, bleiben die Umstände des Pächters und sein Produktionsfeld gleich mittelmäßig.	ch29_clean.en-ch29_clean.de
The agricultural revolution which commenced in the last third of the 15th century, and continued during almost the whole of the 16th (excepting, however, its last decade), enriched him just as speedily as it impoverished the mass of the agricultural people.	Die Agrikulturrevolution im letzten Dritteil des 15. Jahrhunderts, die fast während des ganzen 16. Jahrhunderts (jedoch mit Ausnahme seiner letzten Dezennien) fortwährt, bereichert ihn ebenso rasch, als sie das Landvolk verarmt.	ch29_clean.en-ch29_clean.de
The usurpation of the common lands allowed him to augment greatly his stock of cattle, almost without cost, whilst they yielded him a richer supply of manure for the tillage of the soil.	Die Usurpation von Gemeindeweiden usw. erlaubt ihm große Vermehrung seines Viehstands fast ohne Kosten, während ihm das Vieh reichlichere Düngungsmittel zur Bestellung des Bodens liefert.	ch29_clean.en-ch29_clean.de
To this was added in the 16th century a very important element.	Im 16. Jahrhundert kommt ein entscheidend wichtiges Moment hinzu.	ch29_clean.en-ch29_clean.de
At that time the contracts for farms ran for a long time, often for 99 years.	Damals waren die Pachtkontrakte lang, oft für 99 Jahre laufend.	ch29_clean.en-ch29_clean.de
The progressive fall in the value of the precious metals, and therefore of money, brought the farmers golden fruit.	Der fortdauernde Fall im Wert der edlen Metalle und daher des Geldes trug den Pächtern goldne Früchte.	ch29_clean.en-ch29_clean.de
Apart from all the other circumstances discussed above, it lowered wages.	Er senkte, von allen andren, früher erörterten Umständen abgesehn, den Arbeitslohn.	ch29_clean.en-ch29_clean.de
A portion of the latter was now added to the profits of the farm.	Ein Bruchstück desselben wurde zum Pachtprofit geschlagen.	ch29_clean.en-ch29_clean.de
The continuous rise in the price of corn, wool, meat, in a word of all agricultural produce, swelled the money capital of the farm without any action on his part, whilst the rent he paid (being calculated on the old value of money) diminished in reality.	Das fortwährende Steigen der Preise von Korn, Wolle, Fleisch, kurz sämtlicher Agrikulturprodukte, schwellte das Geldkapital des Pächters ohne sein Zutun, während die Grundrente, die er zu zahlen hatte, im veralteten Geldwert kontrahiert war.	ch29_clean.en-ch29_clean.de
Thus they grew rich at the expense both of their labourers and their landlords.	So bereicherte er sich gleichzeitig auf Kosten seiner Lohnarbeiter und seines Landlords.	ch29_clean.en-ch29_clean.de
No wonder, therefore, that England, at the end of the 16th century, had a class of capitalist farmers, rich, considering the circumstances of the time.	Kein Wunder also, wenn England Ende des 16. Jahrhunderts eine Klasse für die damaligen Verhältnisse reicher "Kapitalpächter" besaß.	ch29_clean.en-ch29_clean.de

